"com_code","com_annee","com_type","popleg_annee","popleg_mun","popleg_a_part","popleg_tot","popleg_date_maj"
"01001","2022","COM","2020","806","15","821","2023-01-02"
"01002","2022","COM","2020","262","6","268","2023-01-02"
"01004","2022","COM","2020","14288","374","14662","2023-01-02"
"01005","2022","COM","2020","1782","24","1806","2023-01-02"
"01006","2022","COM","2020","113","0","113","2023-01-02"
"01007","2022","COM","2020","2827","119","2946","2023-01-02"
"01008","2022","COM","2020","768","13","781","2023-01-02"
"01009","2022","COM","2020","324","8","332","2023-01-02"
"01010","2022","COM","2020","1101","15","1116","2023-01-02"
"01011","2022","COM","2020","368","11","379","2023-01-02"
"01012","2022","COM","2020","327","3","330","2023-01-02"
"01013","2022","COM","2020","143","4","147","2023-01-02"
"01014","2022","COM","2020","3336","91","3427","2023-01-02"
"01015","2022","COM","2020","663","15","678","2023-01-02"
"01016","2022","COM","2020","458","9","467","2023-01-02"
"01017","2022","COM","2020","445","11","456","2023-01-02"
"01019","2022","COM","2020","26","4","30","2023-01-02"
"01021","2022","COM","2020","1490","30","1520","2023-01-02"
"01022","2022","COM","2020","1213","16","1229","2023-01-02"
"01023","2022","COM","2020","76","0","76","2023-01-02"
"01024","2022","COM","2020","3299","66","3365","2023-01-02"
"01025","2022","COM","2020","4068","104","4172","2023-01-02"
"01026","2022","COM","2020","977","68","1045","2023-01-02"
"01027","2022","COM","2020","2647","52","2699","2023-01-02"
"01028","2022","COM","2020","625","17","642","2023-01-02"
"01029","2022","COM","2020","683","8","691","2023-01-02"
"01030","2022","COM","2020","821","15","836","2023-01-02"
"01031","2022","COM","2020","3671","234","3905","2023-01-02"
"01032","2022","COM","2020","3414","29","3443","2023-01-02"
"01033","2022","COM","2020","16434","336","16770","2023-01-02"
"01034","2022","COM","2020","9207","343","9550","2023-01-02"
"01035","2022","COM","2020","308","8","316","2023-01-02"
"01036","2022","COM","2020","1334","24","1358","2023-01-02"
"01037","2022","COM","2020","309","3","312","2023-01-02"
"01038","2022","COM","2020","759","19","778","2023-01-02"
"01039","2022","COM","2020","439","7","446","2023-01-02"
"01040","2022","COM","2020","480","10","490","2023-01-02"
"01041","2022","COM","2020","748","20","768","2023-01-02"
"01042","2022","COM","2020","291","7","298","2023-01-02"
"01043","2022","COM","2020","4829","114","4943","2023-01-02"
"01044","2022","COM","2020","628","17","645","2023-01-02"
"01045","2022","COM","2020","285","3","288","2023-01-02"
"01046","2022","COM","2020","912","8","920","2023-01-02"
"01047","2022","COM","2020","1269","34","1303","2023-01-02"
"01049","2022","COM","2020","3335","77","3412","2023-01-02"
"01050","2022","COM","2020","380","4","384","2023-01-02"
"01051","2022","COM","2020","91","1","92","2023-01-02"
"01052","2022","COM","2020","332","6","338","2023-01-02"
"01053","2022","COM","2020","41681","1682","43363","2023-01-02"
"01054","2022","COM","2020","1482","35","1517","2023-01-02"
"01056","2022","COM","2020","351","4","355","2023-01-02"
"01057","2022","COM","2020","514","16","530","2023-01-02"
"01058","2022","COM","2020","819","19","838","2023-01-02"
"01060","2022","COM","2020","486","19","505","2023-01-02"
"01061","2022","COM","2020","1133","33","1166","2023-01-02"
"01062","2022","COM","2020","951","23","974","2023-01-02"
"01063","2022","COM","2020","561","16","577","2023-01-02"
"01064","2022","COM","2020","1095","19","1114","2023-01-02"
"01065","2022","COM","2020","1825","64","1889","2023-01-02"
"01066","2022","COM","2020","92","1","93","2023-01-02"
"01067","2022","COM","2020","259","12","271","2023-01-02"
"01068","2022","COM","2020","771","17","788","2023-01-02"
"01069","2022","COM","2020","1514","39","1553","2023-01-02"
"01071","2022","COM","2020","5045","123","5168","2023-01-02"
"01072","2022","COM","2020","3202","63","3265","2023-01-02"
"01073","2022","COM","2020","995","25","1020","2023-01-02"
"01074","2022","COM","2020","2574","38","2612","2023-01-02"
"01075","2022","COM","2020","1402","31","1433","2023-01-02"
"01076","2022","COM","2020","122","3","125","2023-01-02"
"01077","2022","COM","2020","192","2","194","2023-01-02"
"01078","2022","COM","2020","1597","34","1631","2023-01-02"
"01079","2022","COM","2020","822","30","852","2023-01-02"
"01080","2022","COM","2020","636","16","652","2023-01-02"
"01081","2022","COM","2020","726","21","747","2023-01-02"
"01082","2022","COM","2020","637","15","652","2023-01-02"
"01083","2022","COM","2020","965","17","982","2023-01-02"
"01084","2022","COM","2020","921","19","940","2023-01-02"
"01085","2022","COM","2020","397","6","403","2023-01-02"
"01087","2022","COM","2020","279","10","289","2023-01-02"
"01088","2022","COM","2020","902","28","930","2023-01-02"
"01089","2022","COM","2020","2254","49","2303","2023-01-02"
"01090","2022","COM","2020","361","6","367","2023-01-02"
"01092","2022","COM","2020","1622","60","1682","2023-01-02"
"01093","2022","COM","2020","4968","203","5171","2023-01-02"
"01094","2022","COM","2020","761","12","773","2023-01-02"
"01095","2022","COM","2020","843","18","861","2023-01-02"
"01096","2022","COM","2020","1033","30","1063","2023-01-02"
"01098","2022","COM","2020","1175","38","1213","2023-01-02"
"01099","2022","COM","2020","1590","60","1650","2023-01-02"
"01100","2022","COM","2020","131","4","135","2023-01-02"
"01101","2022","COM","2020","152","7","159","2023-01-02"
"01102","2022","COM","2020","966","15","981","2023-01-02"
"01103","2022","COM","2020","2226","50","2276","2023-01-02"
"01104","2022","COM","2020","453","11","464","2023-01-02"
"01105","2022","COM","2020","1867","52","1919","2023-01-02"
"01106","2022","COM","2020","178","7","185","2023-01-02"
"01107","2022","COM","2020","136","4","140","2023-01-02"
"01108","2022","COM","2020","1161","24","1185","2023-01-02"
"01109","2022","COM","2020","2230","46","2276","2023-01-02"
"01110","2022","COM","2020","159","2","161","2023-01-02"
"01111","2022","COM","2020","133","2","135","2023-01-02"
"01112","2022","COM","2020","467","6","473","2023-01-02"
"01113","2022","COM","2020","817","12","829","2023-01-02"
"01114","2022","COM","2020","693","11","704","2023-01-02"
"01115","2022","COM","2020","1339","31","1370","2023-01-02"
"01116","2022","COM","2020","496","14","510","2023-01-02"
"01117","2022","COM","2020","150","1","151","2023-01-02"
"01118","2022","COM","2020","1279","27","1306","2023-01-02"
"01121","2022","COM","2020","116","1","117","2023-01-02"
"01123","2022","COM","2020","1159","36","1195","2023-01-02"
"01124","2022","COM","2020","702","8","710","2023-01-02"
"01125","2022","COM","2020","604","13","617","2023-01-02"
"01127","2022","COM","2020","506","8","514","2023-01-02"
"01128","2022","COM","2020","301","1","302","2023-01-02"
"01129","2022","COM","2020","303","5","308","2023-01-02"
"01130","2022","COM","2020","2368","38","2406","2023-01-02"
"01133","2022","COM","2020","395","5","400","2023-01-02"
"01134","2022","COM","2020","1792","44","1836","2023-01-02"
"01135","2022","COM","2020","2205","64","2269","2023-01-02"
"01136","2022","COM","2020","922","21","943","2023-01-02"
"01138","2022","COM","2020","2987","61","3048","2023-01-02"
"01139","2022","COM","2020","444","5","449","2023-01-02"
"01140","2022","COM","2020","764","19","783","2023-01-02"
"01141","2022","COM","2020","443","6","449","2023-01-02"
"01142","2022","COM","2020","4765","54","4819","2023-01-02"
"01143","2022","COM","2020","9999","240","10239","2023-01-02"
"01145","2022","COM","2020","1190","24","1214","2023-01-02"
"01146","2022","COM","2020","436","3","439","2023-01-02"
"01147","2022","COM","2020","509","3","512","2023-01-02"
"01148","2022","COM","2020","1892","47","1939","2023-01-02"
"01149","2022","COM","2020","1094","29","1123","2023-01-02"
"01150","2022","COM","2020","214","5","219","2023-01-02"
"01151","2022","COM","2020","1139","29","1168","2023-01-02"
"01152","2022","COM","2020","756","25","781","2023-01-02"
"01153","2022","COM","2020","2123","75","2198","2023-01-02"
"01155","2022","COM","2020","142","5","147","2023-01-02"
"01156","2022","COM","2020","843","12","855","2023-01-02"
"01157","2022","COM","2020","2339","53","2392","2023-01-02"
"01158","2022","COM","2020","1053","19","1072","2023-01-02"
"01159","2022","COM","2020","3366","72","3438","2023-01-02"
"01160","2022","COM","2020","10612","172","10784","2023-01-02"
"01162","2022","COM","2020","65","3","68","2023-01-02"
"01163","2022","COM","2020","2016","34","2050","2023-01-02"
"01165","2022","COM","2020","1586","33","1619","2023-01-02"
"01166","2022","COM","2020","2417","36","2453","2023-01-02"
"01167","2022","COM","2020","657","24","681","2023-01-02"
"01169","2022","COM","2020","651","23","674","2023-01-02"
"01170","2022","COM","2020","1044","27","1071","2023-01-02"
"01171","2022","COM","2020","830","41","871","2023-01-02"
"01173","2022","COM","2020","13177","290","13467","2023-01-02"
"01174","2022","COM","2020","176","2","178","2023-01-02"
"01175","2022","COM","2020","790","23","813","2023-01-02"
"01177","2022","COM","2020","184","5","189","2023-01-02"
"01179","2022","COM","2020","1884","52","1936","2023-01-02"
"01180","2022","COM","2020","842","20","862","2023-01-02"
"01181","2022","COM","2020","1241","50","1291","2023-01-02"
"01183","2022","COM","2020","1487","29","1516","2023-01-02"
"01184","2022","COM","2020","756","28","784","2023-01-02"
"01185","2022","COM","2020","4824","157","4981","2023-01-02"
"01187","2022","COM","2020","615","19","634","2023-01-02"
"01188","2022","COM","2020","681","21","702","2023-01-02"
"01189","2022","COM","2020","1123","27","1150","2023-01-02"
"01190","2022","COM","2020","86","1","87","2023-01-02"
"01191","2022","COM","2020","152","4","156","2023-01-02"
"01192","2022","COM","2020","2272","55","2327","2023-01-02"
"01193","2022","COM","2020","220","6","226","2023-01-02"
"01194","2022","COM","2020","6337","93","6430","2023-01-02"
"01195","2022","COM","2020","1822","39","1861","2023-01-02"
"01196","2022","COM","2020","1241","20","1261","2023-01-02"
"01197","2022","COM","2020","377","14","391","2023-01-02"
"01198","2022","COM","2020","266","3","269","2023-01-02"
"01199","2022","COM","2020","2129","44","2173","2023-01-02"
"01200","2022","COM","2020","213","5","218","2023-01-02"
"01202","2022","COM","2020","7214","126","7340","2023-01-02"
"01203","2022","COM","2020","1306","30","1336","2023-01-02"
"01204","2022","COM","2020","746","16","762","2023-01-02"
"01206","2022","COM","2020","274","6","280","2023-01-02"
"01207","2022","COM","2020","314","12","326","2023-01-02"
"01208","2022","COM","2020","135","1","136","2023-01-02"
"01209","2022","COM","2020","796","16","812","2023-01-02"
"01210","2022","COM","2020","231","4","235","2023-01-02"
"01211","2022","COM","2020","1397","39","1436","2023-01-02"
"01212","2022","COM","2020","712","8","720","2023-01-02"
"01213","2022","COM","2020","1332","29","1361","2023-01-02"
"01214","2022","COM","2020","161","5","166","2023-01-02"
"01215","2022","COM","2020","143","2","145","2023-01-02"
"01216","2022","COM","2020","893","21","914","2023-01-02"
"01219","2022","COM","2020","162","4","166","2023-01-02"
"01224","2022","COM","2020","3296","28","3324","2023-01-02"
"01225","2022","COM","2020","383","15","398","2023-01-02"
"01227","2022","COM","2020","642","12","654","2023-01-02"
"01228","2022","COM","2020","668","14","682","2023-01-02"
"01229","2022","COM","2020","1226","22","1248","2023-01-02"
"01230","2022","COM","2020","310","7","317","2023-01-02"
"01231","2022","COM","2020","1948","49","1997","2023-01-02"
"01232","2022","COM","2020","2275","44","2319","2023-01-02"
"01233","2022","COM","2020","130","2","132","2023-01-02"
"01234","2022","COM","2020","167","3","170","2023-01-02"
"01235","2022","COM","2020","1179","87","1266","2023-01-02"
"01236","2022","COM","2020","1021","29","1050","2023-01-02"
"01237","2022","COM","2020","1674","66","1740","2023-01-02"
"01238","2022","COM","2020","2709","58","2767","2023-01-02"
"01239","2022","COM","2020","631","9","640","2023-01-02"
"01240","2022","COM","2020","628","18","646","2023-01-02"
"01241","2022","COM","2020","1379","35","1414","2023-01-02"
"01242","2022","COM","2020","136","2","138","2023-01-02"
"01243","2022","COM","2020","1262","37","1299","2023-01-02"
"01244","2022","COM","2020","7998","143","8141","2023-01-02"
"01245","2022","COM","2020","950","21","971","2023-01-02"
"01246","2022","COM","2020","2204","40","2244","2023-01-02"
"01247","2022","COM","2020","299","13","312","2023-01-02"
"01248","2022","COM","2020","2245","54","2299","2023-01-02"
"01249","2022","COM","2020","10202","153","10355","2023-01-02"
"01250","2022","COM","2020","1979","270","2249","2023-01-02"
"01252","2022","COM","2020","796","23","819","2023-01-02"
"01254","2022","COM","2020","2142","51","2193","2023-01-02"
"01255","2022","COM","2020","651","11","662","2023-01-02"
"01257","2022","COM","2020","351","10","361","2023-01-02"
"01258","2022","COM","2020","1194","22","1216","2023-01-02"
"01259","2022","COM","2020","708","16","724","2023-01-02"
"01260","2022","COM","2020","304","5","309","2023-01-02"
"01261","2022","COM","2020","681","24","705","2023-01-02"
"01262","2022","COM","2020","6864","80","6944","2023-01-02"
"01263","2022","COM","2020","3761","88","3849","2023-01-02"
"01264","2022","COM","2020","1017","19","1036","2023-01-02"
"01265","2022","COM","2020","3499","81","3580","2023-01-02"
"01266","2022","COM","2020","2576","43","2619","2023-01-02"
"01267","2022","COM","2020","1008","27","1035","2023-01-02"
"01268","2022","COM","2020","244","3","247","2023-01-02"
"01269","2022","COM","2020","3453","134","3587","2023-01-02"
"01272","2022","COM","2020","1490","21","1511","2023-01-02"
"01273","2022","COM","2020","1799","25","1824","2023-01-02"
"01274","2022","COM","2020","632","13","645","2023-01-02"
"01275","2022","COM","2020","2596","52","2648","2023-01-02"
"01276","2022","COM","2020","1627","25","1652","2023-01-02"
"01277","2022","COM","2020","115","1","116","2023-01-02"
"01279","2022","COM","2020","77","5","82","2023-01-02"
"01280","2022","COM","2020","136","0","136","2023-01-02"
"01281","2022","COM","2020","4591","175","4766","2023-01-02"
"01282","2022","COM","2020","258","7","265","2023-01-02"
"01283","2022","COM","2020","22271","453","22724","2023-01-02"
"01284","2022","COM","2020","700","13","713","2023-01-02"
"01285","2022","COM","2020","1334","32","1366","2023-01-02"
"01286","2022","COM","2020","959","37","996","2023-01-02"
"01288","2022","COM","2020","2777","59","2836","2023-01-02"
"01289","2022","COM","2020","6460","275","6735","2023-01-02"
"01290","2022","COM","2020","1309","31","1340","2023-01-02"
"01291","2022","COM","2020","844","8","852","2023-01-02"
"01293","2022","COM","2020","145","3","148","2023-01-02"
"01294","2022","COM","2020","897","18","915","2023-01-02"
"01295","2022","COM","2020","676","10","686","2023-01-02"
"01296","2022","COM","2020","413","11","424","2023-01-02"
"01297","2022","COM","2020","890","16","906","2023-01-02"
"01298","2022","COM","2020","157","2","159","2023-01-02"
"01299","2022","COM","2020","589","10","599","2023-01-02"
"01301","2022","COM","2020","2606","61","2667","2023-01-02"
"01302","2022","COM","2020","165","4","169","2023-01-02"
"01303","2022","COM","2020","1696","39","1735","2023-01-02"
"01304","2022","COM","2020","2904","53","2957","2023-01-02"
"01305","2022","COM","2020","2195","43","2238","2023-01-02"
"01306","2022","COM","2020","1637","64","1701","2023-01-02"
"01307","2022","COM","2020","840","21","861","2023-01-02"
"01308","2022","COM","2020","803","14","817","2023-01-02"
"01309","2022","COM","2020","83","0","83","2023-01-02"
"01310","2022","COM","2020","249","4","253","2023-01-02"
"01311","2022","COM","2020","44","0","44","2023-01-02"
"01313","2022","COM","2020","8948","245","9193","2023-01-02"
"01314","2022","COM","2020","1725","31","1756","2023-01-02"
"01317","2022","COM","2020","331","6","337","2023-01-02"
"01318","2022","COM","2020","735","18","753","2023-01-02"
"01319","2022","COM","2020","467","9","476","2023-01-02"
"01320","2022","COM","2020","3833","92","3925","2023-01-02"
"01321","2022","COM","2020","892","29","921","2023-01-02"
"01322","2022","COM","2020","5050","142","5192","2023-01-02"
"01323","2022","COM","2020","1018","17","1035","2023-01-02"
"01325","2022","COM","2020","1065","19","1084","2023-01-02"
"01328","2022","COM","2020","606","4","610","2023-01-02"
"01329","2022","COM","2020","157","2","159","2023-01-02"
"01330","2022","COM","2020","180","7","187","2023-01-02"
"01331","2022","COM","2020","192","1","193","2023-01-02"
"01332","2022","COM","2020","792","23","815","2023-01-02"
"01333","2022","COM","2020","3366","59","3425","2023-01-02"
"01334","2022","COM","2020","680","9","689","2023-01-02"
"01335","2022","COM","2020","410","6","416","2023-01-02"
"01336","2022","COM","2020","1187","22","1209","2023-01-02"
"01337","2022","COM","2020","1336","27","1363","2023-01-02"
"01338","2022","COM","2020","1245","34","1279","2023-01-02"
"01339","2022","COM","2020","1484","44","1528","2023-01-02"
"01342","2022","COM","2020","546","10","556","2023-01-02"
"01343","2022","COM","2020","1822","41","1863","2023-01-02"
"01344","2022","COM","2020","5971","166","6137","2023-01-02"
"01345","2022","COM","2020","2245","33","2278","2023-01-02"
"01346","2022","COM","2020","852","19","871","2023-01-02"
"01347","2022","COM","2020","2072","64","2136","2023-01-02"
"01348","2022","COM","2020","3003","66","3069","2023-01-02"
"01349","2022","COM","2020","523","6","529","2023-01-02"
"01350","2022","COM","2020","2538","37","2575","2023-01-02"
"01351","2022","COM","2020","1602","27","1629","2023-01-02"
"01352","2022","COM","2020","586","5","591","2023-01-02"
"01353","2022","COM","2020","1723","29","1752","2023-01-02"
"01354","2022","COM","2020","14274","189","14463","2023-01-02"
"01355","2022","COM","2020","484","7","491","2023-01-02"
"01356","2022","COM","2020","203","5","208","2023-01-02"
"01357","2022","COM","2020","502","7","509","2023-01-02"
"01358","2022","COM","2020","426","8","434","2023-01-02"
"01359","2022","COM","2020","251","2","253","2023-01-02"
"01360","2022","COM","2020","1934","48","1982","2023-01-02"
"01361","2022","COM","2020","1600","46","1646","2023-01-02"
"01362","2022","COM","2020","809","12","821","2023-01-02"
"01363","2022","COM","2020","1786","73","1859","2023-01-02"
"01364","2022","COM","2020","767","8","775","2023-01-02"
"01365","2022","COM","2020","1165","28","1193","2023-01-02"
"01366","2022","COM","2020","1088","17","1105","2023-01-02"
"01367","2022","COM","2020","726","7","733","2023-01-02"
"01368","2022","COM","2020","842","15","857","2023-01-02"
"01369","2022","COM","2020","955","25","980","2023-01-02"
"01370","2022","COM","2020","1674","28","1702","2023-01-02"
"01371","2022","COM","2020","1221","27","1248","2023-01-02"
"01372","2022","COM","2020","441","13","454","2023-01-02"
"01373","2022","COM","2020","1009","29","1038","2023-01-02"
"01374","2022","COM","2020","1877","45","1922","2023-01-02"
"01375","2022","COM","2020","788","19","807","2023-01-02"
"01376","2022","COM","2020","4066","41","4107","2023-01-02"
"01378","2022","COM","2020","2699","56","2755","2023-01-02"
"01379","2022","COM","2020","762","12","774","2023-01-02"
"01380","2022","COM","2020","612","13","625","2023-01-02"
"01381","2022","COM","2020","920","18","938","2023-01-02"
"01382","2022","COM","2020","305","4","309","2023-01-02"
"01383","2022","COM","2020","1583","21","1604","2023-01-02"
"01384","2022","COM","2020","2172","29","2201","2023-01-02"
"01385","2022","COM","2020","964","19","983","2023-01-02"
"01386","2022","COM","2020","1117","60","1177","2023-01-02"
"01387","2022","COM","2020","256","3","259","2023-01-02"
"01388","2022","COM","2020","1116","8","1124","2023-01-02"
"01389","2022","COM","2020","1823","43","1866","2023-01-02"
"01390","2022","COM","2020","1247","21","1268","2023-01-02"
"01391","2022","COM","2020","273","8","281","2023-01-02"
"01392","2022","COM","2020","654","28","682","2023-01-02"
"01393","2022","COM","2020","555","13","568","2023-01-02"
"01396","2022","COM","2020","987","14","1001","2023-01-02"
"01397","2022","COM","2020","988","19","1007","2023-01-02"
"01398","2022","COM","2020","1438","19","1457","2023-01-02"
"01399","2022","COM","2020","2145","53","2198","2023-01-02"
"01400","2022","COM","2020","139","3","142","2023-01-02"
"01401","2022","COM","2020","2209","73","2282","2023-01-02"
"01402","2022","COM","2020","650","20","670","2023-01-02"
"01403","2022","COM","2020","1310","40","1350","2023-01-02"
"01404","2022","COM","2020","134","2","136","2023-01-02"
"01405","2022","COM","2020","1273","28","1301","2023-01-02"
"01406","2022","COM","2020","173","1","174","2023-01-02"
"01407","2022","COM","2020","1006","17","1023","2023-01-02"
"01408","2022","COM","2020","659","11","670","2023-01-02"
"01410","2022","COM","2020","299","7","306","2023-01-02"
"01411","2022","COM","2020","271","8","279","2023-01-02"
"01412","2022","COM","2020","611","12","623","2023-01-02"
"01415","2022","COM","2020","524","7","531","2023-01-02"
"01416","2022","COM","2020","1012","12","1024","2023-01-02"
"01418","2022","COM","2020","1103","27","1130","2023-01-02"
"01419","2022","COM","2020","6119","180","6299","2023-01-02"
"01420","2022","COM","2020","1664","8","1672","2023-01-02"
"01421","2022","COM","2020","734","15","749","2023-01-02"
"01422","2022","COM","2020","1354","36","1390","2023-01-02"
"01423","2022","COM","2020","1169","22","1191","2023-01-02"
"01424","2022","COM","2020","1823","44","1867","2023-01-02"
"01425","2022","COM","2020","284","7","291","2023-01-02"
"01426","2022","COM","2020","2506","55","2561","2023-01-02"
"01427","2022","COM","2020","6945","163","7108","2023-01-02"
"01428","2022","COM","2020","128","0","128","2023-01-02"
"01429","2022","COM","2020","714","15","729","2023-01-02"
"01430","2022","COM","2020","636","12","648","2023-01-02"
"01431","2022","COM","2020","1224","29","1253","2023-01-02"
"01432","2022","COM","2020","333","3","336","2023-01-02"
"01433","2022","COM","2020","306","4","310","2023-01-02"
"01434","2022","COM","2020","488","10","498","2023-01-02"
"01435","2022","COM","2020","2146","69","2215","2023-01-02"
"01436","2022","COM","2020","492","9","501","2023-01-02"
"01437","2022","COM","2020","221","5","226","2023-01-02"
"01439","2022","COM","2020","99","4","103","2023-01-02"
"01441","2022","COM","2020","743","18","761","2023-01-02"
"01443","2022","COM","2020","4946","94","5040","2023-01-02"
"01444","2022","COM","2020","1195","18","1213","2023-01-02"
"01445","2022","COM","2020","628","22","650","2023-01-02"
"01446","2022","COM","2020","1562","37","1599","2023-01-02"
"01447","2022","COM","2020","1345","31","1376","2023-01-02"
"01448","2022","COM","2020","394","7","401","2023-01-02"
"01449","2022","COM","2020","760","15","775","2023-01-02"
"01450","2022","COM","2020","3755","72","3827","2023-01-02"
"01451","2022","COM","2020","6665","152","6817","2023-01-02"
"01452","2022","COM","2020","1127","24","1151","2023-01-02"
"01453","2022","COM","2020","712","17","729","2023-01-02"
"01454","2022","COM","2020","1118","21","1139","2023-01-02"
"01456","2022","COM","2020","71","2","73","2023-01-02"
"01457","2022","COM","2020","3198","42","3240","2023-01-02"
"02001","2022","COM","2020","505","11","516","2023-01-02"
"02002","2022","COM","2020","602","13","615","2023-01-02"
"02003","2022","COM","2020","1019","26","1045","2023-01-02"
"02004","2022","COM","2020","185","5","190","2023-01-02"
"02005","2022","COM","2020","382","9","391","2023-01-02"
"02006","2022","COM","2020","260","9","269","2023-01-02"
"02007","2022","COM","2020","120","3","123","2023-01-02"
"02008","2022","COM","2020","299","4","303","2023-01-02"
"02009","2022","COM","2020","531","6","537","2023-01-02"
"02010","2022","COM","2020","171","4","175","2023-01-02"
"02011","2022","COM","2020","1159","55","1214","2023-01-02"
"02012","2022","COM","2020","73","0","73","2023-01-02"
"02013","2022","COM","2020","390","9","399","2023-01-02"
"02014","2022","COM","2020","721","22","743","2023-01-02"
"02015","2022","COM","2020","74","1","75","2023-01-02"
"02016","2022","COM","2020","215","8","223","2023-01-02"
"02017","2022","COM","2020","308","2","310","2023-01-02"
"02018","2022","COM","2020","2587","54","2641","2023-01-02"
"02019","2022","COM","2020","359","5","364","2023-01-02"
"02020","2022","COM","2020","455","8","463","2023-01-02"
"02021","2022","COM","2020","82","1","83","2023-01-02"
"02022","2022","COM","2020","401","6","407","2023-01-02"
"02023","2022","COM","2020","101","3","104","2023-01-02"
"02024","2022","COM","2020","49","0","49","2023-01-02"
"02025","2022","COM","2020","367","2","369","2023-01-02"
"02027","2022","COM","2020","210","8","218","2023-01-02"
"02028","2022","COM","2020","2597","59","2656","2023-01-02"
"02029","2022","COM","2020","351","12","363","2023-01-02"
"02030","2022","COM","2020","254","4","258","2023-01-02"
"02031","2022","COM","2020","659","8","667","2023-01-02"
"02032","2022","COM","2020","254","4","258","2023-01-02"
"02033","2022","COM","2020","102","2","104","2023-01-02"
"02034","2022","COM","2020","122","3","125","2023-01-02"
"02035","2022","COM","2020","283","9","292","2023-01-02"
"02036","2022","COM","2020","70","1","71","2023-01-02"
"02037","2022","COM","2020","1380","30","1410","2023-01-02"
"02038","2022","COM","2020","60","1","61","2023-01-02"
"02039","2022","COM","2020","174","3","177","2023-01-02"
"02040","2022","COM","2020","176","3","179","2023-01-02"
"02041","2022","COM","2020","815","15","830","2023-01-02"
"02042","2022","COM","2020","379","6","385","2023-01-02"
"02043","2022","COM","2020","64","1","65","2023-01-02"
"02044","2022","COM","2020","24","0","24","2023-01-02"
"02046","2022","COM","2020","557","10","567","2023-01-02"
"02047","2022","COM","2020","108","1","109","2023-01-02"
"02048","2022","COM","2020","131","1","132","2023-01-02"
"02049","2022","COM","2020","740","13","753","2023-01-02"
"02050","2022","COM","2020","320","2","322","2023-01-02"
"02051","2022","COM","2020","391","6","397","2023-01-02"
"02052","2022","COM","2020","132","7","139","2023-01-02"
"02053","2022","COM","2020","573","6","579","2023-01-02"
"02054","2022","COM","2020","532","15","547","2023-01-02"
"02055","2022","COM","2020","87","2","89","2023-01-02"
"02056","2022","COM","2020","180","1","181","2023-01-02"
"02057","2022","COM","2020","1411","18","1429","2023-01-02"
"02058","2022","COM","2020","851","11","862","2023-01-02"
"02059","2022","COM","2020","2718","28","2746","2023-01-02"
"02060","2022","COM","2020","255","7","262","2023-01-02"
"02061","2022","COM","2020","245","7","252","2023-01-02"
"02062","2022","COM","2020","136","2","138","2023-01-02"
"02063","2022","COM","2020","379","8","387","2023-01-02"
"02064","2022","COM","2020","3762","67","3829","2023-01-02"
"02065","2022","COM","2020","587","11","598","2023-01-02"
"02066","2022","COM","2020","193","2","195","2023-01-02"
"02067","2022","COM","2020","209","5","214","2023-01-02"
"02068","2022","COM","2020","85","5","90","2023-01-02"
"02069","2022","COM","2020","105","2","107","2023-01-02"
"02070","2022","COM","2020","441","12","453","2023-01-02"
"02071","2022","COM","2020","650","11","661","2023-01-02"
"02072","2022","COM","2020","183","3","186","2023-01-02"
"02073","2022","COM","2020","687","4","691","2023-01-02"
"02074","2022","COM","2020","592","11","603","2023-01-02"
"02075","2022","COM","2020","194","2","196","2023-01-02"
"02076","2022","COM","2020","153","3","156","2023-01-02"
"02077","2022","COM","2020","380","9","389","2023-01-02"
"02078","2022","COM","2020","164","3","167","2023-01-02"
"02079","2022","COM","2020","147","0","147","2023-01-02"
"02080","2022","COM","2020","327","9","336","2023-01-02"
"02081","2022","COM","2020","432","8","440","2023-01-02"
"02082","2022","COM","2020","110","0","110","2023-01-02"
"02083","2022","COM","2020","751","15","766","2023-01-02"
"02084","2022","COM","2020","255","5","260","2023-01-02"
"02085","2022","COM","2020","1003","25","1028","2023-01-02"
"02086","2022","COM","2020","999","12","1011","2023-01-02"
"02087","2022","COM","2020","34","1","35","2023-01-02"
"02088","2022","COM","2020","88","5","93","2023-01-02"
"02089","2022","COM","2020","1146","21","1167","2023-01-02"
"02090","2022","COM","2020","203","4","207","2023-01-02"
"02091","2022","COM","2020","94","1","95","2023-01-02"
"02093","2022","COM","2020","1306","60","1366","2023-01-02"
"02094","2022","COM","2020","469","10","479","2023-01-02"
"02095","2022","COM","2020","5703","75","5778","2023-01-02"
"02096","2022","COM","2020","194","2","196","2023-01-02"
"02097","2022","COM","2020","261","2","263","2023-01-02"
"02098","2022","COM","2020","378","14","392","2023-01-02"
"02099","2022","COM","2020","216","5","221","2023-01-02"
"02100","2022","COM","2020","138","0","138","2023-01-02"
"02101","2022","COM","2020","186","3","189","2023-01-02"
"02102","2022","COM","2020","188","3","191","2023-01-02"
"02103","2022","COM","2020","1331","6","1337","2023-01-02"
"02104","2022","COM","2020","98","4","102","2023-01-02"
"02105","2022","COM","2020","193","2","195","2023-01-02"
"02106","2022","COM","2020","810","9","819","2023-01-02"
"02107","2022","COM","2020","105","4","109","2023-01-02"
"02108","2022","COM","2020","158","4","162","2023-01-02"
"02109","2022","COM","2020","473","11","484","2023-01-02"
"02110","2022","COM","2020","2232","26","2258","2023-01-02"
"02111","2022","COM","2020","726","13","739","2023-01-02"
"02112","2022","COM","2020","554","12","566","2023-01-02"
"02114","2022","COM","2020","1558","35","1593","2023-01-02"
"02115","2022","COM","2020","186","6","192","2023-01-02"
"02116","2022","COM","2020","142","1","143","2023-01-02"
"02117","2022","COM","2020","67","0","67","2023-01-02"
"02118","2022","COM","2020","129","3","132","2023-01-02"
"02119","2022","COM","2020","321","6","327","2023-01-02"
"02120","2022","COM","2020","196","6","202","2023-01-02"
"02121","2022","COM","2020","237","4","241","2023-01-02"
"02122","2022","COM","2020","55","1","56","2023-01-02"
"02123","2022","COM","2020","299","5","304","2023-01-02"
"02124","2022","COM","2020","651","10","661","2023-01-02"
"02125","2022","COM","2020","183","10","193","2023-01-02"
"02126","2022","COM","2020","448","5","453","2023-01-02"
"02127","2022","COM","2020","191","5","196","2023-01-02"
"02128","2022","COM","2020","1447","46","1493","2023-01-02"
"02129","2022","COM","2020","19","0","19","2023-01-02"
"02130","2022","COM","2020","198","9","207","2023-01-02"
"02131","2022","COM","2020","1883","41","1924","2023-01-02"
"02132","2022","COM","2020","192","3","195","2023-01-02"
"02133","2022","COM","2020","403","9","412","2023-01-02"
"02134","2022","COM","2020","854","19","873","2023-01-02"
"02135","2022","COM","2020","1148","16","1164","2023-01-02"
"02136","2022","COM","2020","128","3","131","2023-01-02"
"02137","2022","COM","2020","151","6","157","2023-01-02"
"02138","2022","COM","2020","200","3","203","2023-01-02"
"02139","2022","COM","2020","447","8","455","2023-01-02"
"02140","2022","COM","2020","457","9","466","2023-01-02"
"02141","2022","COM","2020","1772","80","1852","2023-01-02"
"02142","2022","COM","2020","251","4","255","2023-01-02"
"02143","2022","COM","2020","184","7","191","2023-01-02"
"02144","2022","COM","2020","140","3","143","2023-01-02"
"02145","2022","COM","2020","545","10","555","2023-01-02"
"02146","2022","COM","2020","96","1","97","2023-01-02"
"02148","2022","COM","2020","256","2","258","2023-01-02"
"02149","2022","COM","2020","60","2","62","2023-01-02"
"02150","2022","COM","2020","62","0","62","2023-01-02"
"02151","2022","COM","2020","116","3","119","2023-01-02"
"02152","2022","COM","2020","87","1","88","2023-01-02"
"02153","2022","COM","2020","775","21","796","2023-01-02"
"02154","2022","COM","2020","365","7","372","2023-01-02"
"02155","2022","COM","2020","177","1","178","2023-01-02"
"02156","2022","COM","2020","258","1","259","2023-01-02"
"02157","2022","COM","2020","834","23","857","2023-01-02"
"02158","2022","COM","2020","271","2","273","2023-01-02"
"02159","2022","COM","2020","302","2","304","2023-01-02"
"02160","2022","COM","2020","527","18","545","2023-01-02"
"02162","2022","COM","2020","298","8","306","2023-01-02"
"02163","2022","COM","2020","2585","41","2626","2023-01-02"
"02164","2022","COM","2020","327","7","334","2023-01-02"
"02165","2022","COM","2020","1655","29","1684","2023-01-02"
"02166","2022","COM","2020","359","9","368","2023-01-02"
"02167","2022","COM","2020","888","14","902","2023-01-02"
"02168","2022","COM","2020","15306","312","15618","2023-01-02"
"02169","2022","COM","2020","84","0","84","2023-01-02"
"02170","2022","COM","2020","124","0","124","2023-01-02"
"02171","2022","COM","2020","90","1","91","2023-01-02"
"02172","2022","COM","2020","251","8","259","2023-01-02"
"02173","2022","COM","2020","11438","405","11843","2023-01-02"
"02174","2022","COM","2020","835","17","852","2023-01-02"
"02175","2022","COM","2020","164","4","168","2023-01-02"
"02176","2022","COM","2020","207","3","210","2023-01-02"
"02177","2022","COM","2020","141","1","142","2023-01-02"
"02178","2022","COM","2020","110","2","112","2023-01-02"
"02179","2022","COM","2020","381","7","388","2023-01-02"
"02180","2022","COM","2020","726","14","740","2023-01-02"
"02181","2022","COM","2020","85","0","85","2023-01-02"
"02182","2022","COM","2020","113","3","116","2023-01-02"
"02183","2022","COM","2020","185","1","186","2023-01-02"
"02184","2022","COM","2020","346","5","351","2023-01-02"
"02185","2022","COM","2020","385","15","400","2023-01-02"
"02186","2022","COM","2020","1336","30","1366","2023-01-02"
"02187","2022","COM","2020","1146","20","1166","2023-01-02"
"02188","2022","COM","2020","145","3","148","2023-01-02"
"02189","2022","COM","2020","345","8","353","2023-01-02"
"02190","2022","COM","2020","523","7","530","2023-01-02"
"02191","2022","COM","2020","511","7","518","2023-01-02"
"02192","2022","COM","2020","370","7","377","2023-01-02"
"02193","2022","COM","2020","65","1","66","2023-01-02"
"02194","2022","COM","2020","179","8","187","2023-01-02"
"02195","2022","COM","2020","900","28","928","2023-01-02"
"02196","2022","COM","2020","306","7","313","2023-01-02"
"02197","2022","COM","2020","530","101","631","2023-01-02"
"02198","2022","COM","2020","228","2","230","2023-01-02"
"02199","2022","COM","2020","597","8","605","2023-01-02"
"02200","2022","COM","2020","104","1","105","2023-01-02"
"02201","2022","COM","2020","449","6","455","2023-01-02"
"02203","2022","COM","2020","1268","19","1287","2023-01-02"
"02204","2022","COM","2020","64","2","66","2023-01-02"
"02205","2022","COM","2020","219","3","222","2023-01-02"
"02206","2022","COM","2020","75","3","78","2023-01-02"
"02207","2022","COM","2020","217","3","220","2023-01-02"
"02208","2022","COM","2020","262","6","268","2023-01-02"
"02209","2022","COM","2020","691","11","702","2023-01-02"
"02210","2022","COM","2020","361","6","367","2023-01-02"
"02211","2022","COM","2020","310","3","313","2023-01-02"
"02212","2022","COM","2020","702","8","710","2023-01-02"
"02213","2022","COM","2020","342","2","344","2023-01-02"
"02214","2022","COM","2020","61","1","62","2023-01-02"
"02215","2022","COM","2020","842","6","848","2023-01-02"
"02216","2022","COM","2020","290","4","294","2023-01-02"
"02217","2022","COM","2020","992","10","1002","2023-01-02"
"02218","2022","COM","2020","627","12","639","2023-01-02"
"02219","2022","COM","2020","196","64","260","2023-01-02"
"02220","2022","COM","2020","442","15","457","2023-01-02"
"02221","2022","COM","2020","154","4","158","2023-01-02"
"02222","2022","COM","2020","34","0","34","2023-01-02"
"02223","2022","COM","2020","304","14","318","2023-01-02"
"02224","2022","COM","2020","340","5","345","2023-01-02"
"02225","2022","COM","2020","83","1","84","2023-01-02"
"02226","2022","COM","2020","1877","28","1905","2023-01-02"
"02227","2022","COM","2020","120","0","120","2023-01-02"
"02228","2022","COM","2020","346","5","351","2023-01-02"
"02229","2022","COM","2020","74","0","74","2023-01-02"
"02230","2022","COM","2020","186","6","192","2023-01-02"
"02231","2022","COM","2020","949","9","958","2023-01-02"
"02232","2022","COM","2020","365","8","373","2023-01-02"
"02233","2022","COM","2020","145","8","153","2023-01-02"
"02234","2022","COM","2020","84","2","86","2023-01-02"
"02235","2022","COM","2020","114","3","117","2023-01-02"
"02236","2022","COM","2020","329","3","332","2023-01-02"
"02237","2022","COM","2020","1499","17","1516","2023-01-02"
"02238","2022","COM","2020","1798","31","1829","2023-01-02"
"02239","2022","COM","2020","1250","84","1334","2023-01-02"
"02240","2022","COM","2020","198","3","201","2023-01-02"
"02241","2022","COM","2020","91","3","94","2023-01-02"
"02242","2022","COM","2020","640","11","651","2023-01-02"
"02243","2022","COM","2020","2958","37","2995","2023-01-02"
"02244","2022","COM","2020","63","3","66","2023-01-02"
"02245","2022","COM","2020","1797","34","1831","2023-01-02"
"02246","2022","COM","2020","608","4","612","2023-01-02"
"02248","2022","COM","2020","156","3","159","2023-01-02"
"02249","2022","COM","2020","101","0","101","2023-01-02"
"02250","2022","COM","2020","72","4","76","2023-01-02"
"02251","2022","COM","2020","27","1","28","2023-01-02"
"02252","2022","COM","2020","71","1","72","2023-01-02"
"02253","2022","COM","2020","357","3","360","2023-01-02"
"02254","2022","COM","2020","128","5","133","2023-01-02"
"02255","2022","COM","2020","155","2","157","2023-01-02"
"02256","2022","COM","2020","130","3","133","2023-01-02"
"02257","2022","COM","2020","437","12","449","2023-01-02"
"02258","2022","COM","2020","372","12","384","2023-01-02"
"02259","2022","COM","2020","390","15","405","2023-01-02"
"02260","2022","COM","2020","654","11","665","2023-01-02"
"02261","2022","COM","2020","389","10","399","2023-01-02"
"02262","2022","COM","2020","208","3","211","2023-01-02"
"02263","2022","COM","2020","114","0","114","2023-01-02"
"02264","2022","COM","2020","724","16","740","2023-01-02"
"02265","2022","COM","2020","93","1","94","2023-01-02"
"02266","2022","COM","2020","44","2","46","2023-01-02"
"02267","2022","COM","2020","297","9","306","2023-01-02"
"02268","2022","COM","2020","635","13","648","2023-01-02"
"02269","2022","COM","2020","154","6","160","2023-01-02"
"02270","2022","COM","2020","164","3","167","2023-01-02"
"02271","2022","COM","2020","129","2","131","2023-01-02"
"02272","2022","COM","2020","77","2","79","2023-01-02"
"02273","2022","COM","2020","199","0","199","2023-01-02"
"02274","2022","COM","2020","192","6","198","2023-01-02"
"02275","2022","COM","2020","316","7","323","2023-01-02"
"02276","2022","COM","2020","115","5","120","2023-01-02"
"02277","2022","COM","2020","343","7","350","2023-01-02"
"02278","2022","COM","2020","30","2","32","2023-01-02"
"02279","2022","COM","2020","552","24","576","2023-01-02"
"02280","2022","COM","2020","408","12","420","2023-01-02"
"02281","2022","COM","2020","252","11","263","2023-01-02"
"02282","2022","COM","2020","432","8","440","2023-01-02"
"02283","2022","COM","2020","285","7","292","2023-01-02"
"02284","2022","COM","2020","104","0","104","2023-01-02"
"02286","2022","COM","2020","861","20","881","2023-01-02"
"02287","2022","COM","2020","1045","27","1072","2023-01-02"
"02288","2022","COM","2020","349","8","357","2023-01-02"
"02289","2022","COM","2020","413","11","424","2023-01-02"
"02290","2022","COM","2020","2730","67","2797","2023-01-02"
"02291","2022","COM","2020","410","6","416","2023-01-02"
"02292","2022","COM","2020","1331","27","1358","2023-01-02"
"02293","2022","COM","2020","551","10","561","2023-01-02"
"02294","2022","COM","2020","206","8","214","2023-01-02"
"02295","2022","COM","2020","850","10","860","2023-01-02"
"02296","2022","COM","2020","1187","21","1208","2023-01-02"
"02297","2022","COM","2020","123","2","125","2023-01-02"
"02298","2022","COM","2020","1454","13","1467","2023-01-02"
"02299","2022","COM","2020","534","6","540","2023-01-02"
"02302","2022","COM","2020","332","12","344","2023-01-02"
"02303","2022","COM","2020","684","16","700","2023-01-02"
"02304","2022","COM","2020","2845","136","2981","2023-01-02"
"02305","2022","COM","2020","2970","52","3022","2023-01-02"
"02306","2022","COM","2020","513","9","522","2023-01-02"
"02307","2022","COM","2020","2055","135","2190","2023-01-02"
"02308","2022","COM","2020","489","4","493","2023-01-02"
"02309","2022","COM","2020","683","5","688","2023-01-02"
"02310","2022","COM","2020","250","7","257","2023-01-02"
"02311","2022","COM","2020","118","2","120","2023-01-02"
"02312","2022","COM","2020","1088","10","1098","2023-01-02"
"02313","2022","COM","2020","444","5","449","2023-01-02"
"02315","2022","COM","2020","1660","35","1695","2023-01-02"
"02316","2022","COM","2020","124","5","129","2023-01-02"
"02317","2022","COM","2020","212","4","216","2023-01-02"
"02318","2022","COM","2020","1377","18","1395","2023-01-02"
"02319","2022","COM","2020","500","8","508","2023-01-02"
"02320","2022","COM","2020","233","4","237","2023-01-02"
"02321","2022","COM","2020","892","189","1081","2023-01-02"
"02322","2022","COM","2020","383","4","387","2023-01-02"
"02323","2022","COM","2020","138","3","141","2023-01-02"
"02324","2022","COM","2020","288","3","291","2023-01-02"
"02326","2022","COM","2020","467","8","475","2023-01-02"
"02327","2022","COM","2020","159","1","160","2023-01-02"
"02328","2022","COM","2020","512","7","519","2023-01-02"
"02329","2022","COM","2020","434","9","443","2023-01-02"
"02330","2022","COM","2020","546","8","554","2023-01-02"
"02331","2022","COM","2020","108","4","112","2023-01-02"
"02332","2022","COM","2020","271","4","275","2023-01-02"
"02333","2022","COM","2020","163","3","166","2023-01-02"
"02334","2022","COM","2020","2946","69","3015","2023-01-02"
"02335","2022","COM","2020","179","8","187","2023-01-02"
"02336","2022","COM","2020","981","16","997","2023-01-02"
"02337","2022","COM","2020","177","5","182","2023-01-02"
"02338","2022","COM","2020","250","8","258","2023-01-02"
"02339","2022","COM","2020","695","9","704","2023-01-02"
"02340","2022","COM","2020","5216","67","5283","2023-01-02"
"02341","2022","COM","2020","262","1","263","2023-01-02"
"02342","2022","COM","2020","130","2","132","2023-01-02"
"02343","2022","COM","2020","82","0","82","2023-01-02"
"02345","2022","COM","2020","40","0","40","2023-01-02"
"02346","2022","COM","2020","654","8","662","2023-01-02"
"02347","2022","COM","2020","438","6","444","2023-01-02"
"02349","2022","COM","2020","56","0","56","2023-01-02"
"02350","2022","COM","2020","138","2","140","2023-01-02"
"02351","2022","COM","2020","113","6","119","2023-01-02"
"02352","2022","COM","2020","563","7","570","2023-01-02"
"02353","2022","COM","2020","281","10","291","2023-01-02"
"02354","2022","COM","2020","79","2","81","2023-01-02"
"02355","2022","COM","2020","945","25","970","2023-01-02"
"02356","2022","COM","2020","234","2","236","2023-01-02"
"02357","2022","COM","2020","70","2","72","2023-01-02"
"02358","2022","COM","2020","321","3","324","2023-01-02"
"02359","2022","COM","2020","1274","20","1294","2023-01-02"
"02360","2022","COM","2020","2780","35","2815","2023-01-02"
"02361","2022","COM","2020","4559","69","4628","2023-01-02"
"02362","2022","COM","2020","238","4","242","2023-01-02"
"02363","2022","COM","2020","374","3","377","2023-01-02"
"02364","2022","COM","2020","254","4","258","2023-01-02"
"02366","2022","COM","2020","326","7","333","2023-01-02"
"02367","2022","COM","2020","146","0","146","2023-01-02"
"02368","2022","COM","2020","568","9","577","2023-01-02"
"02369","2022","COM","2020","242","2","244","2023-01-02"
"02370","2022","COM","2020","590","12","602","2023-01-02"
"02371","2022","COM","2020","1567","33","1600","2023-01-02"
"02372","2022","COM","2020","344","10","354","2023-01-02"
"02373","2022","COM","2020","193","5","198","2023-01-02"
"02374","2022","COM","2020","853","8","861","2023-01-02"
"02375","2022","COM","2020","160","3","163","2023-01-02"
"02376","2022","COM","2020","177","5","182","2023-01-02"
"02377","2022","COM","2020","133","8","141","2023-01-02"
"02378","2022","COM","2020","126","5","131","2023-01-02"
"02379","2022","COM","2020","198","126","324","2023-01-02"
"02380","2022","COM","2020","26","0","26","2023-01-02"
"02381","2022","COM","2020","8685","189","8874","2023-01-02"
"02382","2022","COM","2020","1360","37","1397","2023-01-02"
"02383","2022","COM","2020","1441","33","1474","2023-01-02"
"02384","2022","COM","2020","57","2","59","2023-01-02"
"02385","2022","COM","2020","165","4","169","2023-01-02"
"02386","2022","COM","2020","225","2","227","2023-01-02"
"02387","2022","COM","2020","1007","36","1043","2023-01-02"
"02388","2022","COM","2020","221","5","226","2023-01-02"
"02389","2022","COM","2020","666","13","679","2023-01-02"
"02390","2022","COM","2020","260","2","262","2023-01-02"
"02391","2022","COM","2020","212","5","217","2023-01-02"
"02392","2022","COM","2020","317","6","323","2023-01-02"
"02393","2022","COM","2020","139","5","144","2023-01-02"
"02395","2022","COM","2020","139","6","145","2023-01-02"
"02396","2022","COM","2020","63","2","65","2023-01-02"
"02397","2022","COM","2020","1252","19","1271","2023-01-02"
"02398","2022","COM","2020","281","4","285","2023-01-02"
"02399","2022","COM","2020","615","4","619","2023-01-02"
"02400","2022","COM","2020","152","4","156","2023-01-02"
"02401","2022","COM","2020","191","2","193","2023-01-02"
"02402","2022","COM","2020","37","2","39","2023-01-02"
"02403","2022","COM","2020","257","7","264","2023-01-02"
"02404","2022","COM","2020","183","4","187","2023-01-02"
"02405","2022","COM","2020","535","5","540","2023-01-02"
"02406","2022","COM","2020","131","0","131","2023-01-02"
"02407","2022","COM","2020","208","9","217","2023-01-02"
"02408","2022","COM","2020","24091","647","24738","2023-01-02"
"02409","2022","COM","2020","272","7","279","2023-01-02"
"02410","2022","COM","2020","242","5","247","2023-01-02"
"02411","2022","COM","2020","200","4","204","2023-01-02"
"02412","2022","COM","2020","100","1","101","2023-01-02"
"02413","2022","COM","2020","241","4","245","2023-01-02"
"02414","2022","COM","2020","201","5","206","2023-01-02"
"02415","2022","COM","2020","159","5","164","2023-01-02"
"02416","2022","COM","2020","417","4","421","2023-01-02"
"02417","2022","COM","2020","120","0","120","2023-01-02"
"02418","2022","COM","2020","223","4","227","2023-01-02"
"02419","2022","COM","2020","268","10","278","2023-01-02"
"02420","2022","COM","2020","830","10","840","2023-01-02"
"02421","2022","COM","2020","99","2","101","2023-01-02"
"02422","2022","COM","2020","802","9","811","2023-01-02"
"02423","2022","COM","2020","426","8","434","2023-01-02"
"02424","2022","COM","2020","103","0","103","2023-01-02"
"02425","2022","COM","2020","173","0","173","2023-01-02"
"02426","2022","COM","2020","541","7","548","2023-01-02"
"02427","2022","COM","2020","140","1","141","2023-01-02"
"02428","2022","COM","2020","74","2","76","2023-01-02"
"02429","2022","COM","2020","123","1","124","2023-01-02"
"02430","2022","COM","2020","1270","129","1399","2023-01-02"
"02431","2022","COM","2020","378","9","387","2023-01-02"
"02432","2022","COM","2020","190","5","195","2023-01-02"
"02433","2022","COM","2020","219","7","226","2023-01-02"
"02435","2022","COM","2020","82","0","82","2023-01-02"
"02438","2022","COM","2020","244","9","253","2023-01-02"
"02439","2022","COM","2020","1196","13","1209","2023-01-02"
"02440","2022","COM","2020","138","0","138","2023-01-02"
"02441","2022","COM","2020","181","3","184","2023-01-02"
"02442","2022","COM","2020","90","1","91","2023-01-02"
"02443","2022","COM","2020","206","6","212","2023-01-02"
"02444","2022","COM","2020","125","0","125","2023-01-02"
"02445","2022","COM","2020","277","3","280","2023-01-02"
"02446","2022","COM","2020","118","1","119","2023-01-02"
"02447","2022","COM","2020","148","5","153","2023-01-02"
"02448","2022","COM","2020","117","3","120","2023-01-02"
"02449","2022","COM","2020","64","3","67","2023-01-02"
"02450","2022","COM","2020","361","4","365","2023-01-02"
"02451","2022","COM","2020","122","0","122","2023-01-02"
"02452","2022","COM","2020","235","10","245","2023-01-02"
"02453","2022","COM","2020","404","8","412","2023-01-02"
"02454","2022","COM","2020","404","3","407","2023-01-02"
"02455","2022","COM","2020","196","4","200","2023-01-02"
"02456","2022","COM","2020","295","4","299","2023-01-02"
"02457","2022","COM","2020","389","10","399","2023-01-02"
"02458","2022","COM","2020","822","14","836","2023-01-02"
"02459","2022","COM","2020","158","8","166","2023-01-02"
"02460","2022","COM","2020","206","1","207","2023-01-02"
"02461","2022","COM","2020","369","8","377","2023-01-02"
"02462","2022","COM","2020","229","2","231","2023-01-02"
"02463","2022","COM","2020","87","0","87","2023-01-02"
"02464","2022","COM","2020","366","2","368","2023-01-02"
"02465","2022","COM","2020","527","7","534","2023-01-02"
"02466","2022","COM","2020","131","1","132","2023-01-02"
"02467","2022","COM","2020","50","1","51","2023-01-02"
"02468","2022","COM","2020","2219","31","2250","2023-01-02"
"02469","2022","COM","2020","487","13","500","2023-01-02"
"02470","2022","COM","2020","433","12","445","2023-01-02"
"02471","2022","COM","2020","136","2","138","2023-01-02"
"02472","2022","COM","2020","404","7","411","2023-01-02"
"02473","2022","COM","2020","219","1","220","2023-01-02"
"02474","2022","COM","2020","394","4","398","2023-01-02"
"02476","2022","COM","2020","669","14","683","2023-01-02"
"02477","2022","COM","2020","964","22","986","2023-01-02"
"02478","2022","COM","2020","259","12","271","2023-01-02"
"02480","2022","COM","2020","316","3","319","2023-01-02"
"02481","2022","COM","2020","480","16","496","2023-01-02"
"02482","2022","COM","2020","55","1","56","2023-01-02"
"02483","2022","COM","2020","511","11","522","2023-01-02"
"02484","2022","COM","2020","532","3","535","2023-01-02"
"02485","2022","COM","2020","95","5","100","2023-01-02"
"02486","2022","COM","2020","106","1","107","2023-01-02"
"02487","2022","COM","2020","620","8","628","2023-01-02"
"02488","2022","COM","2020","158","2","160","2023-01-02"
"02489","2022","COM","2020","348","7","355","2023-01-02"
"02490","2022","COM","2020","124","3","127","2023-01-02"
"02491","2022","COM","2020","322","9","331","2023-01-02"
"02492","2022","COM","2020","445","8","453","2023-01-02"
"02493","2022","COM","2020","223","6","229","2023-01-02"
"02494","2022","COM","2020","127","2","129","2023-01-02"
"02495","2022","COM","2020","1043","15","1058","2023-01-02"
"02496","2022","COM","2020","98","1","99","2023-01-02"
"02497","2022","COM","2020","1151","30","1181","2023-01-02"
"02498","2022","COM","2020","762","17","779","2023-01-02"
"02499","2022","COM","2020","42","2","44","2023-01-02"
"02500","2022","COM","2020","807","18","825","2023-01-02"
"02501","2022","COM","2020","97","2","99","2023-01-02"
"02502","2022","COM","2020","1291","12","1303","2023-01-02"
"02503","2022","COM","2020","827","2","829","2023-01-02"
"02504","2022","COM","2020","1608","27","1635","2023-01-02"
"02505","2022","COM","2020","207","5","212","2023-01-02"
"02506","2022","COM","2020","197","4","201","2023-01-02"
"02507","2022","COM","2020","31","0","31","2023-01-02"
"02508","2022","COM","2020","152","6","158","2023-01-02"
"02509","2022","COM","2020","153","0","153","2023-01-02"
"02510","2022","COM","2020","146","5","151","2023-01-02"
"02511","2022","COM","2020","302","6","308","2023-01-02"
"02512","2022","COM","2020","269","5","274","2023-01-02"
"02513","2022","COM","2020","136","2","138","2023-01-02"
"02514","2022","COM","2020","702","15","717","2023-01-02"
"02515","2022","COM","2020","53","4","57","2023-01-02"
"02516","2022","COM","2020","69","1","70","2023-01-02"
"02517","2022","COM","2020","295","5","300","2023-01-02"
"02518","2022","COM","2020","301","2","303","2023-01-02"
"02519","2022","COM","2020","188","4","192","2023-01-02"
"02520","2022","COM","2020","737","5","742","2023-01-02"
"02521","2022","COM","2020","1374","14","1388","2023-01-02"
"02522","2022","COM","2020","73","2","75","2023-01-02"
"02523","2022","COM","2020","71","1","72","2023-01-02"
"02524","2022","COM","2020","692","18","710","2023-01-02"
"02525","2022","COM","2020","566","6","572","2023-01-02"
"02526","2022","COM","2020","102","3","105","2023-01-02"
"02527","2022","COM","2020","461","9","470","2023-01-02"
"02528","2022","COM","2020","223","6","229","2023-01-02"
"02529","2022","COM","2020","180","3","183","2023-01-02"
"02530","2022","COM","2020","78","1","79","2023-01-02"
"02531","2022","COM","2020","125","3","128","2023-01-02"
"02532","2022","COM","2020","983","18","1001","2023-01-02"
"02533","2022","COM","2020","108","6","114","2023-01-02"
"02534","2022","COM","2020","47","1","48","2023-01-02"
"02535","2022","COM","2020","113","5","118","2023-01-02"
"02536","2022","COM","2020","104","1","105","2023-01-02"
"02537","2022","COM","2020","203","1","204","2023-01-02"
"02538","2022","COM","2020","74","0","74","2023-01-02"
"02539","2022","COM","2020","699","7","706","2023-01-02"
"02540","2022","COM","2020","1216","36","1252","2023-01-02"
"02541","2022","COM","2020","420","5","425","2023-01-02"
"02542","2022","COM","2020","80","2","82","2023-01-02"
"02543","2022","COM","2020","2055","34","2089","2023-01-02"
"02544","2022","COM","2020","613","11","624","2023-01-02"
"02545","2022","COM","2020","187","2","189","2023-01-02"
"02546","2022","COM","2020","188","4","192","2023-01-02"
"02547","2022","COM","2020","66","1","67","2023-01-02"
"02548","2022","COM","2020","382","6","388","2023-01-02"
"02549","2022","COM","2020","849","22","871","2023-01-02"
"02550","2022","COM","2020","120","3","123","2023-01-02"
"02551","2022","COM","2020","110","0","110","2023-01-02"
"02552","2022","COM","2020","190","8","198","2023-01-02"
"02553","2022","COM","2020","247","4","251","2023-01-02"
"02554","2022","COM","2020","1100","23","1123","2023-01-02"
"02555","2022","COM","2020","2095","45","2140","2023-01-02"
"02556","2022","COM","2020","77","2","79","2023-01-02"
"02557","2022","COM","2020","128","0","128","2023-01-02"
"02558","2022","COM","2020","2531","25","2556","2023-01-02"
"02559","2022","COM","2020","483","6","489","2023-01-02"
"02560","2022","COM","2020","245","4","249","2023-01-02"
"02561","2022","COM","2020","147","4","151","2023-01-02"
"02562","2022","COM","2020","206","2","208","2023-01-02"
"02563","2022","COM","2020","163","3","166","2023-01-02"
"02564","2022","COM","2020","491","6","497","2023-01-02"
"02565","2022","COM","2020","293","3","296","2023-01-02"
"02566","2022","COM","2020","1106","22","1128","2023-01-02"
"02567","2022","COM","2020","275","8","283","2023-01-02"
"02568","2022","COM","2020","165","4","169","2023-01-02"
"02569","2022","COM","2020","476","3","479","2023-01-02"
"02570","2022","COM","2020","174","0","174","2023-01-02"
"02571","2022","COM","2020","711","75","786","2023-01-02"
"02572","2022","COM","2020","500","9","509","2023-01-02"
"02573","2022","COM","2020","57","1","58","2023-01-02"
"02574","2022","COM","2020","1409","21","1430","2023-01-02"
"02575","2022","COM","2020","1660","12","1672","2023-01-02"
"02576","2022","COM","2020","328","8","336","2023-01-02"
"02577","2022","COM","2020","91","1","92","2023-01-02"
"02578","2022","COM","2020","86","1","87","2023-01-02"
"02579","2022","COM","2020","124","9","133","2023-01-02"
"02580","2022","COM","2020","816","9","825","2023-01-02"
"02581","2022","COM","2020","320","1","321","2023-01-02"
"02582","2022","COM","2020","77","2","79","2023-01-02"
"02583","2022","COM","2020","53","2","55","2023-01-02"
"02584","2022","COM","2020","117","7","124","2023-01-02"
"02585","2022","COM","2020","255","6","261","2023-01-02"
"02586","2022","COM","2020","138","6","144","2023-01-02"
"02587","2022","COM","2020","353","11","364","2023-01-02"
"02588","2022","COM","2020","67","2","69","2023-01-02"
"02589","2022","COM","2020","262","0","262","2023-01-02"
"02590","2022","COM","2020","169","2","171","2023-01-02"
"02591","2022","COM","2020","136","2","138","2023-01-02"
"02592","2022","COM","2020","193","5","198","2023-01-02"
"02593","2022","COM","2020","1067","21","1088","2023-01-02"
"02594","2022","COM","2020","129","6","135","2023-01-02"
"02595","2022","COM","2020","137","0","137","2023-01-02"
"02596","2022","COM","2020","762","13","775","2023-01-02"
"02598","2022","COM","2020","679","18","697","2023-01-02"
"02599","2022","COM","2020","253","3","256","2023-01-02"
"02600","2022","COM","2020","340","5","345","2023-01-02"
"02601","2022","COM","2020","190","4","194","2023-01-02"
"02602","2022","COM","2020","1668","25","1693","2023-01-02"
"02604","2022","COM","2020","82","0","82","2023-01-02"
"02605","2022","COM","2020","192","5","197","2023-01-02"
"02606","2022","COM","2020","69","3","72","2023-01-02"
"02607","2022","COM","2020","84","1","85","2023-01-02"
"02608","2022","COM","2020","468","2","470","2023-01-02"
"02609","2022","COM","2020","21","1","22","2023-01-02"
"02610","2022","COM","2020","741","11","752","2023-01-02"
"02612","2022","COM","2020","124","2","126","2023-01-02"
"02613","2022","COM","2020","603","11","614","2023-01-02"
"02614","2022","COM","2020","272","7","279","2023-01-02"
"02615","2022","COM","2020","357","13","370","2023-01-02"
"02616","2022","COM","2020","202","3","205","2023-01-02"
"02617","2022","COM","2020","507","4","511","2023-01-02"
"02618","2022","COM","2020","691","11","702","2023-01-02"
"02619","2022","COM","2020","637","6","643","2023-01-02"
"02620","2022","COM","2020","341","7","348","2023-01-02"
"02621","2022","COM","2020","386","8","394","2023-01-02"
"02622","2022","COM","2020","55","0","55","2023-01-02"
"02623","2022","COM","2020","96","3","99","2023-01-02"
"02624","2022","COM","2020","272","65","337","2023-01-02"
"02625","2022","COM","2020","142","2","144","2023-01-02"
"02626","2022","COM","2020","336","7","343","2023-01-02"
"02627","2022","COM","2020","126","2","128","2023-01-02"
"02628","2022","COM","2020","218","6","224","2023-01-02"
"02629","2022","COM","2020","322","12","334","2023-01-02"
"02631","2022","COM","2020","409","5","414","2023-01-02"
"02632","2022","COM","2020","56","1","57","2023-01-02"
"02633","2022","COM","2020","61","2","63","2023-01-02"
"02634","2022","COM","2020","85","4","89","2023-01-02"
"02635","2022","COM","2020","146","2","148","2023-01-02"
"02636","2022","COM","2020","200","5","205","2023-01-02"
"02637","2022","COM","2020","291","10","301","2023-01-02"
"02638","2022","COM","2020","238","1","239","2023-01-02"
"02639","2022","COM","2020","346","7","353","2023-01-02"
"02640","2022","COM","2020","155","4","159","2023-01-02"
"02641","2022","COM","2020","111","3","114","2023-01-02"
"02642","2022","COM","2020","166","3","169","2023-01-02"
"02643","2022","COM","2020","784","8","792","2023-01-02"
"02644","2022","COM","2020","340","12","352","2023-01-02"
"02645","2022","COM","2020","188","8","196","2023-01-02"
"02647","2022","COM","2020","59","0","59","2023-01-02"
"02648","2022","COM","2020","1914","37","1951","2023-01-02"
"02649","2022","COM","2020","309","4","313","2023-01-02"
"02650","2022","COM","2020","359","6","365","2023-01-02"
"02651","2022","COM","2020","106","1","107","2023-01-02"
"02652","2022","COM","2020","103","1","104","2023-01-02"
"02653","2022","COM","2020","498","13","511","2023-01-02"
"02654","2022","COM","2020","83","1","84","2023-01-02"
"02655","2022","COM","2020","146","0","146","2023-01-02"
"02656","2022","COM","2020","394","10","404","2023-01-02"
"02657","2022","COM","2020","234","5","239","2023-01-02"
"02658","2022","COM","2020","239","6","245","2023-01-02"
"02659","2022","COM","2020","505","13","518","2023-01-02"
"02660","2022","COM","2020","37","2","39","2023-01-02"
"02661","2022","COM","2020","245","3","248","2023-01-02"
"02662","2022","COM","2020","328","9","337","2023-01-02"
"02663","2022","COM","2020","225","5","230","2023-01-02"
"02664","2022","COM","2020","122","3","125","2023-01-02"
"02665","2022","COM","2020","299","5","304","2023-01-02"
"02666","2022","COM","2020","975","13","988","2023-01-02"
"02667","2022","COM","2020","201","5","206","2023-01-02"
"02668","2022","COM","2020","1018","26","1044","2023-01-02"
"02670","2022","COM","2020","150","1","151","2023-01-02"
"02671","2022","COM","2020","283","5","288","2023-01-02"
"02672","2022","COM","2020","254","8","262","2023-01-02"
"02673","2022","COM","2020","442","7","449","2023-01-02"
"02674","2022","COM","2020","49","0","49","2023-01-02"
"02675","2022","COM","2020","134","1","135","2023-01-02"
"02676","2022","COM","2020","1711","26","1737","2023-01-02"
"02677","2022","COM","2020","238","3","241","2023-01-02"
"02678","2022","COM","2020","67","0","67","2023-01-02"
"02679","2022","COM","2020","151","4","155","2023-01-02"
"02680","2022","COM","2020","2304","39","2343","2023-01-02"
"02681","2022","COM","2020","280","6","286","2023-01-02"
"02682","2022","COM","2020","115","3","118","2023-01-02"
"02683","2022","COM","2020","108","2","110","2023-01-02"
"02684","2022","COM","2020","3279","60","3339","2023-01-02"
"02685","2022","COM","2020","121","1","122","2023-01-02"
"02686","2022","COM","2020","368","6","374","2023-01-02"
"02687","2022","COM","2020","335","9","344","2023-01-02"
"02688","2022","COM","2020","45","4","49","2023-01-02"
"02689","2022","COM","2020","41","1","42","2023-01-02"
"02690","2022","COM","2020","76","1","77","2023-01-02"
"02691","2022","COM","2020","53100","1247","54347","2023-01-02"
"02693","2022","COM","2020","223","3","226","2023-01-02"
"02694","2022","COM","2020","627","14","641","2023-01-02"
"02696","2022","COM","2020","74","3","77","2023-01-02"
"02697","2022","COM","2020","383","5","388","2023-01-02"
"02698","2022","COM","2020","102","2","104","2023-01-02"
"02699","2022","COM","2020","276","3","279","2023-01-02"
"02701","2022","COM","2020","704","7","711","2023-01-02"
"02702","2022","COM","2020","605","13","618","2023-01-02"
"02703","2022","COM","2020","1082","15","1097","2023-01-02"
"02704","2022","COM","2020","234","3","237","2023-01-02"
"02705","2022","COM","2020","206","6","212","2023-01-02"
"02706","2022","COM","2020","568","12","580","2023-01-02"
"02707","2022","COM","2020","179","0","179","2023-01-02"
"02708","2022","COM","2020","214","8","222","2023-01-02"
"02709","2022","COM","2020","406","8","414","2023-01-02"
"02710","2022","COM","2020","729","18","747","2023-01-02"
"02711","2022","COM","2020","285","6","291","2023-01-02"
"02712","2022","COM","2020","141","3","144","2023-01-02"
"02713","2022","COM","2020","267","3","270","2023-01-02"
"02714","2022","COM","2020","361","1","362","2023-01-02"
"02715","2022","COM","2020","42","3","45","2023-01-02"
"02716","2022","COM","2020","290","6","296","2023-01-02"
"02717","2022","COM","2020","597","13","610","2023-01-02"
"02718","2022","COM","2020","118","3","121","2023-01-02"
"02719","2022","COM","2020","2013","41","2054","2023-01-02"
"02720","2022","COM","2020","2062","73","2135","2023-01-02"
"02721","2022","COM","2020","475","2","477","2023-01-02"
"02722","2022","COM","2020","28888","655","29543","2023-01-02"
"02723","2022","COM","2020","97","1","98","2023-01-02"
"02724","2022","COM","2020","61","1","62","2023-01-02"
"02725","2022","COM","2020","137","6","143","2023-01-02"
"02726","2022","COM","2020","175","2","177","2023-01-02"
"02727","2022","COM","2020","211","3","214","2023-01-02"
"02728","2022","COM","2020","260","4","264","2023-01-02"
"02729","2022","COM","2020","79","1","80","2023-01-02"
"02730","2022","COM","2020","265","7","272","2023-01-02"
"02731","2022","COM","2020","173","2","175","2023-01-02"
"02732","2022","COM","2020","104","0","104","2023-01-02"
"02734","2022","COM","2020","272","6","278","2023-01-02"
"02735","2022","COM","2020","17","0","17","2023-01-02"
"02736","2022","COM","2020","166","5","171","2023-01-02"
"02737","2022","COM","2020","552","12","564","2023-01-02"
"02738","2022","COM","2020","13504","190","13694","2023-01-02"
"02739","2022","COM","2020","336","7","343","2023-01-02"
"02740","2022","COM","2020","221","6","227","2023-01-02"
"02741","2022","COM","2020","540","5","545","2023-01-02"
"02742","2022","COM","2020","117","0","117","2023-01-02"
"02743","2022","COM","2020","156","1","157","2023-01-02"
"02744","2022","COM","2020","70","2","72","2023-01-02"
"02745","2022","COM","2020","117","1","118","2023-01-02"
"02746","2022","COM","2020","658","11","669","2023-01-02"
"02747","2022","COM","2020","84","0","84","2023-01-02"
"02748","2022","COM","2020","934","25","959","2023-01-02"
"02749","2022","COM","2020","216","10","226","2023-01-02"
"02750","2022","COM","2020","568","8","576","2023-01-02"
"02751","2022","COM","2020","143","2","145","2023-01-02"
"02752","2022","COM","2020","284","4","288","2023-01-02"
"02753","2022","COM","2020","327","4","331","2023-01-02"
"02754","2022","COM","2020","186","3","189","2023-01-02"
"02755","2022","COM","2020","571","12","583","2023-01-02"
"02756","2022","COM","2020","689","12","701","2023-01-02"
"02757","2022","COM","2020","521","10","531","2023-01-02"
"02758","2022","COM","2020","2017","37","2054","2023-01-02"
"02759","2022","COM","2020","366","6","372","2023-01-02"
"02760","2022","COM","2020","138","3","141","2023-01-02"
"02761","2022","COM","2020","211","4","215","2023-01-02"
"02762","2022","COM","2020","150","3","153","2023-01-02"
"02763","2022","COM","2020","219","4","223","2023-01-02"
"02764","2022","COM","2020","90","3","93","2023-01-02"
"02765","2022","COM","2020","237","10","247","2023-01-02"
"02766","2022","COM","2020","236","4","240","2023-01-02"
"02767","2022","COM","2020","321","3","324","2023-01-02"
"02768","2022","COM","2020","530","10","540","2023-01-02"
"02769","2022","COM","2020","906","16","922","2023-01-02"
"02770","2022","COM","2020","785","20","805","2023-01-02"
"02772","2022","COM","2020","154","5","159","2023-01-02"
"02773","2022","COM","2020","39","0","39","2023-01-02"
"02774","2022","COM","2020","119","1","120","2023-01-02"
"02775","2022","COM","2020","929","17","946","2023-01-02"
"02776","2022","COM","2020","561","12","573","2023-01-02"
"02777","2022","COM","2020","137","7","144","2023-01-02"
"02778","2022","COM","2020","94","1","95","2023-01-02"
"02779","2022","COM","2020","220","3","223","2023-01-02"
"02780","2022","COM","2020","1363","24","1387","2023-01-02"
"02781","2022","COM","2020","451","15","466","2023-01-02"
"02782","2022","COM","2020","221","2","223","2023-01-02"
"02783","2022","COM","2020","137","0","137","2023-01-02"
"02784","2022","COM","2020","144","2","146","2023-01-02"
"02785","2022","COM","2020","1101","31","1132","2023-01-02"
"02786","2022","COM","2020","126","2","128","2023-01-02"
"02787","2022","COM","2020","260","2","262","2023-01-02"
"02788","2022","COM","2020","462","7","469","2023-01-02"
"02789","2022","COM","2020","2600","95","2695","2023-01-02"
"02790","2022","COM","2020","239","3","242","2023-01-02"
"02791","2022","COM","2020","261","6","267","2023-01-02"
"02792","2022","COM","2020","156","7","163","2023-01-02"
"02793","2022","COM","2020","116","1","117","2023-01-02"
"02794","2022","COM","2020","187","8","195","2023-01-02"
"02795","2022","COM","2020","1604","19","1623","2023-01-02"
"02796","2022","COM","2020","86","2","88","2023-01-02"
"02797","2022","COM","2020","172","0","172","2023-01-02"
"02798","2022","COM","2020","1214","19","1233","2023-01-02"
"02799","2022","COM","2020","400","10","410","2023-01-02"
"02800","2022","COM","2020","313","5","318","2023-01-02"
"02801","2022","COM","2020","270","6","276","2023-01-02"
"02802","2022","COM","2020","208","2","210","2023-01-02"
"02803","2022","COM","2020","145","5","150","2023-01-02"
"02804","2022","COM","2020","191","5","196","2023-01-02"
"02805","2022","COM","2020","2549","42","2591","2023-01-02"
"02806","2022","COM","2020","300","5","305","2023-01-02"
"02807","2022","COM","2020","661","23","684","2023-01-02"
"02808","2022","COM","2020","282","7","289","2023-01-02"
"02809","2022","COM","2020","68","3","71","2023-01-02"
"02810","2022","COM","2020","10392","411","10803","2023-01-02"
"02812","2022","COM","2020","203","6","209","2023-01-02"
"02813","2022","COM","2020","245","7","252","2023-01-02"
"02814","2022","COM","2020","161","0","161","2023-01-02"
"02815","2022","COM","2020","427","15","442","2023-01-02"
"02816","2022","COM","2020","535","6","541","2023-01-02"
"02817","2022","COM","2020","82","1","83","2023-01-02"
"02818","2022","COM","2020","1161","10","1171","2023-01-02"
"02819","2022","COM","2020","111","4","115","2023-01-02"
"02820","2022","COM","2020","1688","43","1731","2023-01-02"
"02821","2022","COM","2020","674","21","695","2023-01-02"
"02822","2022","COM","2020","397","7","404","2023-01-02"
"02823","2022","COM","2020","75","0","75","2023-01-02"
"02824","2022","COM","2020","374","7","381","2023-01-02"
"02826","2022","COM","2020","348","7","355","2023-01-02"
"02827","2022","COM","2020","306","4","310","2023-01-02"
"02828","2022","COM","2020","92","0","92","2023-01-02"
"02829","2022","COM","2020","41","1","42","2023-01-02"
"02830","2022","COM","2020","959","16","975","2023-01-02"
"02831","2022","COM","2020","378","6","384","2023-01-02"
"02832","2022","COM","2020","186","5","191","2023-01-02"
"02833","2022","COM","2020","493","7","500","2023-01-02"
"02834","2022","COM","2020","173","6","179","2023-01-02"
"03001","2022","COM","2020","2899","62","2961","2023-01-02"
"03002","2022","COM","2020","309","12","321","2023-01-02"
"03003","2022","COM","2020","983","29","1012","2023-01-02"
"03004","2022","COM","2020","241","8","249","2023-01-02"
"03005","2022","COM","2020","337","4","341","2023-01-02"
"03006","2022","COM","2020","629","17","646","2023-01-02"
"03007","2022","COM","2020","356","7","363","2023-01-02"
"03008","2022","COM","2020","376","9","385","2023-01-02"
"03009","2022","COM","2020","136","34","170","2023-01-02"
"03010","2022","COM","2020","419","9","428","2023-01-02"
"03011","2022","COM","2020","425","9","434","2023-01-02"
"03012","2022","COM","2020","316","5","321","2023-01-02"
"03013","2022","COM","2020","4012","97","4109","2023-01-02"
"03014","2022","COM","2020","136","2","138","2023-01-02"
"03015","2022","COM","2020","331","11","342","2023-01-02"
"03016","2022","COM","2020","142","2","144","2023-01-02"
"03017","2022","COM","2020","187","6","193","2023-01-02"
"03018","2022","COM","2020","680","14","694","2023-01-02"
"03019","2022","COM","2020","1628","24","1652","2023-01-02"
"03020","2022","COM","2020","292","6","298","2023-01-02"
"03021","2022","COM","2020","222","2","224","2023-01-02"
"03022","2022","COM","2020","985","17","1002","2023-01-02"
"03023","2022","COM","2020","8844","236","9080","2023-01-02"
"03024","2022","COM","2020","234","4","238","2023-01-02"
"03025","2022","COM","2020","1347","21","1368","2023-01-02"
"03026","2022","COM","2020","761","18","779","2023-01-02"
"03027","2022","COM","2020","920","28","948","2023-01-02"
"03028","2022","COM","2020","362","8","370","2023-01-02"
"03029","2022","COM","2020","796","16","812","2023-01-02"
"03030","2022","COM","2020","879","16","895","2023-01-02"
"03031","2022","COM","2020","293","11","304","2023-01-02"
"03032","2022","COM","2020","243","1","244","2023-01-02"
"03033","2022","COM","2020","181","4","185","2023-01-02"
"03034","2022","COM","2020","493","12","505","2023-01-02"
"03035","2022","COM","2020","206","3","209","2023-01-02"
"03036","2022","COM","2020","2566","69","2635","2023-01-02"
"03037","2022","COM","2020","260","2","262","2023-01-02"
"03038","2022","COM","2020","526","9","535","2023-01-02"
"03039","2022","COM","2020","384","7","391","2023-01-02"
"03040","2022","COM","2020","1132","38","1170","2023-01-02"
"03041","2022","COM","2020","321","8","329","2023-01-02"
"03042","2022","COM","2020","531","11","542","2023-01-02"
"03043","2022","COM","2020","1191","78","1269","2023-01-02"
"03044","2022","COM","2020","1531","36","1567","2023-01-02"
"03045","2022","COM","2020","833","18","851","2023-01-02"
"03046","2022","COM","2020","1010","24","1034","2023-01-02"
"03047","2022","COM","2020","405","7","412","2023-01-02"
"03048","2022","COM","2020","1305","23","1328","2023-01-02"
"03049","2022","COM","2020","427","10","437","2023-01-02"
"03050","2022","COM","2020","177","9","186","2023-01-02"
"03051","2022","COM","2020","294","8","302","2023-01-02"
"03052","2022","COM","2020","1090","26","1116","2023-01-02"
"03053","2022","COM","2020","1105","26","1131","2023-01-02"
"03054","2022","COM","2020","237","7","244","2023-01-02"
"03055","2022","COM","2020","945","15","960","2023-01-02"
"03056","2022","COM","2020","388","7","395","2023-01-02"
"03057","2022","COM","2020","196","6","202","2023-01-02"
"03058","2022","COM","2020","240","7","247","2023-01-02"
"03059","2022","COM","2020","367","8","375","2023-01-02"
"03060","2022","COM","2020","1039","17","1056","2023-01-02"
"03061","2022","COM","2020","387","10","397","2023-01-02"
"03062","2022","COM","2020","346","17","363","2023-01-02"
"03063","2022","COM","2020","1030","20","1050","2023-01-02"
"03064","2022","COM","2020","175","4","179","2023-01-02"
"03065","2022","COM","2020","546","9","555","2023-01-02"
"03066","2022","COM","2020","321","5","326","2023-01-02"
"03067","2022","COM","2020","134","4","138","2023-01-02"
"03068","2022","COM","2020","103","1","104","2023-01-02"
"03069","2022","COM","2020","311","6","317","2023-01-02"
"03070","2022","COM","2020","135","4","139","2023-01-02"
"03071","2022","COM","2020","250","4","254","2023-01-02"
"03072","2022","COM","2020","495","10","505","2023-01-02"
"03073","2022","COM","2020","621","12","633","2023-01-02"
"03074","2022","COM","2020","648","15","663","2023-01-02"
"03075","2022","COM","2020","164","2","166","2023-01-02"
"03076","2022","COM","2020","219","7","226","2023-01-02"
"03077","2022","COM","2020","128","2","130","2023-01-02"
"03078","2022","COM","2020","229","8","237","2023-01-02"
"03079","2022","COM","2020","296","4","300","2023-01-02"
"03080","2022","COM","2020","702","11","713","2023-01-02"
"03081","2022","COM","2020","323","13","336","2023-01-02"
"03082","2022","COM","2020","6100","185","6285","2023-01-02"
"03083","2022","COM","2020","575","12","587","2023-01-02"
"03084","2022","COM","2020","2031","29","2060","2023-01-02"
"03085","2022","COM","2020","641","54","695","2023-01-02"
"03086","2022","COM","2020","305","8","313","2023-01-02"
"03087","2022","COM","2020","597","6","603","2023-01-02"
"03088","2022","COM","2020","316","4","320","2023-01-02"
"03089","2022","COM","2020","154","7","161","2023-01-02"
"03090","2022","COM","2020","307","7","314","2023-01-02"
"03091","2022","COM","2020","436","9","445","2023-01-02"
"03092","2022","COM","2020","629","14","643","2023-01-02"
"03093","2022","COM","2020","1219","28","1247","2023-01-02"
"03094","2022","COM","2020","3283","102","3385","2023-01-02"
"03095","2022","COM","2020","12677","477","13154","2023-01-02"
"03096","2022","COM","2020","89","1","90","2023-01-02"
"03097","2022","COM","2020","359","9","368","2023-01-02"
"03098","2022","COM","2020","4465","100","4565","2023-01-02"
"03099","2022","COM","2020","388","12","400","2023-01-02"
"03100","2022","COM","2020","1373","35","1408","2023-01-02"
"03101","2022","COM","2020","8698","173","8871","2023-01-02"
"03102","2022","COM","2020","3010","52","3062","2023-01-02"
"03103","2022","COM","2020","1046","16","1062","2023-01-02"
"03104","2022","COM","2020","1167","34","1201","2023-01-02"
"03105","2022","COM","2020","360","7","367","2023-01-02"
"03106","2022","COM","2020","1317","103","1420","2023-01-02"
"03107","2022","COM","2020","1269","27","1296","2023-01-02"
"03108","2022","COM","2020","373","6","379","2023-01-02"
"03109","2022","COM","2020","788","34","822","2023-01-02"
"03110","2022","COM","2020","977","26","1003","2023-01-02"
"03111","2022","COM","2020","1117","24","1141","2023-01-02"
"03112","2022","COM","2020","665","9","674","2023-01-02"
"03113","2022","COM","2020","527","16","543","2023-01-02"
"03114","2022","COM","2020","271","7","278","2023-01-02"
"03115","2022","COM","2020","344","6","350","2023-01-02"
"03116","2022","COM","2020","188","5","193","2023-01-02"
"03117","2022","COM","2020","479","12","491","2023-01-02"
"03118","2022","COM","2020","5815","197","6012","2023-01-02"
"03119","2022","COM","2020","414","4","418","2023-01-02"
"03120","2022","COM","2020","711","13","724","2023-01-02"
"03121","2022","COM","2020","636","17","653","2023-01-02"
"03122","2022","COM","2020","235","5","240","2023-01-02"
"03124","2022","COM","2020","219","4","223","2023-01-02"
"03125","2022","COM","2020","122","2","124","2023-01-02"
"03126","2022","COM","2020","1176","14","1190","2023-01-02"
"03127","2022","COM","2020","601","15","616","2023-01-02"
"03128","2022","COM","2020","2632","56","2688","2023-01-02"
"03129","2022","COM","2020","308","12","320","2023-01-02"
"03130","2022","COM","2020","280","6","286","2023-01-02"
"03131","2022","COM","2020","553","12","565","2023-01-02"
"03132","2022","COM","2020","554","16","570","2023-01-02"
"03133","2022","COM","2020","524","10","534","2023-01-02"
"03134","2022","COM","2020","193","1","194","2023-01-02"
"03135","2022","COM","2020","412","9","421","2023-01-02"
"03136","2022","COM","2020","225","9","234","2023-01-02"
"03137","2022","COM","2020","270","6","276","2023-01-02"
"03138","2022","COM","2020","3137","73","3210","2023-01-02"
"03139","2022","COM","2020","314","11","325","2023-01-02"
"03140","2022","COM","2020","1147","14","1161","2023-01-02"
"03141","2022","COM","2020","149","2","151","2023-01-02"
"03142","2022","COM","2020","242","4","246","2023-01-02"
"03143","2022","COM","2020","91","3","94","2023-01-02"
"03144","2022","COM","2020","210","7","217","2023-01-02"
"03145","2022","COM","2020","743","12","755","2023-01-02"
"03146","2022","COM","2020","168","28","196","2023-01-02"
"03147","2022","COM","2020","167","2","169","2023-01-02"
"03148","2022","COM","2020","348","5","353","2023-01-02"
"03149","2022","COM","2020","429","11","440","2023-01-02"
"03150","2022","COM","2020","202","5","207","2023-01-02"
"03151","2022","COM","2020","157","4","161","2023-01-02"
"03152","2022","COM","2020","230","5","235","2023-01-02"
"03154","2022","COM","2020","273","3","276","2023-01-02"
"03155","2022","COM","2020","1881","42","1923","2023-01-02"
"03156","2022","COM","2020","1670","52","1722","2023-01-02"
"03157","2022","COM","2020","1035","23","1058","2023-01-02"
"03158","2022","COM","2020","860","15","875","2023-01-02"
"03159","2022","COM","2020","776","14","790","2023-01-02"
"03160","2022","COM","2020","412","4","416","2023-01-02"
"03161","2022","COM","2020","902","25","927","2023-01-02"
"03162","2022","COM","2020","201","6","207","2023-01-02"
"03163","2022","COM","2020","729","21","750","2023-01-02"
"03164","2022","COM","2020","283","3","286","2023-01-02"
"03165","2022","COM","2020","1386","86","1472","2023-01-02"
"03166","2022","COM","2020","308","5","313","2023-01-02"
"03167","2022","COM","2020","287","4","291","2023-01-02"
"03168","2022","COM","2020","908","13","921","2023-01-02"
"03169","2022","COM","2020","323","6","329","2023-01-02"
"03170","2022","COM","2020","125","6","131","2023-01-02"
"03171","2022","COM","2020","243","6","249","2023-01-02"
"03172","2022","COM","2020","122","2","124","2023-01-02"
"03173","2022","COM","2020","1144","32","1176","2023-01-02"
"03174","2022","COM","2020","924","25","949","2023-01-02"
"03175","2022","COM","2020","277","11","288","2023-01-02"
"03176","2022","COM","2020","542","10","552","2023-01-02"
"03177","2022","COM","2020","247","5","252","2023-01-02"
"03178","2022","COM","2020","290","6","296","2023-01-02"
"03179","2022","COM","2020","298","4","302","2023-01-02"
"03180","2022","COM","2020","654","11","665","2023-01-02"
"03181","2022","COM","2020","295","2","297","2023-01-02"
"03182","2022","COM","2020","262","1","263","2023-01-02"
"03183","2022","COM","2020","469","4","473","2023-01-02"
"03184","2022","COM","2020","504","8","512","2023-01-02"
"03185","2022","COM","2020","33822","1046","34868","2023-01-02"
"03186","2022","COM","2020","1523","18","1541","2023-01-02"
"03187","2022","COM","2020","625","9","634","2023-01-02"
"03188","2022","COM","2020","216","4","220","2023-01-02"
"03189","2022","COM","2020","709","25","734","2023-01-02"
"03190","2022","COM","2020","19444","553","19997","2023-01-02"
"03191","2022","COM","2020","272","8","280","2023-01-02"
"03192","2022","COM","2020","150","3","153","2023-01-02"
"03193","2022","COM","2020","191","4","195","2023-01-02"
"03194","2022","COM","2020","125","2","127","2023-01-02"
"03195","2022","COM","2020","2588","98","2686","2023-01-02"
"03196","2022","COM","2020","213","5","218","2023-01-02"
"03197","2022","COM","2020","1452","30","1482","2023-01-02"
"03198","2022","COM","2020","192","3","195","2023-01-02"
"03200","2022","COM","2020","1493","259","1752","2023-01-02"
"03201","2022","COM","2020","301","13","314","2023-01-02"
"03202","2022","COM","2020","593","15","608","2023-01-02"
"03203","2022","COM","2020","385","8","393","2023-01-02"
"03204","2022","COM","2020","618","16","634","2023-01-02"
"03205","2022","COM","2020","438","11","449","2023-01-02"
"03206","2022","COM","2020","162","6","168","2023-01-02"
"03207","2022","COM","2020","514","13","527","2023-01-02"
"03208","2022","COM","2020","425","8","433","2023-01-02"
"03209","2022","COM","2020","151","3","154","2023-01-02"
"03210","2022","COM","2020","394","4","398","2023-01-02"
"03211","2022","COM","2020","2506","47","2553","2023-01-02"
"03212","2022","COM","2020","1527","25","1552","2023-01-02"
"03213","2022","COM","2020","253","4","257","2023-01-02"
"03214","2022","COM","2020","365","5","370","2023-01-02"
"03215","2022","COM","2020","543","8","551","2023-01-02"
"03216","2022","COM","2020","173","2","175","2023-01-02"
"03217","2022","COM","2020","761","34","795","2023-01-02"
"03218","2022","COM","2020","270","8","278","2023-01-02"
"03219","2022","COM","2020","215","3","218","2023-01-02"
"03220","2022","COM","2020","717","16","733","2023-01-02"
"03221","2022","COM","2020","732","8","740","2023-01-02"
"03222","2022","COM","2020","89","5","94","2023-01-02"
"03223","2022","COM","2020","437","14","451","2023-01-02"
"03224","2022","COM","2020","285","7","292","2023-01-02"
"03225","2022","COM","2020","441","9","450","2023-01-02"
"03226","2022","COM","2020","248","4","252","2023-01-02"
"03227","2022","COM","2020","374","7","381","2023-01-02"
"03228","2022","COM","2020","44","0","44","2023-01-02"
"03229","2022","COM","2020","605","16","621","2023-01-02"
"03230","2022","COM","2020","526","5","531","2023-01-02"
"03231","2022","COM","2020","188","9","197","2023-01-02"
"03232","2022","COM","2020","298","9","307","2023-01-02"
"03233","2022","COM","2020","389","7","396","2023-01-02"
"03234","2022","COM","2020","368","11","379","2023-01-02"
"03235","2022","COM","2020","964","10","974","2023-01-02"
"03236","2022","COM","2020","3653","70","3723","2023-01-02"
"03237","2022","COM","2020","426","8","434","2023-01-02"
"03238","2022","COM","2020","522","9","531","2023-01-02"
"03239","2022","COM","2020","263","12","275","2023-01-02"
"03240","2022","COM","2020","539","10","549","2023-01-02"
"03241","2022","COM","2020","368","45","413","2023-01-02"
"03242","2022","COM","2020","565","13","578","2023-01-02"
"03243","2022","COM","2020","124","2","126","2023-01-02"
"03244","2022","COM","2020","127","1","128","2023-01-02"
"03245","2022","COM","2020","124","1","125","2023-01-02"
"03246","2022","COM","2020","592","12","604","2023-01-02"
"03247","2022","COM","2020","1119","33","1152","2023-01-02"
"03248","2022","COM","2020","163","2","165","2023-01-02"
"03249","2022","COM","2020","161","3","164","2023-01-02"
"03250","2022","COM","2020","347","7","354","2023-01-02"
"03251","2022","COM","2020","392","6","398","2023-01-02"
"03252","2022","COM","2020","698","17","715","2023-01-02"
"03253","2022","COM","2020","374","10","384","2023-01-02"
"03254","2022","COM","2020","5100","121","5221","2023-01-02"
"03255","2022","COM","2020","144","3","147","2023-01-02"
"03256","2022","COM","2020","209","5","214","2023-01-02"
"03257","2022","COM","2020","801","22","823","2023-01-02"
"03258","2022","COM","2020","1758","25","1783","2023-01-02"
"03259","2022","COM","2020","333","3","336","2023-01-02"
"03260","2022","COM","2020","223","6","229","2023-01-02"
"03261","2022","COM","2020","178","7","185","2023-01-02"
"03262","2022","COM","2020","2097","37","2134","2023-01-02"
"03263","2022","COM","2020","197","9","206","2023-01-02"
"03264","2022","COM","2020","2554","56","2610","2023-01-02"
"03265","2022","COM","2020","665","79","744","2023-01-02"
"03266","2022","COM","2020","278","8","286","2023-01-02"
"03267","2022","COM","2020","658","22","680","2023-01-02"
"03268","2022","COM","2020","386","3","389","2023-01-02"
"03269","2022","COM","2020","84","3","87","2023-01-02"
"03270","2022","COM","2020","142","2","144","2023-01-02"
"03271","2022","COM","2020","805","32","837","2023-01-02"
"03272","2022","COM","2020","275","7","282","2023-01-02"
"03273","2022","COM","2020","484","15","499","2023-01-02"
"03274","2022","COM","2020","318","6","324","2023-01-02"
"03275","2022","COM","2020","1736","50","1786","2023-01-02"
"03276","2022","COM","2020","103","6","109","2023-01-02"
"03277","2022","COM","2020","254","4","258","2023-01-02"
"03278","2022","COM","2020","189","4","193","2023-01-02"
"03279","2022","COM","2020","555","8","563","2023-01-02"
"03280","2022","COM","2020","181","9","190","2023-01-02"
"03281","2022","COM","2020","389","3","392","2023-01-02"
"03282","2022","COM","2020","360","6","366","2023-01-02"
"03283","2022","COM","2020","1035","19","1054","2023-01-02"
"03284","2022","COM","2020","288","9","297","2023-01-02"
"03285","2022","COM","2020","180","9","189","2023-01-02"
"03286","2022","COM","2020","1140","20","1160","2023-01-02"
"03287","2022","COM","2020","381","8","389","2023-01-02"
"03288","2022","COM","2020","379","8","387","2023-01-02"
"03289","2022","COM","2020","510","11","521","2023-01-02"
"03290","2022","COM","2020","1634","56","1690","2023-01-02"
"03291","2022","COM","2020","407","13","420","2023-01-02"
"03292","2022","COM","2020","883","9","892","2023-01-02"
"03293","2022","COM","2020","293","10","303","2023-01-02"
"03294","2022","COM","2020","169","1","170","2023-01-02"
"03295","2022","COM","2020","72","1","73","2023-01-02"
"03296","2022","COM","2020","373","12","385","2023-01-02"
"03297","2022","COM","2020","1514","28","1542","2023-01-02"
"03298","2022","COM","2020","3642","71","3713","2023-01-02"
"03299","2022","COM","2020","225","8","233","2023-01-02"
"03300","2022","COM","2020","535","12","547","2023-01-02"
"03301","2022","COM","2020","1163","25","1188","2023-01-02"
"03302","2022","COM","2020","38","1","39","2023-01-02"
"03303","2022","COM","2020","237","10","247","2023-01-02"
"03304","2022","COM","2020","2262","61","2323","2023-01-02"
"03305","2022","COM","2020","587","12","599","2023-01-02"
"03306","2022","COM","2020","1906","51","1957","2023-01-02"
"03307","2022","COM","2020","236","3","239","2023-01-02"
"03308","2022","COM","2020","152","2","154","2023-01-02"
"03309","2022","COM","2020","452","4","456","2023-01-02"
"03310","2022","COM","2020","25372","308","25680","2023-01-02"
"03311","2022","COM","2020","297","7","304","2023-01-02"
"03312","2022","COM","2020","272","11","283","2023-01-02"
"03313","2022","COM","2020","276","8","284","2023-01-02"
"03314","2022","COM","2020","1330","36","1366","2023-01-02"
"03315","2022","COM","2020","1282","39","1321","2023-01-02"
"03316","2022","COM","2020","1074","16","1090","2023-01-02"
"03317","2022","COM","2020","291","7","298","2023-01-02"
"03319","2022","COM","2020","489","10","499","2023-01-02"
"03320","2022","COM","2020","777","16","793","2023-01-02"
"03321","2022","COM","2020","12701","523","13224","2023-01-02"
"04001","2022","COM","2020","1420","28","1448","2023-01-02"
"04004","2022","COM","2020","544","14","558","2023-01-02"
"04005","2022","COM","2020","128","3","131","2023-01-02"
"04006","2022","COM","2020","837","8","845","2023-01-02"
"04007","2022","COM","2020","67","0","67","2023-01-02"
"04008","2022","COM","2020","1021","35","1056","2023-01-02"
"04009","2022","COM","2020","14","0","14","2023-01-02"
"04012","2022","COM","2020","91","1","92","2023-01-02"
"04013","2022","COM","2020","616","15","631","2023-01-02"
"04016","2022","COM","2020","63","0","63","2023-01-02"
"04017","2022","COM","2020","101","5","106","2023-01-02"
"04018","2022","COM","2020","1057","17","1074","2023-01-02"
"04019","2022","COM","2020","2561","199","2760","2023-01-02"
"04020","2022","COM","2020","132","2","134","2023-01-02"
"04021","2022","COM","2020","146","4","150","2023-01-02"
"04022","2022","COM","2020","410","8","418","2023-01-02"
"04023","2022","COM","2020","193","4","197","2023-01-02"
"04024","2022","COM","2020","125","3","128","2023-01-02"
"04025","2022","COM","2020","392","14","406","2023-01-02"
"04026","2022","COM","2020","143","2","145","2023-01-02"
"04027","2022","COM","2020","253","53","306","2023-01-02"
"04028","2022","COM","2020","121","1","122","2023-01-02"
"04030","2022","COM","2020","55","0","55","2023-01-02"
"04031","2022","COM","2020","554","11","565","2023-01-02"
"04032","2022","COM","2020","127","0","127","2023-01-02"
"04033","2022","COM","2020","782","18","800","2023-01-02"
"04034","2022","COM","2020","1117","15","1132","2023-01-02"
"04035","2022","COM","2020","289","6","295","2023-01-02"
"04036","2022","COM","2020","966","30","996","2023-01-02"
"04037","2022","COM","2020","74","2","76","2023-01-02"
"04039","2022","COM","2020","1462","40","1502","2023-01-02"
"04040","2022","COM","2020","62","1","63","2023-01-02"
"04041","2022","COM","2020","298","6","304","2023-01-02"
"04042","2022","COM","2020","138","1","139","2023-01-02"
"04043","2022","COM","2020","85","3","88","2023-01-02"
"04045","2022","COM","2020","1198","23","1221","2023-01-02"
"04046","2022","COM","2020","688","103","791","2023-01-02"
"04047","2022","COM","2020","856","21","877","2023-01-02"
"04049","2022","COM","2020","5063","109","5172","2023-01-02"
"04050","2022","COM","2020","26","0","26","2023-01-02"
"04051","2022","COM","2020","73","2","75","2023-01-02"
"04053","2022","COM","2020","502","12","514","2023-01-02"
"04054","2022","COM","2020","73","1","74","2023-01-02"
"04055","2022","COM","2020","190","0","190","2023-01-02"
"04057","2022","COM","2020","178","3","181","2023-01-02"
"04058","2022","COM","2020","280","5","285","2023-01-02"
"04059","2022","COM","2020","221","3","224","2023-01-02"
"04061","2022","COM","2020","479","5","484","2023-01-02"
"04062","2022","COM","2020","151","3","154","2023-01-02"
"04063","2022","COM","2020","1241","36","1277","2023-01-02"
"04065","2022","COM","2020","627","6","633","2023-01-02"
"04066","2022","COM","2020","576","12","588","2023-01-02"
"04067","2022","COM","2020","51","1","52","2023-01-02"
"04068","2022","COM","2020","839","13","852","2023-01-02"
"04069","2022","COM","2020","127","5","132","2023-01-02"
"04070","2022","COM","2020","16864","940","17804","2023-01-02"
"04072","2022","COM","2020","111","2","113","2023-01-02"
"04073","2022","COM","2020","385","12","397","2023-01-02"
"04074","2022","COM","2020","100","2","102","2023-01-02"
"04075","2022","COM","2020","384","9","393","2023-01-02"
"04076","2022","COM","2020","810","21","831","2023-01-02"
"04077","2022","COM","2020","171","3","174","2023-01-02"
"04079","2022","COM","2020","1378","36","1414","2023-01-02"
"04081","2022","COM","2020","389","4","393","2023-01-02"
"04084","2022","COM","2020","487","7","494","2023-01-02"
"04085","2022","COM","2020","59","2","61","2023-01-02"
"04086","2022","COM","2020","295","16","311","2023-01-02"
"04087","2022","COM","2020","135","2","137","2023-01-02"
"04088","2022","COM","2020","5115","95","5210","2023-01-02"
"04090","2022","COM","2020","206","4","210","2023-01-02"
"04091","2022","COM","2020","92","0","92","2023-01-02"
"04092","2022","COM","2020","121","4","125","2023-01-02"
"04093","2022","COM","2020","60","1","61","2023-01-02"
"04094","2022","COM","2020","2790","35","2825","2023-01-02"
"04095","2022","COM","2020","90","0","90","2023-01-02"
"04096","2022","COM","2020","1137","26","1163","2023-01-02"
"04097","2022","COM","2020","375","5","380","2023-01-02"
"04099","2022","COM","2020","85","5","90","2023-01-02"
"04101","2022","COM","2020","132","3","135","2023-01-02"
"04102","2022","COM","2020","178","3","181","2023-01-02"
"04104","2022","COM","2020","390","11","401","2023-01-02"
"04106","2022","COM","2020","378","9","387","2023-01-02"
"04107","2022","COM","2020","4","0","4","2023-01-02"
"04108","2022","COM","2020","1984","31","2015","2023-01-02"
"04109","2022","COM","2020","325","4","329","2023-01-02"
"04110","2022","COM","2020","994","28","1022","2023-01-02"
"04111","2022","COM","2020","1349","31","1380","2023-01-02"
"04112","2022","COM","2020","23018","671","23689","2023-01-02"
"04113","2022","COM","2020","449","14","463","2023-01-02"
"04115","2022","COM","2020","120","2","122","2023-01-02"
"04116","2022","COM","2020","3766","47","3813","2023-01-02"
"04118","2022","COM","2020","123","1","124","2023-01-02"
"04120","2022","COM","2020","117","1","118","2023-01-02"
"04121","2022","COM","2020","631","11","642","2023-01-02"
"04122","2022","COM","2020","512","11","523","2023-01-02"
"04123","2022","COM","2020","1118","30","1148","2023-01-02"
"04124","2022","COM","2020","413","7","420","2023-01-02"
"04126","2022","COM","2020","403","15","418","2023-01-02"
"04127","2022","COM","2020","325","4","329","2023-01-02"
"04128","2022","COM","2020","226","9","235","2023-01-02"
"04129","2022","COM","2020","59","1","60","2023-01-02"
"04130","2022","COM","2020","207","2","209","2023-01-02"
"04132","2022","COM","2020","152","1","153","2023-01-02"
"04133","2022","COM","2020","238","1","239","2023-01-02"
"04134","2022","COM","2020","550","23","573","2023-01-02"
"04135","2022","COM","2020","718","15","733","2023-01-02"
"04136","2022","COM","2020","309","8","317","2023-01-02"
"04137","2022","COM","2020","45","1","46","2023-01-02"
"04138","2022","COM","2020","285","6","291","2023-01-02"
"04139","2022","COM","2020","523","9","532","2023-01-02"
"04140","2022","COM","2020","127","3","130","2023-01-02"
"04141","2022","COM","2020","363","7","370","2023-01-02"
"04142","2022","COM","2020","51","0","51","2023-01-02"
"04143","2022","COM","2020","5920","115","6035","2023-01-02"
"04144","2022","COM","2020","351","1","352","2023-01-02"
"04145","2022","COM","2020","1463","33","1496","2023-01-02"
"04148","2022","COM","2020","250","9","259","2023-01-02"
"04149","2022","COM","2020","2801","46","2847","2023-01-02"
"04150","2022","COM","2020","204","4","208","2023-01-02"
"04151","2022","COM","2020","523","13","536","2023-01-02"
"04152","2022","COM","2020","3936","134","4070","2023-01-02"
"04154","2022","COM","2020","96","1","97","2023-01-02"
"04155","2022","COM","2020","177","1","178","2023-01-02"
"04156","2022","COM","2020","270","1","271","2023-01-02"
"04157","2022","COM","2020","683","8","691","2023-01-02"
"04158","2022","COM","2020","406","8","414","2023-01-02"
"04159","2022","COM","2020","84","0","84","2023-01-02"
"04160","2022","COM","2020","1697","35","1732","2023-01-02"
"04161","2022","COM","2020","324","7","331","2023-01-02"
"04162","2022","COM","2020","259","6","265","2023-01-02"
"04163","2022","COM","2020","507","12","519","2023-01-02"
"04164","2022","COM","2020","88","1","89","2023-01-02"
"04166","2022","COM","2020","1661","39","1700","2023-01-02"
"04167","2022","COM","2020","286","5","291","2023-01-02"
"04169","2022","COM","2020","105","2","107","2023-01-02"
"04170","2022","COM","2020","74","0","74","2023-01-02"
"04171","2022","COM","2020","122","0","122","2023-01-02"
"04172","2022","COM","2020","734","11","745","2023-01-02"
"04173","2022","COM","2020","1015","21","1036","2023-01-02"
"04174","2022","COM","2020","152","1","153","2023-01-02"
"04175","2022","COM","2020","90","2","92","2023-01-02"
"04176","2022","COM","2020","117","4","121","2023-01-02"
"04177","2022","COM","2020","45","0","45","2023-01-02"
"04178","2022","COM","2020","1316","36","1352","2023-01-02"
"04179","2022","COM","2020","106","2","108","2023-01-02"
"04180","2022","COM","2020","81","4","85","2023-01-02"
"04181","2022","COM","2020","48","1","49","2023-01-02"
"04182","2022","COM","2020","215","2","217","2023-01-02"
"04183","2022","COM","2020","153","3","156","2023-01-02"
"04184","2022","COM","2020","136","3","139","2023-01-02"
"04186","2022","COM","2020","96","1","97","2023-01-02"
"04187","2022","COM","2020","40","1","41","2023-01-02"
"04188","2022","COM","2020","867","12","879","2023-01-02"
"04189","2022","COM","2020","634","14","648","2023-01-02"
"04190","2022","COM","2020","124","3","127","2023-01-02"
"04191","2022","COM","2020","12","2","14","2023-01-02"
"04192","2022","COM","2020","1230","24","1254","2023-01-02"
"04193","2022","COM","2020","177","7","184","2023-01-02"
"04194","2022","COM","2020","97","2","99","2023-01-02"
"04195","2022","COM","2020","600","13","613","2023-01-02"
"04197","2022","COM","2020","3475","84","3559","2023-01-02"
"04199","2022","COM","2020","170","4","174","2023-01-02"
"04200","2022","COM","2020","660","22","682","2023-01-02"
"04201","2022","COM","2020","120","3","123","2023-01-02"
"04202","2022","COM","2020","130","2","132","2023-01-02"
"04203","2022","COM","2020","472","9","481","2023-01-02"
"04204","2022","COM","2020","161","4","165","2023-01-02"
"04205","2022","COM","2020","1372","28","1400","2023-01-02"
"04206","2022","COM","2020","426","8","434","2023-01-02"
"04207","2022","COM","2020","101","4","105","2023-01-02"
"04208","2022","COM","2020","607","16","623","2023-01-02"
"04209","2022","COM","2020","7669","241","7910","2023-01-02"
"04210","2022","COM","2020","88","4","92","2023-01-02"
"04211","2022","COM","2020","178","3","181","2023-01-02"
"04214","2022","COM","2020","129","2","131","2023-01-02"
"04216","2022","COM","2020","231","5","236","2023-01-02"
"04217","2022","COM","2020","738","19","757","2023-01-02"
"04218","2022","COM","2020","224","6","230","2023-01-02"
"04219","2022","COM","2020","245","6","251","2023-01-02"
"04220","2022","COM","2020","370","11","381","2023-01-02"
"04222","2022","COM","2020","343","8","351","2023-01-02"
"04224","2022","COM","2020","100","1","101","2023-01-02"
"04226","2022","COM","2020","562","12","574","2023-01-02"
"04227","2022","COM","2020","289","7","296","2023-01-02"
"04228","2022","COM","2020","37","0","37","2023-01-02"
"04229","2022","COM","2020","239","4","243","2023-01-02"
"04230","2022","COM","2020","3158","66","3224","2023-01-02"
"04231","2022","COM","2020","244","6","250","2023-01-02"
"04233","2022","COM","2020","267","8","275","2023-01-02"
"04234","2022","COM","2020","226","2","228","2023-01-02"
"04235","2022","COM","2020","62","1","63","2023-01-02"
"04236","2022","COM","2020","107","0","107","2023-01-02"
"04237","2022","COM","2020","125","3","128","2023-01-02"
"04240","2022","COM","2020","250","5","255","2023-01-02"
"04241","2022","COM","2020","194","5","199","2023-01-02"
"04242","2022","COM","2020","4355","84","4439","2023-01-02"
"04244","2022","COM","2020","1639","32","1671","2023-01-02"
"04245","2022","COM","2020","3212","71","3283","2023-01-02"
"05001","2022","COM","2020","383","6","389","2023-01-02"
"05003","2022","COM","2020","382","11","393","2023-01-02"
"05004","2022","COM","2020","916","14","930","2023-01-02"
"05006","2022","COM","2020","2238","86","2324","2023-01-02"
"05007","2022","COM","2020","354","8","362","2023-01-02"
"05008","2022","COM","2020","369","6","375","2023-01-02"
"05009","2022","COM","2020","97","3","100","2023-01-02"
"05010","2022","COM","2020","802","11","813","2023-01-02"
"05011","2022","COM","2020","419","9","428","2023-01-02"
"05012","2022","COM","2020","627","14","641","2023-01-02"
"05013","2022","COM","2020","123","5","128","2023-01-02"
"05014","2022","COM","2020","181","4","185","2023-01-02"
"05016","2022","COM","2020","257","2","259","2023-01-02"
"05017","2022","COM","2020","2579","70","2649","2023-01-02"
"05018","2022","COM","2020","328","10","338","2023-01-02"
"05019","2022","COM","2020","150","4","154","2023-01-02"
"05021","2022","COM","2020","141","1","142","2023-01-02"
"05022","2022","COM","2020","249","3","252","2023-01-02"
"05023","2022","COM","2020","10780","315","11095","2023-01-02"
"05024","2022","COM","2020","218","8","226","2023-01-02"
"05025","2022","COM","2020","209","7","216","2023-01-02"
"05026","2022","COM","2020","282","3","285","2023-01-02"
"05027","2022","COM","2020","195","4","199","2023-01-02"
"05028","2022","COM","2020","169","4","173","2023-01-02"
"05029","2022","COM","2020","918","26","944","2023-01-02"
"05031","2022","COM","2020","185","4","189","2023-01-02"
"05032","2022","COM","2020","136","3","139","2023-01-02"
"05033","2022","COM","2020","41","0","41","2023-01-02"
"05035","2022","COM","2020","30","3","33","2023-01-02"
"05036","2022","COM","2020","1200","35","1235","2023-01-02"
"05037","2022","COM","2020","519","20","539","2023-01-02"
"05038","2022","COM","2020","306","16","322","2023-01-02"
"05039","2022","COM","2020","716","14","730","2023-01-02"
"05040","2022","COM","2020","3077","79","3156","2023-01-02"
"05044","2022","COM","2020","125","3","128","2023-01-02"
"05045","2022","COM","2020","1125","31","1156","2023-01-02"
"05046","2022","COM","2020","6435","346","6781","2023-01-02"
"05047","2022","COM","2020","120","4","124","2023-01-02"
"05048","2022","COM","2020","203","6","209","2023-01-02"
"05049","2022","COM","2020","58","0","58","2023-01-02"
"05050","2022","COM","2020","823","9","832","2023-01-02"
"05051","2022","COM","2020","28","0","28","2023-01-02"
"05052","2022","COM","2020","800","12","812","2023-01-02"
"05053","2022","COM","2020","525","11","536","2023-01-02"
"05054","2022","COM","2020","448","10","458","2023-01-02"
"05055","2022","COM","2020","317","5","322","2023-01-02"
"05056","2022","COM","2020","333","8","341","2023-01-02"
"05057","2022","COM","2020","261","6","267","2023-01-02"
"05058","2022","COM","2020","205","3","208","2023-01-02"
"05059","2022","COM","2020","933","20","953","2023-01-02"
"05060","2022","COM","2020","181","8","189","2023-01-02"
"05061","2022","COM","2020","40111","1417","41528","2023-01-02"
"05062","2022","COM","2020","166","3","169","2023-01-02"
"05063","2022","COM","2020","477","10","487","2023-01-02"
"05064","2022","COM","2020","105","3","108","2023-01-02"
"05065","2022","COM","2020","2291","83","2374","2023-01-02"
"05066","2022","COM","2020","8","0","8","2023-01-02"
"05068","2022","COM","2020","466","12","478","2023-01-02"
"05070","2022","COM","2020","3579","52","3631","2023-01-02"
"05071","2022","COM","2020","349","20","369","2023-01-02"
"05072","2022","COM","2020","243","5","248","2023-01-02"
"05073","2022","COM","2020","341","14","355","2023-01-02"
"05074","2022","COM","2020","201","0","201","2023-01-02"
"05075","2022","COM","2020","450","15","465","2023-01-02"
"05076","2022","COM","2020","92","0","92","2023-01-02"
"05077","2022","COM","2020","300","2","302","2023-01-02"
"05078","2022","COM","2020","284","10","294","2023-01-02"
"05079","2022","COM","2020","1062","23","1085","2023-01-02"
"05080","2022","COM","2020","63","1","64","2023-01-02"
"05081","2022","COM","2020","50","4","54","2023-01-02"
"05082","2022","COM","2020","173","2","175","2023-01-02"
"05084","2022","COM","2020","465","7","472","2023-01-02"
"05085","2022","COM","2020","452","14","466","2023-01-02"
"05086","2022","COM","2020","104","2","106","2023-01-02"
"05087","2022","COM","2020","537","15","552","2023-01-02"
"05089","2022","COM","2020","87","1","88","2023-01-02"
"05090","2022","COM","2020","209","5","214","2023-01-02"
"05091","2022","COM","2020","40","4","44","2023-01-02"
"05092","2022","COM","2020","781","15","796","2023-01-02"
"05093","2022","COM","2020","357","10","367","2023-01-02"
"05094","2022","COM","2020","14","1","15","2023-01-02"
"05095","2022","COM","2020","306","3","309","2023-01-02"
"05096","2022","COM","2020","680","16","696","2023-01-02"
"05097","2022","COM","2020","344","33","377","2023-01-02"
"05098","2022","COM","2020","530","13","543","2023-01-02"
"05099","2022","COM","2020","103","1","104","2023-01-02"
"05100","2022","COM","2020","810","31","841","2023-01-02"
"05101","2022","COM","2020","1129","39","1168","2023-01-02"
"05102","2022","COM","2020","91","2","93","2023-01-02"
"05103","2022","COM","2020","791","21","812","2023-01-02"
"05104","2022","COM","2020","337","15","352","2023-01-02"
"05106","2022","COM","2020","300","7","307","2023-01-02"
"05107","2022","COM","2020","459","11","470","2023-01-02"
"05108","2022","COM","2020","181","6","187","2023-01-02"
"05109","2022","COM","2020","515","20","535","2023-01-02"
"05110","2022","COM","2020","290","2","292","2023-01-02"
"05111","2022","COM","2020","267","9","276","2023-01-02"
"05112","2022","COM","2020","89","0","89","2023-01-02"
"05113","2022","COM","2020","375","17","392","2023-01-02"
"05114","2022","COM","2020","248","1","249","2023-01-02"
"05115","2022","COM","2020","458","10","468","2023-01-02"
"05116","2022","COM","2020","209","2","211","2023-01-02"
"05117","2022","COM","2020","114","0","114","2023-01-02"
"05118","2022","COM","2020","1329","27","1356","2023-01-02"
"05119","2022","COM","2020","658","18","676","2023-01-02"
"05121","2022","COM","2020","179","6","185","2023-01-02"
"05122","2022","COM","2020","837","20","857","2023-01-02"
"05123","2022","COM","2020","1578","43","1621","2023-01-02"
"05124","2022","COM","2020","473","9","482","2023-01-02"
"05126","2022","COM","2020","469","8","477","2023-01-02"
"05127","2022","COM","2020","177","5","182","2023-01-02"
"05128","2022","COM","2020","697","22","719","2023-01-02"
"05129","2022","COM","2020","154","3","157","2023-01-02"
"05130","2022","COM","2020","196","5","201","2023-01-02"
"05131","2022","COM","2020","77","4","81","2023-01-02"
"05132","2022","COM","2020","2078","68","2146","2023-01-02"
"05133","2022","COM","2020","1523","46","1569","2023-01-02"
"05134","2022","COM","2020","321","5","326","2023-01-02"
"05135","2022","COM","2020","55","2","57","2023-01-02"
"05136","2022","COM","2020","732","14","746","2023-01-02"
"05139","2022","COM","2020","904","26","930","2023-01-02"
"05140","2022","COM","2020","302","6","308","2023-01-02"
"05142","2022","COM","2020","446","10","456","2023-01-02"
"05144","2022","COM","2020","134","5","139","2023-01-02"
"05145","2022","COM","2020","1075","91","1166","2023-01-02"
"05146","2022","COM","2020","137","1","138","2023-01-02"
"05147","2022","COM","2020","372","5","377","2023-01-02"
"05148","2022","COM","2020","548","8","556","2023-01-02"
"05149","2022","COM","2020","366","12","378","2023-01-02"
"05151","2022","COM","2020","1127","37","1164","2023-01-02"
"05152","2022","COM","2020","123","1","124","2023-01-02"
"05153","2022","COM","2020","356","11","367","2023-01-02"
"05154","2022","COM","2020","163","0","163","2023-01-02"
"05155","2022","COM","2020","30","1","31","2023-01-02"
"05156","2022","COM","2020","517","11","528","2023-01-02"
"05157","2022","COM","2020","171","5","176","2023-01-02"
"05158","2022","COM","2020","121","1","122","2023-01-02"
"05159","2022","COM","2020","85","3","88","2023-01-02"
"05160","2022","COM","2020","82","0","82","2023-01-02"
"05161","2022","COM","2020","931","22","953","2023-01-02"
"05162","2022","COM","2020","1397","34","1431","2023-01-02"
"05163","2022","COM","2020","149","1","150","2023-01-02"
"05164","2022","COM","2020","1080","55","1135","2023-01-02"
"05165","2022","COM","2020","248","6","254","2023-01-02"
"05166","2022","COM","2020","1292","27","1319","2023-01-02"
"05167","2022","COM","2020","85","2","87","2023-01-02"
"05168","2022","COM","2020","727","22","749","2023-01-02"
"05169","2022","COM","2020","40","0","40","2023-01-02"
"05170","2022","COM","2020","2295","54","2349","2023-01-02"
"05171","2022","COM","2020","221","4","225","2023-01-02"
"05172","2022","COM","2020","306","5","311","2023-01-02"
"05173","2022","COM","2020","460","10","470","2023-01-02"
"05174","2022","COM","2020","613","22","635","2023-01-02"
"05176","2022","COM","2020","273","7","280","2023-01-02"
"05177","2022","COM","2020","554","11","565","2023-01-02"
"05178","2022","COM","2020","599","39","638","2023-01-02"
"05179","2022","COM","2020","3231","147","3378","2023-01-02"
"05180","2022","COM","2020","532","14","546","2023-01-02"
"05181","2022","COM","2020","287","13","300","2023-01-02"
"05182","2022","COM","2020","38","1","39","2023-01-02"
"05183","2022","COM","2020","1466","34","1500","2023-01-02"
"05184","2022","COM","2020","210","8","218","2023-01-02"
"06001","2022","COM","2020","93","0","93","2023-01-02"
"06002","2022","COM","2020","52","0","52","2023-01-02"
"06003","2022","COM","2020","644","5","649","2023-01-02"
"06004","2022","COM","2020","74709","1070","75779","2023-01-02"
"06005","2022","COM","2020","177","0","177","2023-01-02"
"06006","2022","COM","2020","2271","33","2304","2023-01-02"
"06007","2022","COM","2020","3175","68","3243","2023-01-02"
"06008","2022","COM","2020","37","1","38","2023-01-02"
"06009","2022","COM","2020","116","1","117","2023-01-02"
"06010","2022","COM","2020","2927","62","2989","2023-01-02"
"06011","2022","COM","2020","3762","26","3788","2023-01-02"
"06012","2022","COM","2020","13153","127","13280","2023-01-02"
"06013","2022","COM","2020","658","20","678","2023-01-02"
"06014","2022","COM","2020","940","6","946","2023-01-02"
"06015","2022","COM","2020","1236","23","1259","2023-01-02"
"06016","2022","COM","2020","552","4","556","2023-01-02"
"06017","2022","COM","2020","256","4","260","2023-01-02"
"06018","2022","COM","2020","9575","351","9926","2023-01-02"
"06019","2022","COM","2020","1663","18","1681","2023-01-02"
"06020","2022","COM","2020","594","8","602","2023-01-02"
"06021","2022","COM","2020","723","4","727","2023-01-02"
"06022","2022","COM","2020","548","6","554","2023-01-02"
"06023","2022","COM","2020","2121","52","2173","2023-01-02"
"06024","2022","COM","2020","201","5","206","2023-01-02"
"06025","2022","COM","2020","1417","7","1424","2023-01-02"
"06026","2022","COM","2020","1386","27","1413","2023-01-02"
"06027","2022","COM","2020","52100","475","52575","2023-01-02"
"06028","2022","COM","2020","407","5","412","2023-01-02"
"06029","2022","COM","2020","72435","724","73159","2023-01-02"
"06030","2022","COM","2020","42125","399","42524","2023-01-02"
"06031","2022","COM","2020","1293","10","1303","2023-01-02"
"06032","2022","COM","2020","4517","68","4585","2023-01-02"
"06033","2022","COM","2020","12875","135","13010","2023-01-02"
"06034","2022","COM","2020","1674","16","1690","2023-01-02"
"06035","2022","COM","2020","1133","9","1142","2023-01-02"
"06036","2022","COM","2020","417","4","421","2023-01-02"
"06037","2022","COM","2020","302","3","305","2023-01-02"
"06038","2022","COM","2020","3690","60","3750","2023-01-02"
"06039","2022","COM","2020","956","9","965","2023-01-02"
"06040","2022","COM","2020","63","0","63","2023-01-02"
"06041","2022","COM","2020","403","6","409","2023-01-02"
"06042","2022","COM","2020","670","12","682","2023-01-02"
"06043","2022","COM","2020","821","4","825","2023-01-02"
"06044","2022","COM","2020","8048","160","8208","2023-01-02"
"06045","2022","COM","2020","71","2","73","2023-01-02"
"06046","2022","COM","2020","3494","40","3534","2023-01-02"
"06047","2022","COM","2020","95","1","96","2023-01-02"
"06048","2022","COM","2020","7534","78","7612","2023-01-02"
"06049","2022","COM","2020","108","2","110","2023-01-02"
"06050","2022","COM","2020","529","6","535","2023-01-02"
"06051","2022","COM","2020","98","2","100","2023-01-02"
"06052","2022","COM","2020","164","1","165","2023-01-02"
"06053","2022","COM","2020","141","1","142","2023-01-02"
"06054","2022","COM","2020","5176","19","5195","2023-01-02"
"06055","2022","COM","2020","152","3","155","2023-01-02"
"06056","2022","COM","2020","143","2","145","2023-01-02"
"06057","2022","COM","2020","2562","18","2580","2023-01-02"
"06058","2022","COM","2020","612","15","627","2023-01-02"
"06059","2022","COM","2020","2222","37","2259","2023-01-02"
"06060","2022","COM","2020","2053","45","2098","2023-01-02"
"06061","2022","COM","2020","91","3","94","2023-01-02"
"06062","2022","COM","2020","315","1","316","2023-01-02"
"06063","2022","COM","2020","74","0","74","2023-01-02"
"06064","2022","COM","2020","4229","43","4272","2023-01-02"
"06065","2022","COM","2020","7117","108","7225","2023-01-02"
"06066","2022","COM","2020","1598","11","1609","2023-01-02"
"06067","2022","COM","2020","1485","13","1498","2023-01-02"
"06068","2022","COM","2020","371","9","380","2023-01-02"
"06069","2022","COM","2020","48708","899","49607","2023-01-02"
"06070","2022","COM","2020","564","13","577","2023-01-02"
"06071","2022","COM","2020","585","7","592","2023-01-02"
"06072","2022","COM","2020","147","1","148","2023-01-02"
"06073","2022","COM","2020","653","14","667","2023-01-02"
"06074","2022","COM","2020","1206","9","1215","2023-01-02"
"06075","2022","COM","2020","4963","48","5011","2023-01-02"
"06076","2022","COM","2020","48","0","48","2023-01-02"
"06077","2022","COM","2020","1279","12","1291","2023-01-02"
"06078","2022","COM","2020","326","7","333","2023-01-02"
"06079","2022","COM","2020","21772","295","22067","2023-01-02"
"06080","2022","COM","2020","105","4","109","2023-01-02"
"06081","2022","COM","2020","100","2","102","2023-01-02"
"06082","2022","COM","2020","104","1","105","2023-01-02"
"06083","2022","COM","2020","30679","484","31163","2023-01-02"
"06084","2022","COM","2020","10215","182","10397","2023-01-02"
"06085","2022","COM","2020","20180","446","20626","2023-01-02"
"06086","2022","COM","2020","252","2","254","2023-01-02"
"06087","2022","COM","2020","41","0","41","2023-01-02"
"06088","2022","COM","2020","343477","2899","346376","2023-01-02"
"06089","2022","COM","2020","2375","77","2452","2023-01-02"
"06090","2022","COM","2020","7956","91","8047","2023-01-02"
"06091","2022","COM","2020","2369","17","2386","2023-01-02"
"06092","2022","COM","2020","1465","12","1477","2023-01-02"
"06093","2022","COM","2020","223","4","227","2023-01-02"
"06094","2022","COM","2020","880","6","886","2023-01-02"
"06095","2022","COM","2020","8211","189","8400","2023-01-02"
"06096","2022","COM","2020","103","1","104","2023-01-02"
"06097","2022","COM","2020","335","0","335","2023-01-02"
"06098","2022","COM","2020","126","1","127","2023-01-02"
"06099","2022","COM","2020","1826","80","1906","2023-01-02"
"06100","2022","COM","2020","229","1","230","2023-01-02"
"06101","2022","COM","2020","170","2","172","2023-01-02"
"06102","2022","COM","2020","112","1","113","2023-01-02"
"06103","2022","COM","2020","1822","50","1872","2023-01-02"
"06104","2022","COM","2020","12966","196","13162","2023-01-02"
"06105","2022","COM","2020","7277","199","7476","2023-01-02"
"06106","2022","COM","2020","570","8","578","2023-01-02"
"06107","2022","COM","2020","64","1","65","2023-01-02"
"06108","2022","COM","2020","5413","96","5509","2023-01-02"
"06109","2022","COM","2020","954","5","959","2023-01-02"
"06110","2022","COM","2020","119","2","121","2023-01-02"
"06111","2022","COM","2020","116","3","119","2023-01-02"
"06112","2022","COM","2020","4115","104","4219","2023-01-02"
"06113","2022","COM","2020","1336","23","1359","2023-01-02"
"06114","2022","COM","2020","5694","28","5722","2023-01-02"
"06115","2022","COM","2020","86","3","89","2023-01-02"
"06116","2022","COM","2020","214","3","217","2023-01-02"
"06117","2022","COM","2020","1350","10","1360","2023-01-02"
"06118","2022","COM","2020","3927","101","4028","2023-01-02"
"06119","2022","COM","2020","105","2","107","2023-01-02"
"06120","2022","COM","2020","1413","153","1566","2023-01-02"
"06121","2022","COM","2020","1481","8","1489","2023-01-02"
"06122","2022","COM","2020","4317","114","4431","2023-01-02"
"06123","2022","COM","2020","30141","192","30333","2023-01-02"
"06124","2022","COM","2020","48","0","48","2023-01-02"
"06125","2022","COM","2020","153","7","160","2023-01-02"
"06126","2022","COM","2020","3143","19","3162","2023-01-02"
"06127","2022","COM","2020","1431","12","1443","2023-01-02"
"06128","2022","COM","2020","3179","68","3247","2023-01-02"
"06129","2022","COM","2020","307","82","389","2023-01-02"
"06130","2022","COM","2020","3671","104","3775","2023-01-02"
"06131","2022","COM","2020","48","2","50","2023-01-02"
"06132","2022","COM","2020","449","4","453","2023-01-02"
"06133","2022","COM","2020","72","1","73","2023-01-02"
"06134","2022","COM","2020","537","8","545","2023-01-02"
"06135","2022","COM","2020","197","2","199","2023-01-02"
"06136","2022","COM","2020","3792","87","3879","2023-01-02"
"06137","2022","COM","2020","1171","24","1195","2023-01-02"
"06138","2022","COM","2020","1361","16","1377","2023-01-02"
"06139","2022","COM","2020","107","3","110","2023-01-02"
"06140","2022","COM","2020","3069","54","3123","2023-01-02"
"06141","2022","COM","2020","348","1","349","2023-01-02"
"06142","2022","COM","2020","308","1","309","2023-01-02"
"06143","2022","COM","2020","690","10","700","2023-01-02"
"06144","2022","COM","2020","549","4","553","2023-01-02"
"06145","2022","COM","2020","138","2","140","2023-01-02"
"06146","2022","COM","2020","149","1","150","2023-01-02"
"06147","2022","COM","2020","4887","34","4921","2023-01-02"
"06148","2022","COM","2020","4063","101","4164","2023-01-02"
"06149","2022","COM","2020","10103","52","10155","2023-01-02"
"06150","2022","COM","2020","2997","55","3052","2023-01-02"
"06151","2022","COM","2020","863","1","864","2023-01-02"
"06152","2022","COM","2020","13162","503","13665","2023-01-02"
"06153","2022","COM","2020","834","289","1123","2023-01-02"
"06154","2022","COM","2020","473","8","481","2023-01-02"
"06155","2022","COM","2020","27970","198","28168","2023-01-02"
"06156","2022","COM","2020","173","1","174","2023-01-02"
"06157","2022","COM","2020","19315","270","19585","2023-01-02"
"06158","2022","COM","2020","778","6","784","2023-01-02"
"06159","2022","COM","2020","5002","35","5037","2023-01-02"
"06160","2022","COM","2020","91","2","93","2023-01-02"
"06161","2022","COM","2020","16329","259","16588","2023-01-02"
"06162","2022","COM","2020","696","10","706","2023-01-02"
"06163","2022","COM","2020","2144","49","2193","2023-01-02"
"07001","2022","COM","2020","373","12","385","2023-01-02"
"07002","2022","COM","2020","551","18","569","2023-01-02"
"07003","2022","COM","2020","170","1","171","2023-01-02"
"07004","2022","COM","2020","79","1","80","2023-01-02"
"07005","2022","COM","2020","1489","44","1533","2023-01-02"
"07006","2022","COM","2020","158","6","164","2023-01-02"
"07007","2022","COM","2020","998","13","1011","2023-01-02"
"07008","2022","COM","2020","1447","52","1499","2023-01-02"
"07009","2022","COM","2020","1201","22","1223","2023-01-02"
"07010","2022","COM","2020","16359","603","16962","2023-01-02"
"07011","2022","COM","2020","867","18","885","2023-01-02"
"07012","2022","COM","2020","379","9","388","2023-01-02"
"07013","2022","COM","2020","1248","22","1270","2023-01-02"
"07014","2022","COM","2020","324","7","331","2023-01-02"
"07015","2022","COM","2020","528","24","552","2023-01-02"
"07017","2022","COM","2020","764","15","779","2023-01-02"
"07018","2022","COM","2020","48","0","48","2023-01-02"
"07019","2022","COM","2020","12403","774","13177","2023-01-02"
"07020","2022","COM","2020","468","11","479","2023-01-02"
"07022","2022","COM","2020","1268","12","1280","2023-01-02"
"07023","2022","COM","2020","372","6","378","2023-01-02"
"07024","2022","COM","2020","658","21","679","2023-01-02"
"07025","2022","COM","2020","206","2","208","2023-01-02"
"07026","2022","COM","2020","255","5","260","2023-01-02"
"07027","2022","COM","2020","1840","31","1871","2023-01-02"
"07028","2022","COM","2020","524","10","534","2023-01-02"
"07029","2022","COM","2020","254","3","257","2023-01-02"
"07030","2022","COM","2020","206","5","211","2023-01-02"
"07031","2022","COM","2020","755","18","773","2023-01-02"
"07032","2022","COM","2020","161","1","162","2023-01-02"
"07033","2022","COM","2020","225","2","227","2023-01-02"
"07034","2022","COM","2020","256","3","259","2023-01-02"
"07035","2022","COM","2020","610","19","629","2023-01-02"
"07036","2022","COM","2020","448","11","459","2023-01-02"
"07037","2022","COM","2020","147","4","151","2023-01-02"
"07038","2022","COM","2020","49","0","49","2023-01-02"
"07039","2022","COM","2020","256","5","261","2023-01-02"
"07040","2022","COM","2020","254","5","259","2023-01-02"
"07041","2022","COM","2020","2332","58","2390","2023-01-02"
"07042","2022","COM","2020","7187","166","7353","2023-01-02"
"07044","2022","COM","2020","250","8","258","2023-01-02"
"07045","2022","COM","2020","525","7","532","2023-01-02"
"07047","2022","COM","2020","86","2","88","2023-01-02"
"07048","2022","COM","2020","338","7","345","2023-01-02"
"07049","2022","COM","2020","56","3","59","2023-01-02"
"07050","2022","COM","2020","955","16","971","2023-01-02"
"07051","2022","COM","2020","577","18","595","2023-01-02"
"07052","2022","COM","2020","616","10","626","2023-01-02"
"07053","2022","COM","2020","535","3","538","2023-01-02"
"07054","2022","COM","2020","256","10","266","2023-01-02"
"07055","2022","COM","2020","3044","76","3120","2023-01-02"
"07056","2022","COM","2020","904","18","922","2023-01-02"
"07058","2022","COM","2020","1019","37","1056","2023-01-02"
"07059","2022","COM","2020","238","8","246","2023-01-02"
"07060","2022","COM","2020","265","5","270","2023-01-02"
"07061","2022","COM","2020","419","12","431","2023-01-02"
"07062","2022","COM","2020","145","4","149","2023-01-02"
"07063","2022","COM","2020","404","9","413","2023-01-02"
"07064","2022","COM","2020","2849","155","3004","2023-01-02"
"07065","2022","COM","2020","234","3","237","2023-01-02"
"07066","2022","COM","2020","3004","174","3178","2023-01-02"
"07067","2022","COM","2020","327","4","331","2023-01-02"
"07068","2022","COM","2020","571","6","577","2023-01-02"
"07069","2022","COM","2020","652","22","674","2023-01-02"
"07070","2022","COM","2020","2328","49","2377","2023-01-02"
"07071","2022","COM","2020","782","10","792","2023-01-02"
"07072","2022","COM","2020","1659","42","1701","2023-01-02"
"07073","2022","COM","2020","521","10","531","2023-01-02"
"07074","2022","COM","2020","153","6","159","2023-01-02"
"07075","2022","COM","2020","149","4","153","2023-01-02"
"07076","2022","COM","2020","3069","66","3135","2023-01-02"
"07077","2022","COM","2020","259","2","261","2023-01-02"
"07078","2022","COM","2020","3144","79","3223","2023-01-02"
"07079","2022","COM","2020","1156","20","1176","2023-01-02"
"07080","2022","COM","2020","298","9","307","2023-01-02"
"07081","2022","COM","2020","64","0","64","2023-01-02"
"07082","2022","COM","2020","202","12","214","2023-01-02"
"07083","2022","COM","2020","436","11","447","2023-01-02"
"07084","2022","COM","2020","1031","37","1068","2023-01-02"
"07085","2022","COM","2020","603","17","620","2023-01-02"
"07086","2022","COM","2020","936","20","956","2023-01-02"
"07087","2022","COM","2020","444","8","452","2023-01-02"
"07088","2022","COM","2020","94","2","96","2023-01-02"
"07089","2022","COM","2020","1754","49","1803","2023-01-02"
"07090","2022","COM","2020","1240","17","1257","2023-01-02"
"07091","2022","COM","2020","328","7","335","2023-01-02"
"07092","2022","COM","2020","46","1","47","2023-01-02"
"07093","2022","COM","2020","275","8","283","2023-01-02"
"07094","2022","COM","2020","178","3","181","2023-01-02"
"07095","2022","COM","2020","464","4","468","2023-01-02"
"07096","2022","COM","2020","368","3","371","2023-01-02"
"07097","2022","COM","2020","693","18","711","2023-01-02"
"07098","2022","COM","2020","80","4","84","2023-01-02"
"07099","2022","COM","2020","618","22","640","2023-01-02"
"07100","2022","COM","2020","513","19","532","2023-01-02"
"07101","2022","COM","2020","911","21","932","2023-01-02"
"07102","2022","COM","2020","10965","189","11154","2023-01-02"
"07103","2022","COM","2020","310","3","313","2023-01-02"
"07104","2022","COM","2020","93","0","93","2023-01-02"
"07105","2022","COM","2020","100","3","103","2023-01-02"
"07106","2022","COM","2020","125","1","126","2023-01-02"
"07107","2022","COM","2020","1291","25","1316","2023-01-02"
"07108","2022","COM","2020","117","8","125","2023-01-02"
"07109","2022","COM","2020","295","6","301","2023-01-02"
"07110","2022","COM","2020","1741","28","1769","2023-01-02"
"07111","2022","COM","2020","175","3","178","2023-01-02"
"07112","2022","COM","2020","259","5","264","2023-01-02"
"07113","2022","COM","2020","311","7","318","2023-01-02"
"07114","2022","COM","2020","199","2","201","2023-01-02"
"07115","2022","COM","2020","674","11","685","2023-01-02"
"07116","2022","COM","2020","1359","21","1380","2023-01-02"
"07117","2022","COM","2020","2213","38","2251","2023-01-02"
"07118","2022","COM","2020","145","6","151","2023-01-02"
"07119","2022","COM","2020","252","5","257","2023-01-02"
"07120","2022","COM","2020","58","0","58","2023-01-02"
"07121","2022","COM","2020","191","0","191","2023-01-02"
"07122","2022","COM","2020","1699","48","1747","2023-01-02"
"07123","2022","COM","2020","163","6","169","2023-01-02"
"07124","2022","COM","2020","40","1","41","2023-01-02"
"07126","2022","COM","2020","1179","24","1203","2023-01-02"
"07127","2022","COM","2020","1131","13","1144","2023-01-02"
"07128","2022","COM","2020","374","6","380","2023-01-02"
"07129","2022","COM","2020","2361","40","2401","2023-01-02"
"07130","2022","COM","2020","207","5","212","2023-01-02"
"07131","2022","COM","2020","448","42","490","2023-01-02"
"07132","2022","COM","2020","1573","50","1623","2023-01-02"
"07133","2022","COM","2020","250","3","253","2023-01-02"
"07134","2022","COM","2020","1032","27","1059","2023-01-02"
"07136","2022","COM","2020","104","1","105","2023-01-02"
"07137","2022","COM","2020","43","0","43","2023-01-02"
"07138","2022","COM","2020","2230","50","2280","2023-01-02"
"07139","2022","COM","2020","103","0","103","2023-01-02"
"07140","2022","COM","2020","797","24","821","2023-01-02"
"07141","2022","COM","2020","234","7","241","2023-01-02"
"07142","2022","COM","2020","314","9","323","2023-01-02"
"07143","2022","COM","2020","785","17","802","2023-01-02"
"07144","2022","COM","2020","49","2","51","2023-01-02"
"07145","2022","COM","2020","1154","18","1172","2023-01-02"
"07146","2022","COM","2020","598","16","614","2023-01-02"
"07147","2022","COM","2020","242","5","247","2023-01-02"
"07148","2022","COM","2020","146","6","152","2023-01-02"
"07149","2022","COM","2020","279","5","284","2023-01-02"
"07150","2022","COM","2020","551","16","567","2023-01-02"
"07151","2022","COM","2020","254","12","266","2023-01-02"
"07152","2022","COM","2020","1191","26","1217","2023-01-02"
"07153","2022","COM","2020","264","8","272","2023-01-02"
"07154","2022","COM","2020","122","2","124","2023-01-02"
"07155","2022","COM","2020","1245","31","1276","2023-01-02"
"07156","2022","COM","2020","929","29","958","2023-01-02"
"07157","2022","COM","2020","1372","13","1385","2023-01-02"
"07158","2022","COM","2020","97","0","97","2023-01-02"
"07159","2022","COM","2020","736","10","746","2023-01-02"
"07160","2022","COM","2020","62","1","63","2023-01-02"
"07161","2022","COM","2020","737","23","760","2023-01-02"
"07162","2022","COM","2020","577","13","590","2023-01-02"
"07163","2022","COM","2020","83","5","88","2023-01-02"
"07165","2022","COM","2020","553","22","575","2023-01-02"
"07166","2022","COM","2020","244","2","246","2023-01-02"
"07167","2022","COM","2020","1011","23","1034","2023-01-02"
"07168","2022","COM","2020","587","9","596","2023-01-02"
"07169","2022","COM","2020","380","1","381","2023-01-02"
"07170","2022","COM","2020","243","6","249","2023-01-02"
"07171","2022","COM","2020","538","8","546","2023-01-02"
"07172","2022","COM","2020","2305","52","2357","2023-01-02"
"07173","2022","COM","2020","50","0","50","2023-01-02"
"07174","2022","COM","2020","494","8","502","2023-01-02"
"07175","2022","COM","2020","77","2","79","2023-01-02"
"07176","2022","COM","2020","158","2","160","2023-01-02"
"07177","2022","COM","2020","843","19","862","2023-01-02"
"07178","2022","COM","2020","583","7","590","2023-01-02"
"07179","2022","COM","2020","135","1","136","2023-01-02"
"07181","2022","COM","2020","2883","33","2916","2023-01-02"
"07182","2022","COM","2020","1180","31","1211","2023-01-02"
"07183","2022","COM","2020","496","8","504","2023-01-02"
"07184","2022","COM","2020","510","11","521","2023-01-02"
"07185","2022","COM","2020","709","9","718","2023-01-02"
"07186","2022","COM","2020","8567","259","8826","2023-01-02"
"07187","2022","COM","2020","136","2","138","2023-01-02"
"07188","2022","COM","2020","1707","31","1738","2023-01-02"
"07189","2022","COM","2020","325","7","332","2023-01-02"
"07190","2022","COM","2020","218","7","225","2023-01-02"
"07191","2022","COM","2020","2278","58","2336","2023-01-02"
"07192","2022","COM","2020","240","7","247","2023-01-02"
"07193","2022","COM","2020","275","4","279","2023-01-02"
"07194","2022","COM","2020","461","9","470","2023-01-02"
"07195","2022","COM","2020","63","2","65","2023-01-02"
"07196","2022","COM","2020","257","4","261","2023-01-02"
"07197","2022","COM","2020","2724","84","2808","2023-01-02"
"07198","2022","COM","2020","1131","26","1157","2023-01-02"
"07199","2022","COM","2020","1280","26","1306","2023-01-02"
"07200","2022","COM","2020","61","1","62","2023-01-02"
"07201","2022","COM","2020","2281","22","2303","2023-01-02"
"07202","2022","COM","2020","174","4","178","2023-01-02"
"07203","2022","COM","2020","116","3","119","2023-01-02"
"07204","2022","COM","2020","2350","59","2409","2023-01-02"
"07205","2022","COM","2020","1420","22","1442","2023-01-02"
"07206","2022","COM","2020","69","2","71","2023-01-02"
"07207","2022","COM","2020","1083","16","1099","2023-01-02"
"07208","2022","COM","2020","121","3","124","2023-01-02"
"07209","2022","COM","2020","55","2","57","2023-01-02"
"07210","2022","COM","2020","516","11","527","2023-01-02"
"07211","2022","COM","2020","462","14","476","2023-01-02"
"07212","2022","COM","2020","210","1","211","2023-01-02"
"07213","2022","COM","2020","153","4","157","2023-01-02"
"07214","2022","COM","2020","206","2","208","2023-01-02"
"07215","2022","COM","2020","201","5","206","2023-01-02"
"07216","2022","COM","2020","497","21","518","2023-01-02"
"07217","2022","COM","2020","842","12","854","2023-01-02"
"07218","2022","COM","2020","340","9","349","2023-01-02"
"07219","2022","COM","2020","326","5","331","2023-01-02"
"07220","2022","COM","2020","105","0","105","2023-01-02"
"07221","2022","COM","2020","248","9","257","2023-01-02"
"07222","2022","COM","2020","211","5","216","2023-01-02"
"07223","2022","COM","2020","139","2","141","2023-01-02"
"07224","2022","COM","2020","222","13","235","2023-01-02"
"07225","2022","COM","2020","1225","47","1272","2023-01-02"
"07226","2022","COM","2020","90","0","90","2023-01-02"
"07227","2022","COM","2020","1404","47","1451","2023-01-02"
"07228","2022","COM","2020","849","21","870","2023-01-02"
"07229","2022","COM","2020","930","25","955","2023-01-02"
"07230","2022","COM","2020","414","14","428","2023-01-02"
"07231","2022","COM","2020","2880","83","2963","2023-01-02"
"07232","2022","COM","2020","408","10","418","2023-01-02"
"07233","2022","COM","2020","207","4","211","2023-01-02"
"07234","2022","COM","2020","296","3","299","2023-01-02"
"07235","2022","COM","2020","213","3","216","2023-01-02"
"07236","2022","COM","2020","1125","20","1145","2023-01-02"
"07237","2022","COM","2020","784","13","797","2023-01-02"
"07238","2022","COM","2020","337","7","344","2023-01-02"
"07239","2022","COM","2020","113","2","115","2023-01-02"
"07240","2022","COM","2020","2408","51","2459","2023-01-02"
"07241","2022","COM","2020","710","17","727","2023-01-02"
"07242","2022","COM","2020","114","4","118","2023-01-02"
"07243","2022","COM","2020","290","5","295","2023-01-02"
"07244","2022","COM","2020","254","4","258","2023-01-02"
"07245","2022","COM","2020","2507","70","2577","2023-01-02"
"07247","2022","COM","2020","856","10","866","2023-01-02"
"07248","2022","COM","2020","242","11","253","2023-01-02"
"07249","2022","COM","2020","93","2","95","2023-01-02"
"07250","2022","COM","2020","493","9","502","2023-01-02"
"07251","2022","COM","2020","174","3","177","2023-01-02"
"07253","2022","COM","2020","169","3","172","2023-01-02"
"07254","2022","COM","2020","865","20","885","2023-01-02"
"07255","2022","COM","2020","1434","37","1471","2023-01-02"
"07257","2022","COM","2020","118","2","120","2023-01-02"
"07258","2022","COM","2020","223","3","226","2023-01-02"
"07259","2022","COM","2020","1681","37","1718","2023-01-02"
"07260","2022","COM","2020","953","20","973","2023-01-02"
"07261","2022","COM","2020","1600","33","1633","2023-01-02"
"07262","2022","COM","2020","176","3","179","2023-01-02"
"07263","2022","COM","2020","116","3","119","2023-01-02"
"07264","2022","COM","2020","2379","69","2448","2023-01-02"
"07265","2022","COM","2020","1383","35","1418","2023-01-02"
"07266","2022","COM","2020","113","2","115","2023-01-02"
"07267","2022","COM","2020","268","4","272","2023-01-02"
"07268","2022","COM","2020","947","12","959","2023-01-02"
"07269","2022","COM","2020","1092","39","1131","2023-01-02"
"07270","2022","COM","2020","433","12","445","2023-01-02"
"07272","2022","COM","2020","332","10","342","2023-01-02"
"07273","2022","COM","2020","216","1","217","2023-01-02"
"07274","2022","COM","2020","200","5","205","2023-01-02"
"07275","2022","COM","2020","100","3","103","2023-01-02"
"07276","2022","COM","2020","265","20","285","2023-01-02"
"07277","2022","COM","2020","148","5","153","2023-01-02"
"07278","2022","COM","2020","404","9","413","2023-01-02"
"07279","2022","COM","2020","1926","44","1970","2023-01-02"
"07280","2022","COM","2020","965","19","984","2023-01-02"
"07281","2022","COM","2020","7538","216","7754","2023-01-02"
"07282","2022","COM","2020","440","28","468","2023-01-02"
"07283","2022","COM","2020","62","2","64","2023-01-02"
"07284","2022","COM","2020","181","4","185","2023-01-02"
"07285","2022","COM","2020","112","1","113","2023-01-02"
"07286","2022","COM","2020","517","2","519","2023-01-02"
"07287","2022","COM","2020","294","13","307","2023-01-02"
"07288","2022","COM","2020","1320","45","1365","2023-01-02"
"07289","2022","COM","2020","1664","57","1721","2023-01-02"
"07290","2022","COM","2020","270","7","277","2023-01-02"
"07291","2022","COM","2020","854","23","877","2023-01-02"
"07292","2022","COM","2020","1221","30","1251","2023-01-02"
"07293","2022","COM","2020","913","18","931","2023-01-02"
"07294","2022","COM","2020","544","12","556","2023-01-02"
"07295","2022","COM","2020","1103","24","1127","2023-01-02"
"07296","2022","COM","2020","1772","51","1823","2023-01-02"
"07297","2022","COM","2020","509","7","516","2023-01-02"
"07298","2022","COM","2020","787","32","819","2023-01-02"
"07299","2022","COM","2020","119","4","123","2023-01-02"
"07300","2022","COM","2020","465","16","481","2023-01-02"
"07301","2022","COM","2020","946","14","960","2023-01-02"
"07302","2022","COM","2020","833","22","855","2023-01-02"
"07303","2022","COM","2020","269","3","272","2023-01-02"
"07304","2022","COM","2020","711","13","724","2023-01-02"
"07305","2022","COM","2020","383","13","396","2023-01-02"
"07306","2022","COM","2020","240","7","247","2023-01-02"
"07307","2022","COM","2020","448","9","457","2023-01-02"
"07308","2022","COM","2020","2242","35","2277","2023-01-02"
"07309","2022","COM","2020","1501","28","1529","2023-01-02"
"07310","2022","COM","2020","897","24","921","2023-01-02"
"07311","2022","COM","2020","151","7","158","2023-01-02"
"07312","2022","COM","2020","524","16","540","2023-01-02"
"07313","2022","COM","2020","1117","17","1134","2023-01-02"
"07314","2022","COM","2020","382","12","394","2023-01-02"
"07315","2022","COM","2020","376","8","384","2023-01-02"
"07316","2022","COM","2020","2299","51","2350","2023-01-02"
"07317","2022","COM","2020","1111","29","1140","2023-01-02"
"07318","2022","COM","2020","200","5","205","2023-01-02"
"07319","2022","COM","2020","8841","210","9051","2023-01-02"
"07321","2022","COM","2020","255","7","262","2023-01-02"
"07322","2022","COM","2020","1213","12","1225","2023-01-02"
"07323","2022","COM","2020","1727","52","1779","2023-01-02"
"07324","2022","COM","2020","10835","586","11421","2023-01-02"
"07325","2022","COM","2020","2056","72","2128","2023-01-02"
"07326","2022","COM","2020","117","0","117","2023-01-02"
"07327","2022","COM","2020","415","14","429","2023-01-02"
"07328","2022","COM","2020","603","17","620","2023-01-02"
"07329","2022","COM","2020","420","8","428","2023-01-02"
"07330","2022","COM","2020","2435","39","2474","2023-01-02"
"07331","2022","COM","2020","3495","66","3561","2023-01-02"
"07332","2022","COM","2020","439","12","451","2023-01-02"
"07333","2022","COM","2020","952","12","964","2023-01-02"
"07334","2022","COM","2020","2653","57","2710","2023-01-02"
"07335","2022","COM","2020","209","2","211","2023-01-02"
"07336","2022","COM","2020","223","7","230","2023-01-02"
"07337","2022","COM","2020","2594","83","2677","2023-01-02"
"07338","2022","COM","2020","1970","33","2003","2023-01-02"
"07339","2022","COM","2020","2020","65","2085","2023-01-02"
"07340","2022","COM","2020","1510","48","1558","2023-01-02"
"07341","2022","COM","2020","3028","107","3135","2023-01-02"
"07342","2022","COM","2020","1183","26","1209","2023-01-02"
"07343","2022","COM","2020","1410","40","1450","2023-01-02"
"07344","2022","COM","2020","483","3","486","2023-01-02"
"07345","2022","COM","2020","944","19","963","2023-01-02"
"07346","2022","COM","2020","3667","64","3731","2023-01-02"
"07347","2022","COM","2020","623","11","634","2023-01-02"
"07348","2022","COM","2020","1081","15","1096","2023-01-02"
"07349","2022","COM","2020","4828","57","4885","2023-01-02"
"08001","2022","COM","2020","469","3","472","2023-01-02"
"08003","2022","COM","2020","1642","36","1678","2023-01-02"
"08004","2022","COM","2020","244","1","245","2023-01-02"
"08005","2022","COM","2020","159","2","161","2023-01-02"
"08006","2022","COM","2020","252","5","257","2023-01-02"
"08008","2022","COM","2020","728","5","733","2023-01-02"
"08010","2022","COM","2020","133","4","137","2023-01-02"
"08011","2022","COM","2020","212","4","216","2023-01-02"
"08013","2022","COM","2020","388","5","393","2023-01-02"
"08014","2022","COM","2020","143","6","149","2023-01-02"
"08015","2022","COM","2020","100","5","105","2023-01-02"
"08016","2022","COM","2020","207","2","209","2023-01-02"
"08017","2022","COM","2020","118","3","121","2023-01-02"
"08018","2022","COM","2020","76","2","78","2023-01-02"
"08019","2022","COM","2020","59","4","63","2023-01-02"
"08020","2022","COM","2020","60","0","60","2023-01-02"
"08021","2022","COM","2020","153","4","157","2023-01-02"
"08022","2022","COM","2020","317","12","329","2023-01-02"
"08023","2022","COM","2020","65","1","66","2023-01-02"
"08024","2022","COM","2020","1079","18","1097","2023-01-02"
"08025","2022","COM","2020","1112","21","1133","2023-01-02"
"08026","2022","COM","2020","307","8","315","2023-01-02"
"08027","2022","COM","2020","97","1","98","2023-01-02"
"08028","2022","COM","2020","982","20","1002","2023-01-02"
"08029","2022","COM","2020","85","2","87","2023-01-02"
"08030","2022","COM","2020","58","0","58","2023-01-02"
"08031","2022","COM","2020","41","3","44","2023-01-02"
"08032","2022","COM","2020","220","3","223","2023-01-02"
"08033","2022","COM","2020","91","2","93","2023-01-02"
"08034","2022","COM","2020","337","6","343","2023-01-02"
"08035","2022","COM","2020","54","4","58","2023-01-02"
"08036","2022","COM","2020","108","6","114","2023-01-02"
"08037","2022","COM","2020","891","10","901","2023-01-02"
"08038","2022","COM","2020","340","8","348","2023-01-02"
"08039","2022","COM","2020","480","5","485","2023-01-02"
"08040","2022","COM","2020","881","20","901","2023-01-02"
"08041","2022","COM","2020","204","8","212","2023-01-02"
"08043","2022","COM","2020","1629","32","1661","2023-01-02"
"08044","2022","COM","2020","169","1","170","2023-01-02"
"08045","2022","COM","2020","257","12","269","2023-01-02"
"08046","2022","COM","2020","160","3","163","2023-01-02"
"08047","2022","COM","2020","108","0","108","2023-01-02"
"08048","2022","COM","2020","407","7","414","2023-01-02"
"08049","2022","COM","2020","129","2","131","2023-01-02"
"08052","2022","COM","2020","73","2","75","2023-01-02"
"08053","2022","COM","2020","2405","182","2587","2023-01-02"
"08055","2022","COM","2020","424","7","431","2023-01-02"
"08056","2022","COM","2020","44","0","44","2023-01-02"
"08057","2022","COM","2020","244","23","267","2023-01-02"
"08058","2022","COM","2020","221","6","227","2023-01-02"
"08059","2022","COM","2020","28","1","29","2023-01-02"
"08060","2022","COM","2020","298","1","299","2023-01-02"
"08061","2022","COM","2020","37","2","39","2023-01-02"
"08062","2022","COM","2020","126","5","131","2023-01-02"
"08063","2022","COM","2020","133","1","134","2023-01-02"
"08064","2022","COM","2020","310","4","314","2023-01-02"
"08065","2022","COM","2020","46","1","47","2023-01-02"
"08066","2022","COM","2020","67","1","68","2023-01-02"
"08067","2022","COM","2020","1110","17","1127","2023-01-02"
"08069","2022","COM","2020","142","2","144","2023-01-02"
"08070","2022","COM","2020","376","6","382","2023-01-02"
"08071","2022","COM","2020","135","2","137","2023-01-02"
"08073","2022","COM","2020","93","2","95","2023-01-02"
"08074","2022","COM","2020","57","2","59","2023-01-02"
"08075","2022","COM","2020","138","3","141","2023-01-02"
"08076","2022","COM","2020","971","20","991","2023-01-02"
"08077","2022","COM","2020","52","1","53","2023-01-02"
"08078","2022","COM","2020","845","10","855","2023-01-02"
"08080","2022","COM","2020","125","1","126","2023-01-02"
"08081","2022","COM","2020","5011","71","5082","2023-01-02"
"08082","2022","COM","2020","79","4","83","2023-01-02"
"08083","2022","COM","2020","359","6","365","2023-01-02"
"08084","2022","COM","2020","274","2","276","2023-01-02"
"08085","2022","COM","2020","225","5","230","2023-01-02"
"08086","2022","COM","2020","90","8","98","2023-01-02"
"08087","2022","COM","2020","141","2","143","2023-01-02"
"08088","2022","COM","2020","133","4","137","2023-01-02"
"08089","2022","COM","2020","372","8","380","2023-01-02"
"08090","2022","COM","2020","2875","44","2919","2023-01-02"
"08092","2022","COM","2020","189","8","197","2023-01-02"
"08094","2022","COM","2020","56","0","56","2023-01-02"
"08095","2022","COM","2020","179","5","184","2023-01-02"
"08096","2022","COM","2020","715","15","730","2023-01-02"
"08097","2022","COM","2020","437","7","444","2023-01-02"
"08098","2022","COM","2020","54","2","56","2023-01-02"
"08099","2022","COM","2020","122","4","126","2023-01-02"
"08100","2022","COM","2020","73","0","73","2023-01-02"
"08101","2022","COM","2020","165","4","169","2023-01-02"
"08102","2022","COM","2020","87","5","92","2023-01-02"
"08103","2022","COM","2020","221","4","225","2023-01-02"
"08104","2022","COM","2020","61","0","61","2023-01-02"
"08105","2022","COM","2020","46388","1045","47433","2023-01-02"
"08106","2022","COM","2020","71","0","71","2023-01-02"
"08107","2022","COM","2020","1323","16","1339","2023-01-02"
"08109","2022","COM","2020","138","3","141","2023-01-02"
"08110","2022","COM","2020","168","1","169","2023-01-02"
"08111","2022","COM","2020","776","2","778","2023-01-02"
"08113","2022","COM","2020","506","10","516","2023-01-02"
"08115","2022","COM","2020","528","4","532","2023-01-02"
"08116","2022","COM","2020","1026","18","1044","2023-01-02"
"08117","2022","COM","2020","160","0","160","2023-01-02"
"08119","2022","COM","2020","456","7","463","2023-01-02"
"08120","2022","COM","2020","45","2","47","2023-01-02"
"08121","2022","COM","2020","135","5","140","2023-01-02"
"08122","2022","COM","2020","756","15","771","2023-01-02"
"08123","2022","COM","2020","70","1","71","2023-01-02"
"08124","2022","COM","2020","344","9","353","2023-01-02"
"08125","2022","COM","2020","407","9","416","2023-01-02"
"08126","2022","COM","2020","222","4","226","2023-01-02"
"08128","2022","COM","2020","63","3","66","2023-01-02"
"08130","2022","COM","2020","83","1","84","2023-01-02"
"08131","2022","COM","2020","65","3","68","2023-01-02"
"08132","2022","COM","2020","193","2","195","2023-01-02"
"08133","2022","COM","2020","518","5","523","2023-01-02"
"08134","2022","COM","2020","75","0","75","2023-01-02"
"08135","2022","COM","2020","153","3","156","2023-01-02"
"08136","2022","COM","2020","347","9","356","2023-01-02"
"08137","2022","COM","2020","448","11","459","2023-01-02"
"08138","2022","COM","2020","253","8","261","2023-01-02"
"08139","2022","COM","2020","1042","9","1051","2023-01-02"
"08140","2022","COM","2020","1064","20","1084","2023-01-02"
"08141","2022","COM","2020","183","5","188","2023-01-02"
"08142","2022","COM","2020","2008","27","2035","2023-01-02"
"08143","2022","COM","2020","73","0","73","2023-01-02"
"08144","2022","COM","2020","103","1","104","2023-01-02"
"08145","2022","COM","2020","2182","39","2221","2023-01-02"
"08146","2022","COM","2020","91","2","93","2023-01-02"
"08147","2022","COM","2020","80","8","88","2023-01-02"
"08148","2022","COM","2020","272","4","276","2023-01-02"
"08149","2022","COM","2020","142","5","147","2023-01-02"
"08150","2022","COM","2020","169","5","174","2023-01-02"
"08151","2022","COM","2020","297","11","308","2023-01-02"
"08153","2022","COM","2020","344","4","348","2023-01-02"
"08154","2022","COM","2020","82","3","85","2023-01-02"
"08155","2022","COM","2020","99","1","100","2023-01-02"
"08156","2022","COM","2020","495","7","502","2023-01-02"
"08158","2022","COM","2020","290","5","295","2023-01-02"
"08159","2022","COM","2020","110","3","113","2023-01-02"
"08160","2022","COM","2020","189","4","193","2023-01-02"
"08161","2022","COM","2020","36","1","37","2023-01-02"
"08162","2022","COM","2020","344","6","350","2023-01-02"
"08163","2022","COM","2020","260","3","263","2023-01-02"
"08164","2022","COM","2020","340","7","347","2023-01-02"
"08165","2022","COM","2020","59","3","62","2023-01-02"
"08166","2022","COM","2020","258","9","267","2023-01-02"
"08167","2022","COM","2020","73","2","75","2023-01-02"
"08168","2022","COM","2020","175","4","179","2023-01-02"
"08169","2022","COM","2020","96","7","103","2023-01-02"
"08170","2022","COM","2020","222","3","225","2023-01-02"
"08171","2022","COM","2020","94","4","98","2023-01-02"
"08172","2022","COM","2020","177","1","178","2023-01-02"
"08173","2022","COM","2020","1708","47","1755","2023-01-02"
"08174","2022","COM","2020","2293","54","2347","2023-01-02"
"08175","2022","COM","2020","242","8","250","2023-01-02"
"08176","2022","COM","2020","56","1","57","2023-01-02"
"08178","2022","COM","2020","184","5","189","2023-01-02"
"08179","2022","COM","2020","589","13","602","2023-01-02"
"08180","2022","COM","2020","1664","40","1704","2023-01-02"
"08182","2022","COM","2020","57","1","58","2023-01-02"
"08183","2022","COM","2020","1046","24","1070","2023-01-02"
"08184","2022","COM","2020","84","2","86","2023-01-02"
"08185","2022","COM","2020","3181","47","3228","2023-01-02"
"08186","2022","COM","2020","49","0","49","2023-01-02"
"08187","2022","COM","2020","312","8","320","2023-01-02"
"08188","2022","COM","2020","995","17","1012","2023-01-02"
"08189","2022","COM","2020","165","2","167","2023-01-02"
"08190","2022","COM","2020","6343","144","6487","2023-01-02"
"08191","2022","COM","2020","1056","27","1083","2023-01-02"
"08192","2022","COM","2020","89","0","89","2023-01-02"
"08193","2022","COM","2020","271","6","277","2023-01-02"
"08194","2022","COM","2020","832","12","844","2023-01-02"
"08195","2022","COM","2020","324","3","327","2023-01-02"
"08196","2022","COM","2020","99","3","102","2023-01-02"
"08197","2022","COM","2020","37","3","40","2023-01-02"
"08198","2022","COM","2020","514","17","531","2023-01-02"
"08199","2022","COM","2020","790","17","807","2023-01-02"
"08200","2022","COM","2020","184","4","188","2023-01-02"
"08201","2022","COM","2020","103","2","105","2023-01-02"
"08202","2022","COM","2020","513","10","523","2023-01-02"
"08203","2022","COM","2020","274","6","280","2023-01-02"
"08204","2022","COM","2020","78","1","79","2023-01-02"
"08205","2022","COM","2020","70","0","70","2023-01-02"
"08206","2022","COM","2020","367","10","377","2023-01-02"
"08207","2022","COM","2020","228","4","232","2023-01-02"
"08208","2022","COM","2020","134","1","135","2023-01-02"
"08209","2022","COM","2020","463","8","471","2023-01-02"
"08210","2022","COM","2020","113","4","117","2023-01-02"
"08211","2022","COM","2020","720","4","724","2023-01-02"
"08212","2022","COM","2020","504","10","514","2023-01-02"
"08214","2022","COM","2020","489","3","492","2023-01-02"
"08215","2022","COM","2020","44","2","46","2023-01-02"
"08216","2022","COM","2020","314","13","327","2023-01-02"
"08217","2022","COM","2020","87","0","87","2023-01-02"
"08218","2022","COM","2020","1382","24","1406","2023-01-02"
"08219","2022","COM","2020","118","1","119","2023-01-02"
"08220","2022","COM","2020","338","8","346","2023-01-02"
"08222","2022","COM","2020","1829","45","1874","2023-01-02"
"08223","2022","COM","2020","123","2","125","2023-01-02"
"08225","2022","COM","2020","207","6","213","2023-01-02"
"08226","2022","COM","2020","167","4","171","2023-01-02"
"08228","2022","COM","2020","161","5","166","2023-01-02"
"08229","2022","COM","2020","130","7","137","2023-01-02"
"08230","2022","COM","2020","392","6","398","2023-01-02"
"08232","2022","COM","2020","413","9","422","2023-01-02"
"08233","2022","COM","2020","45","1","46","2023-01-02"
"08234","2022","COM","2020","115","0","115","2023-01-02"
"08235","2022","COM","2020","382","4","386","2023-01-02"
"08236","2022","COM","2020","301","10","311","2023-01-02"
"08237","2022","COM","2020","643","18","661","2023-01-02"
"08238","2022","COM","2020","98","3","101","2023-01-02"
"08239","2022","COM","2020","1247","28","1275","2023-01-02"
"08240","2022","COM","2020","169","4","173","2023-01-02"
"08242","2022","COM","2020","423","7","430","2023-01-02"
"08243","2022","COM","2020","164","3","167","2023-01-02"
"08244","2022","COM","2020","73","3","76","2023-01-02"
"08245","2022","COM","2020","31","2","33","2023-01-02"
"08246","2022","COM","2020","72","2","74","2023-01-02"
"08247","2022","COM","2020","135","2","137","2023-01-02"
"08248","2022","COM","2020","685","8","693","2023-01-02"
"08249","2022","COM","2020","237","10","247","2023-01-02"
"08250","2022","COM","2020","187","1","188","2023-01-02"
"08251","2022","COM","2020","73","2","75","2023-01-02"
"08252","2022","COM","2020","113","2","115","2023-01-02"
"08254","2022","COM","2020","618","10","628","2023-01-02"
"08255","2022","COM","2020","222","3","225","2023-01-02"
"08256","2022","COM","2020","84","3","87","2023-01-02"
"08257","2022","COM","2020","154","3","157","2023-01-02"
"08259","2022","COM","2020","71","2","73","2023-01-02"
"08260","2022","COM","2020","619","8","627","2023-01-02"
"08262","2022","COM","2020","571","34","605","2023-01-02"
"08263","2022","COM","2020","1114","26","1140","2023-01-02"
"08264","2022","COM","2020","513","14","527","2023-01-02"
"08268","2022","COM","2020","69","4","73","2023-01-02"
"08269","2022","COM","2020","78","1","79","2023-01-02"
"08271","2022","COM","2020","102","1","103","2023-01-02"
"08272","2022","COM","2020","56","0","56","2023-01-02"
"08273","2022","COM","2020","73","1","74","2023-01-02"
"08274","2022","COM","2020","96","4","100","2023-01-02"
"08275","2022","COM","2020","213","4","217","2023-01-02"
"08276","2022","COM","2020","725","13","738","2023-01-02"
"08277","2022","COM","2020","129","4","133","2023-01-02"
"08278","2022","COM","2020","80","0","80","2023-01-02"
"08279","2022","COM","2020","62","2","64","2023-01-02"
"08280","2022","COM","2020","73","2","75","2023-01-02"
"08281","2022","COM","2020","469","10","479","2023-01-02"
"08282","2022","COM","2020","1031","72","1103","2023-01-02"
"08283","2022","COM","2020","127","1","128","2023-01-02"
"08284","2022","COM","2020","878","23","901","2023-01-02"
"08286","2022","COM","2020","116","5","121","2023-01-02"
"08287","2022","COM","2020","137","3","140","2023-01-02"
"08288","2022","COM","2020","90","1","91","2023-01-02"
"08289","2022","COM","2020","605","9","614","2023-01-02"
"08291","2022","COM","2020","240","5","245","2023-01-02"
"08293","2022","COM","2020","140","5","145","2023-01-02"
"08294","2022","COM","2020","132","2","134","2023-01-02"
"08295","2022","COM","2020","187","4","191","2023-01-02"
"08296","2022","COM","2020","113","7","120","2023-01-02"
"08297","2022","COM","2020","300","8","308","2023-01-02"
"08298","2022","COM","2020","1589","47","1636","2023-01-02"
"08300","2022","COM","2020","14","1","15","2023-01-02"
"08301","2022","COM","2020","69","3","72","2023-01-02"
"08302","2022","COM","2020","2191","77","2268","2023-01-02"
"08303","2022","COM","2020","388","8","396","2023-01-02"
"08304","2022","COM","2020","80","2","82","2023-01-02"
"08305","2022","COM","2020","244","2","246","2023-01-02"
"08306","2022","COM","2020","53","3","56","2023-01-02"
"08307","2022","COM","2020","83","1","84","2023-01-02"
"08308","2022","COM","2020","89","0","89","2023-01-02"
"08309","2022","COM","2020","58","1","59","2023-01-02"
"08310","2022","COM","2020","70","7","77","2023-01-02"
"08311","2022","COM","2020","2227","39","2266","2023-01-02"
"08312","2022","COM","2020","190","7","197","2023-01-02"
"08313","2022","COM","2020","146","2","148","2023-01-02"
"08314","2022","COM","2020","843","25","868","2023-01-02"
"08315","2022","COM","2020","75","2","77","2023-01-02"
"08316","2022","COM","2020","993","14","1007","2023-01-02"
"08317","2022","COM","2020","110","4","114","2023-01-02"
"08318","2022","COM","2020","355","2","357","2023-01-02"
"08319","2022","COM","2020","336","8","344","2023-01-02"
"08320","2022","COM","2020","543","16","559","2023-01-02"
"08321","2022","COM","2020","173","4","177","2023-01-02"
"08322","2022","COM","2020","359","13","372","2023-01-02"
"08323","2022","COM","2020","160","0","160","2023-01-02"
"08324","2022","COM","2020","114","2","116","2023-01-02"
"08325","2022","COM","2020","25","2","27","2023-01-02"
"08326","2022","COM","2020","117","2","119","2023-01-02"
"08327","2022","COM","2020","2241","36","2277","2023-01-02"
"08328","2022","COM","2020","5635","67","5702","2023-01-02"
"08329","2022","COM","2020","502","10","512","2023-01-02"
"08330","2022","COM","2020","792","8","800","2023-01-02"
"08331","2022","COM","2020","665","14","679","2023-01-02"
"08332","2022","COM","2020","41","4","45","2023-01-02"
"08333","2022","COM","2020","235","8","243","2023-01-02"
"08334","2022","COM","2020","40","3","43","2023-01-02"
"08335","2022","COM","2020","79","1","80","2023-01-02"
"08336","2022","COM","2020","229","3","232","2023-01-02"
"08338","2022","COM","2020","195","3","198","2023-01-02"
"08339","2022","COM","2020","306","4","310","2023-01-02"
"08340","2022","COM","2020","174","4","178","2023-01-02"
"08341","2022","COM","2020","870","40","910","2023-01-02"
"08342","2022","COM","2020","239","5","244","2023-01-02"
"08343","2022","COM","2020","1144","22","1166","2023-01-02"
"08344","2022","COM","2020","132","2","134","2023-01-02"
"08346","2022","COM","2020","1355","34","1389","2023-01-02"
"08347","2022","COM","2020","217","5","222","2023-01-02"
"08348","2022","COM","2020","112","3","115","2023-01-02"
"08349","2022","COM","2020","562","7","569","2023-01-02"
"08350","2022","COM","2020","238","3","241","2023-01-02"
"08351","2022","COM","2020","78","2","80","2023-01-02"
"08352","2022","COM","2020","208","2","210","2023-01-02"
"08353","2022","COM","2020","720","19","739","2023-01-02"
"08354","2022","COM","2020","821","14","835","2023-01-02"
"08355","2022","COM","2020","387","7","394","2023-01-02"
"08356","2022","COM","2020","178","1","179","2023-01-02"
"08357","2022","COM","2020","779","21","800","2023-01-02"
"08358","2022","COM","2020","255","3","258","2023-01-02"
"08360","2022","COM","2020","198","5","203","2023-01-02"
"08361","2022","COM","2020","1636","57","1693","2023-01-02"
"08362","2022","COM","2020","7445","294","7739","2023-01-02"
"08363","2022","COM","2020","5825","122","5947","2023-01-02"
"08364","2022","COM","2020","128","0","128","2023-01-02"
"08365","2022","COM","2020","1330","20","1350","2023-01-02"
"08366","2022","COM","2020","672","6","678","2023-01-02"
"08367","2022","COM","2020","2266","29","2295","2023-01-02"
"08368","2022","COM","2020","221","3","224","2023-01-02"
"08369","2022","COM","2020","131","3","134","2023-01-02"
"08370","2022","COM","2020","571","6","577","2023-01-02"
"08372","2022","COM","2020","66","0","66","2023-01-02"
"08373","2022","COM","2020","284","4","288","2023-01-02"
"08374","2022","COM","2020","125","0","125","2023-01-02"
"08375","2022","COM","2020","178","4","182","2023-01-02"
"08376","2022","COM","2020","250","5","255","2023-01-02"
"08377","2022","COM","2020","154","2","156","2023-01-02"
"08378","2022","COM","2020","108","0","108","2023-01-02"
"08379","2022","COM","2020","243","10","253","2023-01-02"
"08380","2022","COM","2020","216","4","220","2023-01-02"
"08381","2022","COM","2020","818","12","830","2023-01-02"
"08382","2022","COM","2020","96","3","99","2023-01-02"
"08383","2022","COM","2020","101","4","105","2023-01-02"
"08384","2022","COM","2020","143","3","146","2023-01-02"
"08385","2022","COM","2020","1066","170","1236","2023-01-02"
"08386","2022","COM","2020","343","3","346","2023-01-02"
"08387","2022","COM","2020","182","6","188","2023-01-02"
"08388","2022","COM","2020","344","11","355","2023-01-02"
"08389","2022","COM","2020","327","7","334","2023-01-02"
"08390","2022","COM","2020","79","3","82","2023-01-02"
"08391","2022","COM","2020","941","15","956","2023-01-02"
"08392","2022","COM","2020","190","11","201","2023-01-02"
"08393","2022","COM","2020","66","0","66","2023-01-02"
"08394","2022","COM","2020","72","3","75","2023-01-02"
"08395","2022","COM","2020","144","4","148","2023-01-02"
"08396","2022","COM","2020","122","0","122","2023-01-02"
"08397","2022","COM","2020","54","0","54","2023-01-02"
"08398","2022","COM","2020","91","2","93","2023-01-02"
"08399","2022","COM","2020","138","3","141","2023-01-02"
"08400","2022","COM","2020","515","12","527","2023-01-02"
"08401","2022","COM","2020","225","3","228","2023-01-02"
"08402","2022","COM","2020","835","17","852","2023-01-02"
"08403","2022","COM","2020","1928","15","1943","2023-01-02"
"08404","2022","COM","2020","214","5","219","2023-01-02"
"08405","2022","COM","2020","235","9","244","2023-01-02"
"08406","2022","COM","2020","373","13","386","2023-01-02"
"08407","2022","COM","2020","59","0","59","2023-01-02"
"08408","2022","COM","2020","561","10","571","2023-01-02"
"08409","2022","COM","2020","16376","354","16730","2023-01-02"
"08410","2022","COM","2020","177","17","194","2023-01-02"
"08411","2022","COM","2020","88","0","88","2023-01-02"
"08412","2022","COM","2020","156","3","159","2023-01-02"
"08413","2022","COM","2020","257","3","260","2023-01-02"
"08415","2022","COM","2020","329","13","342","2023-01-02"
"08416","2022","COM","2020","173","6","179","2023-01-02"
"08417","2022","COM","2020","281","8","289","2023-01-02"
"08418","2022","COM","2020","223","3","226","2023-01-02"
"08419","2022","COM","2020","1351","18","1369","2023-01-02"
"08420","2022","COM","2020","1186","21","1207","2023-01-02"
"08421","2022","COM","2020","94","1","95","2023-01-02"
"08422","2022","COM","2020","135","4","139","2023-01-02"
"08424","2022","COM","2020","128","3","131","2023-01-02"
"08425","2022","COM","2020","46","0","46","2023-01-02"
"08426","2022","COM","2020","95","3","98","2023-01-02"
"08427","2022","COM","2020","211","1","212","2023-01-02"
"08428","2022","COM","2020","144","2","146","2023-01-02"
"08429","2022","COM","2020","529","14","543","2023-01-02"
"08430","2022","COM","2020","39","2","41","2023-01-02"
"08431","2022","COM","2020","100","7","107","2023-01-02"
"08432","2022","COM","2020","105","3","108","2023-01-02"
"08433","2022","COM","2020","59","2","61","2023-01-02"
"08434","2022","COM","2020","52","2","54","2023-01-02"
"08435","2022","COM","2020","873","14","887","2023-01-02"
"08436","2022","COM","2020","402","7","409","2023-01-02"
"08437","2022","COM","2020","174","6","180","2023-01-02"
"08438","2022","COM","2020","105","2","107","2023-01-02"
"08439","2022","COM","2020","147","10","157","2023-01-02"
"08440","2022","COM","2020","129","2","131","2023-01-02"
"08444","2022","COM","2020","128","4","132","2023-01-02"
"08445","2022","COM","2020","414","6","420","2023-01-02"
"08446","2022","COM","2020","81","2","83","2023-01-02"
"08448","2022","COM","2020","1032","11","1043","2023-01-02"
"08449","2022","COM","2020","648","14","662","2023-01-02"
"08450","2022","COM","2020","224","9","233","2023-01-02"
"08451","2022","COM","2020","375","8","383","2023-01-02"
"08452","2022","COM","2020","265","7","272","2023-01-02"
"08453","2022","COM","2020","104","3","107","2023-01-02"
"08454","2022","COM","2020","84","0","84","2023-01-02"
"08455","2022","COM","2020","91","1","92","2023-01-02"
"08456","2022","COM","2020","228","4","232","2023-01-02"
"08457","2022","COM","2020","1063","28","1091","2023-01-02"
"08458","2022","COM","2020","180","5","185","2023-01-02"
"08459","2022","COM","2020","140","3","143","2023-01-02"
"08460","2022","COM","2020","152","0","152","2023-01-02"
"08461","2022","COM","2020","204","1","205","2023-01-02"
"08462","2022","COM","2020","128","4","132","2023-01-02"
"08463","2022","COM","2020","55","1","56","2023-01-02"
"08464","2022","COM","2020","79","0","79","2023-01-02"
"08465","2022","COM","2020","43","3","46","2023-01-02"
"08466","2022","COM","2020","69","2","71","2023-01-02"
"08467","2022","COM","2020","107","0","107","2023-01-02"
"08468","2022","COM","2020","194","0","194","2023-01-02"
"08469","2022","COM","2020","477","12","489","2023-01-02"
"08470","2022","COM","2020","66","1","67","2023-01-02"
"08471","2022","COM","2020","32","1","33","2023-01-02"
"08472","2022","COM","2020","297","2","299","2023-01-02"
"08473","2022","COM","2020","302","7","309","2023-01-02"
"08476","2022","COM","2020","418","7","425","2023-01-02"
"08477","2022","COM","2020","109","0","109","2023-01-02"
"08478","2022","COM","2020","238","3","241","2023-01-02"
"08479","2022","COM","2020","202","3","205","2023-01-02"
"08480","2022","COM","2020","3588","65","3653","2023-01-02"
"08481","2022","COM","2020","253","5","258","2023-01-02"
"08482","2022","COM","2020","103","3","106","2023-01-02"
"08483","2022","COM","2020","526","13","539","2023-01-02"
"08484","2022","COM","2020","79","0","79","2023-01-02"
"08485","2022","COM","2020","199","11","210","2023-01-02"
"08486","2022","COM","2020","1465","31","1496","2023-01-02"
"08487","2022","COM","2020","1940","54","1994","2023-01-02"
"08488","2022","COM","2020","2901","83","2984","2023-01-02"
"08489","2022","COM","2020","216","2","218","2023-01-02"
"08490","2022","COM","2020","4169","136","4305","2023-01-02"
"08491","2022","COM","2020","3556","52","3608","2023-01-02"
"08492","2022","COM","2020","329","8","337","2023-01-02"
"08494","2022","COM","2020","455","7","462","2023-01-02"
"08496","2022","COM","2020","124","1","125","2023-01-02"
"08497","2022","COM","2020","1227","25","1252","2023-01-02"
"08498","2022","COM","2020","381","15","396","2023-01-02"
"08499","2022","COM","2020","316","3","319","2023-01-02"
"08500","2022","COM","2020","56","1","57","2023-01-02"
"08501","2022","COM","2020","41","2","43","2023-01-02"
"08502","2022","COM","2020","91","3","94","2023-01-02"
"08503","2022","COM","2020","121","1","122","2023-01-02"
"09001","2022","COM","2020","57","1","58","2023-01-02"
"09002","2022","COM","2020","634","20","654","2023-01-02"
"09003","2022","COM","2020","381","9","390","2023-01-02"
"09004","2022","COM","2020","120","0","120","2023-01-02"
"09005","2022","COM","2020","128","2","130","2023-01-02"
"09006","2022","COM","2020","56","0","56","2023-01-02"
"09007","2022","COM","2020","73","0","73","2023-01-02"
"09008","2022","COM","2020","120","2","122","2023-01-02"
"09009","2022","COM","2020","267","6","273","2023-01-02"
"09011","2022","COM","2020","74","1","75","2023-01-02"
"09012","2022","COM","2020","28","2","30","2023-01-02"
"09013","2022","COM","2020","81","1","82","2023-01-02"
"09014","2022","COM","2020","192","5","197","2023-01-02"
"09015","2022","COM","2020","702","19","721","2023-01-02"
"09016","2022","COM","2020","217","8","225","2023-01-02"
"09017","2022","COM","2020","112","1","113","2023-01-02"
"09018","2022","COM","2020","90","4","94","2023-01-02"
"09019","2022","COM","2020","560","9","569","2023-01-02"
"09020","2022","COM","2020","35","0","35","2023-01-02"
"09021","2022","COM","2020","118","3","121","2023-01-02"
"09022","2022","COM","2020","222","2","224","2023-01-02"
"09023","2022","COM","2020","119","1","120","2023-01-02"
"09024","2022","COM","2020","203","5","208","2023-01-02"
"09025","2022","COM","2020","53","4","57","2023-01-02"
"09026","2022","COM","2020","151","0","151","2023-01-02"
"09027","2022","COM","2020","79","0","79","2023-01-02"
"09029","2022","COM","2020","159","6","165","2023-01-02"
"09030","2022","COM","2020","501","5","506","2023-01-02"
"09031","2022","COM","2020","43","1","44","2023-01-02"
"09032","2022","COM","2020","1285","65","1350","2023-01-02"
"09033","2022","COM","2020","36","1","37","2023-01-02"
"09034","2022","COM","2020","38","0","38","2023-01-02"
"09035","2022","COM","2020","198","3","201","2023-01-02"
"09037","2022","COM","2020","42","0","42","2023-01-02"
"09038","2022","COM","2020","381","5","386","2023-01-02"
"09039","2022","COM","2020","339","13","352","2023-01-02"
"09040","2022","COM","2020","289","7","296","2023-01-02"
"09041","2022","COM","2020","205","7","212","2023-01-02"
"09042","2022","COM","2020","992","12","1004","2023-01-02"
"09043","2022","COM","2020","672","19","691","2023-01-02"
"09044","2022","COM","2020","167","2","169","2023-01-02"
"09045","2022","COM","2020","197","1","198","2023-01-02"
"09046","2022","COM","2020","66","4","70","2023-01-02"
"09047","2022","COM","2020","1072","18","1090","2023-01-02"
"09048","2022","COM","2020","82","0","82","2023-01-02"
"09049","2022","COM","2020","177","3","180","2023-01-02"
"09050","2022","COM","2020","529","7","536","2023-01-02"
"09051","2022","COM","2020","151","4","155","2023-01-02"
"09052","2022","COM","2020","166","8","174","2023-01-02"
"09053","2022","COM","2020","19","3","22","2023-01-02"
"09054","2022","COM","2020","354","5","359","2023-01-02"
"09055","2022","COM","2020","92","1","93","2023-01-02"
"09056","2022","COM","2020","413","11","424","2023-01-02"
"09057","2022","COM","2020","315","5","320","2023-01-02"
"09058","2022","COM","2020","193","5","198","2023-01-02"
"09059","2022","COM","2020","122","4","126","2023-01-02"
"09060","2022","COM","2020","761","10","771","2023-01-02"
"09061","2022","COM","2020","499","5","504","2023-01-02"
"09062","2022","COM","2020","212","6","218","2023-01-02"
"09063","2022","COM","2020","115","2","117","2023-01-02"
"09064","2022","COM","2020","40","0","40","2023-01-02"
"09065","2022","COM","2020","223","3","226","2023-01-02"
"09066","2022","COM","2020","622","10","632","2023-01-02"
"09067","2022","COM","2020","211","3","214","2023-01-02"
"09068","2022","COM","2020","44","0","44","2023-01-02"
"09069","2022","COM","2020","25","0","25","2023-01-02"
"09070","2022","COM","2020","332","8","340","2023-01-02"
"09071","2022","COM","2020","220","8","228","2023-01-02"
"09072","2022","COM","2020","37","1","38","2023-01-02"
"09073","2022","COM","2020","200","1","201","2023-01-02"
"09074","2022","COM","2020","149","1","150","2023-01-02"
"09075","2022","COM","2020","283","5","288","2023-01-02"
"09076","2022","COM","2020","202","7","209","2023-01-02"
"09077","2022","COM","2020","190","1","191","2023-01-02"
"09078","2022","COM","2020","73","0","73","2023-01-02"
"09079","2022","COM","2020","797","14","811","2023-01-02"
"09080","2022","COM","2020","172","5","177","2023-01-02"
"09081","2022","COM","2020","275","11","286","2023-01-02"
"09082","2022","COM","2020","453","9","462","2023-01-02"
"09083","2022","COM","2020","21","0","21","2023-01-02"
"09084","2022","COM","2020","97","1","98","2023-01-02"
"09085","2022","COM","2020","412","3","415","2023-01-02"
"09086","2022","COM","2020","334","8","342","2023-01-02"
"09087","2022","COM","2020","45","0","45","2023-01-02"
"09088","2022","COM","2020","15","0","15","2023-01-02"
"09089","2022","COM","2020","56","2","58","2023-01-02"
"09090","2022","COM","2020","38","7","45","2023-01-02"
"09091","2022","COM","2020","200","3","203","2023-01-02"
"09092","2022","COM","2020","61","3","64","2023-01-02"
"09093","2022","COM","2020","151","1","152","2023-01-02"
"09094","2022","COM","2020","138","4","142","2023-01-02"
"09095","2022","COM","2020","154","3","157","2023-01-02"
"09096","2022","COM","2020","41","3","44","2023-01-02"
"09097","2022","COM","2020","116","0","116","2023-01-02"
"09098","2022","COM","2020","67","1","68","2023-01-02"
"09099","2022","COM","2020","379","14","393","2023-01-02"
"09100","2022","COM","2020","95","1","96","2023-01-02"
"09101","2022","COM","2020","287","3","290","2023-01-02"
"09102","2022","COM","2020","174","7","181","2023-01-02"
"09103","2022","COM","2020","895","16","911","2023-01-02"
"09104","2022","COM","2020","775","18","793","2023-01-02"
"09105","2022","COM","2020","741","9","750","2023-01-02"
"09106","2022","COM","2020","359","16","375","2023-01-02"
"09107","2022","COM","2020","625","17","642","2023-01-02"
"09108","2022","COM","2020","174","4","178","2023-01-02"
"09109","2022","COM","2020","184","3","187","2023-01-02"
"09110","2022","COM","2020","93","3","96","2023-01-02"
"09111","2022","COM","2020","307","4","311","2023-01-02"
"09113","2022","COM","2020","569","3","572","2023-01-02"
"09114","2022","COM","2020","132","2","134","2023-01-02"
"09115","2022","COM","2020","126","1","127","2023-01-02"
"09116","2022","COM","2020","370","3","373","2023-01-02"
"09117","2022","COM","2020","106","0","106","2023-01-02"
"09118","2022","COM","2020","179","2","181","2023-01-02"
"09119","2022","COM","2020","540","12","552","2023-01-02"
"09120","2022","COM","2020","348","4","352","2023-01-02"
"09121","2022","COM","2020","749","100","849","2023-01-02"
"09122","2022","COM","2020","9515","326","9841","2023-01-02"
"09123","2022","COM","2020","114","1","115","2023-01-02"
"09124","2022","COM","2020","1041","12","1053","2023-01-02"
"09125","2022","COM","2020","429","6","435","2023-01-02"
"09126","2022","COM","2020","82","3","85","2023-01-02"
"09127","2022","COM","2020","125","3","128","2023-01-02"
"09128","2022","COM","2020","316","10","326","2023-01-02"
"09129","2022","COM","2020","114","3","117","2023-01-02"
"09130","2022","COM","2020","730","9","739","2023-01-02"
"09131","2022","COM","2020","147","0","147","2023-01-02"
"09132","2022","COM","2020","245","3","248","2023-01-02"
"09133","2022","COM","2020","23","1","24","2023-01-02"
"09134","2022","COM","2020","33","1","34","2023-01-02"
"09136","2022","COM","2020","72","3","75","2023-01-02"
"09137","2022","COM","2020","201","4","205","2023-01-02"
"09138","2022","COM","2020","194","28","222","2023-01-02"
"09139","2022","COM","2020","103","0","103","2023-01-02"
"09140","2022","COM","2020","122","6","128","2023-01-02"
"09141","2022","COM","2020","73","0","73","2023-01-02"
"09142","2022","COM","2020","125","0","125","2023-01-02"
"09143","2022","COM","2020","37","0","37","2023-01-02"
"09145","2022","COM","2020","247","10","257","2023-01-02"
"09146","2022","COM","2020","58","0","58","2023-01-02"
"09147","2022","COM","2020","177","2","179","2023-01-02"
"09148","2022","COM","2020","121","5","126","2023-01-02"
"09149","2022","COM","2020","192","4","196","2023-01-02"
"09150","2022","COM","2020","200","6","206","2023-01-02"
"09151","2022","COM","2020","55","0","55","2023-01-02"
"09152","2022","COM","2020","20","1","21","2023-01-02"
"09153","2022","COM","2020","119","4","123","2023-01-02"
"09154","2022","COM","2020","61","2","63","2023-01-02"
"09155","2022","COM","2020","48","0","48","2023-01-02"
"09156","2022","COM","2020","20","0","20","2023-01-02"
"09157","2022","COM","2020","2391","44","2435","2023-01-02"
"09158","2022","COM","2020","254","7","261","2023-01-02"
"09159","2022","COM","2020","91","2","93","2023-01-02"
"09160","2022","COM","2020","6052","125","6177","2023-01-02"
"09161","2022","COM","2020","618","16","634","2023-01-02"
"09162","2022","COM","2020","15","0","15","2023-01-02"
"09163","2022","COM","2020","81","0","81","2023-01-02"
"09164","2022","COM","2020","489","17","506","2023-01-02"
"09165","2022","COM","2020","233","0","233","2023-01-02"
"09166","2022","COM","2020","105","2","107","2023-01-02"
"09167","2022","COM","2020","2360","40","2400","2023-01-02"
"09168","2022","COM","2020","183","8","191","2023-01-02"
"09169","2022","COM","2020","121","3","124","2023-01-02"
"09170","2022","COM","2020","250","9","259","2023-01-02"
"09171","2022","COM","2020","70","0","70","2023-01-02"
"09172","2022","COM","2020","24","0","24","2023-01-02"
"09173","2022","COM","2020","283","5","288","2023-01-02"
"09174","2022","COM","2020","358","13","371","2023-01-02"
"09175","2022","COM","2020","93","4","97","2023-01-02"
"09176","2022","COM","2020","513","9","522","2023-01-02"
"09177","2022","COM","2020","246","6","252","2023-01-02"
"09178","2022","COM","2020","43","2","45","2023-01-02"
"09179","2022","COM","2020","79","1","80","2023-01-02"
"09180","2022","COM","2020","119","1","120","2023-01-02"
"09181","2022","COM","2020","1181","18","1199","2023-01-02"
"09182","2022","COM","2020","734","10","744","2023-01-02"
"09183","2022","COM","2020","102","4","106","2023-01-02"
"09184","2022","COM","2020","49","1","50","2023-01-02"
"09185","2022","COM","2020","3872","83","3955","2023-01-02"
"09186","2022","COM","2020","101","0","101","2023-01-02"
"09187","2022","COM","2020","351","10","361","2023-01-02"
"09188","2022","COM","2020","1203","24","1227","2023-01-02"
"09189","2022","COM","2020","168","4","172","2023-01-02"
"09190","2022","COM","2020","112","1","113","2023-01-02"
"09192","2022","COM","2020","112","3","115","2023-01-02"
"09193","2022","COM","2020","60","0","60","2023-01-02"
"09194","2022","COM","2020","3114","122","3236","2023-01-02"
"09195","2022","COM","2020","29","0","29","2023-01-02"
"09196","2022","COM","2020","79","1","80","2023-01-02"
"09197","2022","COM","2020","17","0","17","2023-01-02"
"09198","2022","COM","2020","216","5","221","2023-01-02"
"09199","2022","COM","2020","695","17","712","2023-01-02"
"09200","2022","COM","2020","97","3","100","2023-01-02"
"09201","2022","COM","2020","78","1","79","2023-01-02"
"09202","2022","COM","2020","335","9","344","2023-01-02"
"09203","2022","COM","2020","154","9","163","2023-01-02"
"09204","2022","COM","2020","253","11","264","2023-01-02"
"09205","2022","COM","2020","85","1","86","2023-01-02"
"09206","2022","COM","2020","553","13","566","2023-01-02"
"09207","2022","COM","2020","1476","30","1506","2023-01-02"
"09208","2022","COM","2020","120","1","121","2023-01-02"
"09209","2022","COM","2020","1010","21","1031","2023-01-02"
"09210","2022","COM","2020","411","7","418","2023-01-02"
"09211","2022","COM","2020","117","2","119","2023-01-02"
"09212","2022","COM","2020","107","1","108","2023-01-02"
"09213","2022","COM","2020","240","2","242","2023-01-02"
"09214","2022","COM","2020","768","16","784","2023-01-02"
"09215","2022","COM","2020","119","2","121","2023-01-02"
"09216","2022","COM","2020","63","1","64","2023-01-02"
"09217","2022","COM","2020","154","2","156","2023-01-02"
"09218","2022","COM","2020","92","1","93","2023-01-02"
"09219","2022","COM","2020","185","4","189","2023-01-02"
"09220","2022","COM","2020","165","3","168","2023-01-02"
"09221","2022","COM","2020","248","3","251","2023-01-02"
"09222","2022","COM","2020","27","0","27","2023-01-02"
"09223","2022","COM","2020","562","8","570","2023-01-02"
"09224","2022","COM","2020","486","1","487","2023-01-02"
"09225","2022","COM","2020","15938","483","16421","2023-01-02"
"09226","2022","COM","2020","37","0","37","2023-01-02"
"09227","2022","COM","2020","194","1","195","2023-01-02"
"09228","2022","COM","2020","226","5","231","2023-01-02"
"09229","2022","COM","2020","476","12","488","2023-01-02"
"09230","2022","COM","2020","62","0","62","2023-01-02"
"09231","2022","COM","2020","165","1","166","2023-01-02"
"09232","2022","COM","2020","31","0","31","2023-01-02"
"09233","2022","COM","2020","45","1","46","2023-01-02"
"09234","2022","COM","2020","121","3","124","2023-01-02"
"09235","2022","COM","2020","861","16","877","2023-01-02"
"09236","2022","COM","2020","368","16","384","2023-01-02"
"09237","2022","COM","2020","30","1","31","2023-01-02"
"09238","2022","COM","2020","840","17","857","2023-01-02"
"09239","2022","COM","2020","138","2","140","2023-01-02"
"09240","2022","COM","2020","295","3","298","2023-01-02"
"09241","2022","COM","2020","368","6","374","2023-01-02"
"09242","2022","COM","2020","54","1","55","2023-01-02"
"09243","2022","COM","2020","85","3","88","2023-01-02"
"09244","2022","COM","2020","720","12","732","2023-01-02"
"09245","2022","COM","2020","1270","36","1306","2023-01-02"
"09246","2022","COM","2020","532","20","552","2023-01-02"
"09247","2022","COM","2020","160","10","170","2023-01-02"
"09249","2022","COM","2020","146","4","150","2023-01-02"
"09250","2022","COM","2020","90","2","92","2023-01-02"
"09251","2022","COM","2020","165","7","172","2023-01-02"
"09252","2022","COM","2020","90","0","90","2023-01-02"
"09253","2022","COM","2020","391","6","397","2023-01-02"
"09254","2022","COM","2020","249","4","253","2023-01-02"
"09255","2022","COM","2020","41","0","41","2023-01-02"
"09256","2022","COM","2020","59","0","59","2023-01-02"
"09257","2022","COM","2020","631","9","640","2023-01-02"
"09258","2022","COM","2020","466","10","476","2023-01-02"
"09259","2022","COM","2020","153","4","157","2023-01-02"
"09260","2022","COM","2020","30","0","30","2023-01-02"
"09261","2022","COM","2020","6415","397","6812","2023-01-02"
"09262","2022","COM","2020","378","5","383","2023-01-02"
"09263","2022","COM","2020","23","0","23","2023-01-02"
"09264","2022","COM","2020","1285","17","1302","2023-01-02"
"09265","2022","COM","2020","2855","59","2914","2023-01-02"
"09266","2022","COM","2020","72","2","74","2023-01-02"
"09267","2022","COM","2020","125","2","127","2023-01-02"
"09268","2022","COM","2020","1367","32","1399","2023-01-02"
"09269","2022","COM","2020","365","11","376","2023-01-02"
"09270","2022","COM","2020","230","4","234","2023-01-02"
"09271","2022","COM","2020","85","2","87","2023-01-02"
"09272","2022","COM","2020","1337","25","1362","2023-01-02"
"09273","2022","COM","2020","668","23","691","2023-01-02"
"09274","2022","COM","2020","338","5","343","2023-01-02"
"09275","2022","COM","2020","370","10","380","2023-01-02"
"09276","2022","COM","2020","221","10","231","2023-01-02"
"09277","2022","COM","2020","690","11","701","2023-01-02"
"09279","2022","COM","2020","48","2","50","2023-01-02"
"09280","2022","COM","2020","659","12","671","2023-01-02"
"09281","2022","COM","2020","123","2","125","2023-01-02"
"09282","2022","COM","2020","4815","151","4966","2023-01-02"
"09283","2022","COM","2020","398","16","414","2023-01-02"
"09284","2022","COM","2020","188","6","194","2023-01-02"
"09285","2022","COM","2020","704","14","718","2023-01-02"
"09287","2022","COM","2020","11","0","11","2023-01-02"
"09289","2022","COM","2020","1461","23","1484","2023-01-02"
"09290","2022","COM","2020","158","3","161","2023-01-02"
"09291","2022","COM","2020","105","3","108","2023-01-02"
"09292","2022","COM","2020","58","0","58","2023-01-02"
"09293","2022","COM","2020","678","10","688","2023-01-02"
"09294","2022","COM","2020","101","2","103","2023-01-02"
"09295","2022","COM","2020","96","1","97","2023-01-02"
"09296","2022","COM","2020","150","2","152","2023-01-02"
"09297","2022","COM","2020","27","0","27","2023-01-02"
"09298","2022","COM","2020","83","1","84","2023-01-02"
"09299","2022","COM","2020","430","7","437","2023-01-02"
"09300","2022","COM","2020","176","7","183","2023-01-02"
"09301","2022","COM","2020","372","2","374","2023-01-02"
"09303","2022","COM","2020","319","8","327","2023-01-02"
"09304","2022","COM","2020","17","0","17","2023-01-02"
"09305","2022","COM","2020","352","7","359","2023-01-02"
"09306","2022","COM","2020","3013","31","3044","2023-01-02"
"09307","2022","COM","2020","154","2","156","2023-01-02"
"09308","2022","COM","2020","207","8","215","2023-01-02"
"09309","2022","COM","2020","156","5","161","2023-01-02"
"09310","2022","COM","2020","44","2","46","2023-01-02"
"09311","2022","COM","2020","21","0","21","2023-01-02"
"09312","2022","COM","2020","3232","71","3303","2023-01-02"
"09313","2022","COM","2020","158","4","162","2023-01-02"
"09314","2022","COM","2020","262","14","276","2023-01-02"
"09315","2022","COM","2020","121","1","122","2023-01-02"
"09316","2022","COM","2020","109","1","110","2023-01-02"
"09318","2022","COM","2020","126","1","127","2023-01-02"
"09319","2022","COM","2020","114","4","118","2023-01-02"
"09320","2022","COM","2020","28","1","29","2023-01-02"
"09321","2022","COM","2020","310","4","314","2023-01-02"
"09322","2022","COM","2020","268","10","278","2023-01-02"
"09323","2022","COM","2020","90","1","91","2023-01-02"
"09324","2022","COM","2020","3495","57","3552","2023-01-02"
"09325","2022","COM","2020","32","0","32","2023-01-02"
"09326","2022","COM","2020","121","3","124","2023-01-02"
"09327","2022","COM","2020","235","2","237","2023-01-02"
"09328","2022","COM","2020","213","9","222","2023-01-02"
"09329","2022","COM","2020","698","20","718","2023-01-02"
"09330","2022","COM","2020","29","0","29","2023-01-02"
"09331","2022","COM","2020","727","6","733","2023-01-02"
"09332","2022","COM","2020","2295","49","2344","2023-01-02"
"09334","2022","COM","2020","554","63","617","2023-01-02"
"09335","2022","COM","2020","41","0","41","2023-01-02"
"09336","2022","COM","2020","957","21","978","2023-01-02"
"09338","2022","COM","2020","154","3","157","2023-01-02"
"09339","2022","COM","2020","778","14","792","2023-01-02"
"09340","2022","COM","2020","156","4","160","2023-01-02"
"09341","2022","COM","2020","153","0","153","2023-01-02"
"09342","2022","COM","2020","238","2","240","2023-01-02"
"10002","2022","COM","2020","232","5","237","2023-01-02"
"10003","2022","COM","2020","3537","39","3576","2023-01-02"
"10004","2022","COM","2020","207","2","209","2023-01-02"
"10005","2022","COM","2020","250","12","262","2023-01-02"
"10006","2022","COM","2020","2767","78","2845","2023-01-02"
"10007","2022","COM","2020","104","2","106","2023-01-02"
"10008","2022","COM","2020","113","1","114","2023-01-02"
"10009","2022","COM","2020","86","2","88","2023-01-02"
"10010","2022","COM","2020","46","2","48","2023-01-02"
"10011","2022","COM","2020","208","1","209","2023-01-02"
"10012","2022","COM","2020","300","5","305","2023-01-02"
"10013","2022","COM","2020","143","5","148","2023-01-02"
"10014","2022","COM","2020","186","1","187","2023-01-02"
"10015","2022","COM","2020","379","6","385","2023-01-02"
"10017","2022","COM","2020","123","3","126","2023-01-02"
"10018","2022","COM","2020","1030","10","1040","2023-01-02"
"10019","2022","COM","2020","380","5","385","2023-01-02"
"10020","2022","COM","2020","503","10","513","2023-01-02"
"10021","2022","COM","2020","156","4","160","2023-01-02"
"10022","2022","COM","2020","200","11","211","2023-01-02"
"10023","2022","COM","2020","193","4","197","2023-01-02"
"10024","2022","COM","2020","170","3","173","2023-01-02"
"10025","2022","COM","2020","172","4","176","2023-01-02"
"10026","2022","COM","2020","37","0","37","2023-01-02"
"10027","2022","COM","2020","59","2","61","2023-01-02"
"10028","2022","COM","2020","117","2","119","2023-01-02"
"10029","2022","COM","2020","154","2","156","2023-01-02"
"10030","2022","COM","2020","1568","29","1597","2023-01-02"
"10031","2022","COM","2020","475","8","483","2023-01-02"
"10032","2022","COM","2020","301","9","310","2023-01-02"
"10033","2022","COM","2020","4774","194","4968","2023-01-02"
"10034","2022","COM","2020","2932","196","3128","2023-01-02"
"10035","2022","COM","2020","747","9","756","2023-01-02"
"10037","2022","COM","2020","432","10","442","2023-01-02"
"10038","2022","COM","2020","197","2","199","2023-01-02"
"10039","2022","COM","2020","114","5","119","2023-01-02"
"10040","2022","COM","2020","165","8","173","2023-01-02"
"10041","2022","COM","2020","51","0","51","2023-01-02"
"10042","2022","COM","2020","201","4","205","2023-01-02"
"10043","2022","COM","2020","121","3","124","2023-01-02"
"10044","2022","COM","2020","34","0","34","2023-01-02"
"10045","2022","COM","2020","180","9","189","2023-01-02"
"10046","2022","COM","2020","109","2","111","2023-01-02"
"10047","2022","COM","2020","42","1","43","2023-01-02"
"10048","2022","COM","2020","162","4","166","2023-01-02"
"10049","2022","COM","2020","525","9","534","2023-01-02"
"10050","2022","COM","2020","194","3","197","2023-01-02"
"10051","2022","COM","2020","1078","47","1125","2023-01-02"
"10052","2022","COM","2020","220","5","225","2023-01-02"
"10053","2022","COM","2020","603","9","612","2023-01-02"
"10054","2022","COM","2020","110","1","111","2023-01-02"
"10055","2022","COM","2020","261","11","272","2023-01-02"
"10056","2022","COM","2020","247","1","248","2023-01-02"
"10057","2022","COM","2020","53","1","54","2023-01-02"
"10058","2022","COM","2020","235","4","239","2023-01-02"
"10059","2022","COM","2020","112","5","117","2023-01-02"
"10060","2022","COM","2020","2933","56","2989","2023-01-02"
"10061","2022","COM","2020","667","12","679","2023-01-02"
"10062","2022","COM","2020","199","3","202","2023-01-02"
"10063","2022","COM","2020","402","13","415","2023-01-02"
"10064","2022","COM","2020","2754","25","2779","2023-01-02"
"10065","2022","COM","2020","84","1","85","2023-01-02"
"10066","2022","COM","2020","437","10","447","2023-01-02"
"10067","2022","COM","2020","1889","29","1918","2023-01-02"
"10068","2022","COM","2020","121","3","124","2023-01-02"
"10069","2022","COM","2020","115","0","115","2023-01-02"
"10070","2022","COM","2020","482","19","501","2023-01-02"
"10071","2022","COM","2020","52","1","53","2023-01-02"
"10072","2022","COM","2020","34","0","34","2023-01-02"
"10073","2022","COM","2020","125","2","127","2023-01-02"
"10074","2022","COM","2020","504","8","512","2023-01-02"
"10075","2022","COM","2020","100","1","101","2023-01-02"
"10076","2022","COM","2020","257","7","264","2023-01-02"
"10077","2022","COM","2020","105","1","106","2023-01-02"
"10078","2022","COM","2020","27","0","27","2023-01-02"
"10079","2022","COM","2020","133","2","135","2023-01-02"
"10080","2022","COM","2020","1017","12","1029","2023-01-02"
"10081","2022","COM","2020","12324","87","12411","2023-01-02"
"10082","2022","COM","2020","240","5","245","2023-01-02"
"10083","2022","COM","2020","344","5","349","2023-01-02"
"10084","2022","COM","2020","1011","29","1040","2023-01-02"
"10085","2022","COM","2020","65","0","65","2023-01-02"
"10086","2022","COM","2020","257","8","265","2023-01-02"
"10087","2022","COM","2020","51","0","51","2023-01-02"
"10089","2022","COM","2020","701","7","708","2023-01-02"
"10090","2022","COM","2020","228","3","231","2023-01-02"
"10091","2022","COM","2020","139","5","144","2023-01-02"
"10092","2022","COM","2020","129","0","129","2023-01-02"
"10093","2022","COM","2020","103","2","105","2023-01-02"
"10094","2022","COM","2020","593","11","604","2023-01-02"
"10095","2022","COM","2020","287","5","292","2023-01-02"
"10096","2022","COM","2020","444","11","455","2023-01-02"
"10097","2022","COM","2020","157","2","159","2023-01-02"
"10098","2022","COM","2020","312","5","317","2023-01-02"
"10099","2022","COM","2020","527","14","541","2023-01-02"
"10100","2022","COM","2020","1134","24","1158","2023-01-02"
"10101","2022","COM","2020","172","2","174","2023-01-02"
"10102","2022","COM","2020","181","1","182","2023-01-02"
"10103","2022","COM","2020","154","1","155","2023-01-02"
"10104","2022","COM","2020","306","3","309","2023-01-02"
"10105","2022","COM","2020","26","1","27","2023-01-02"
"10106","2022","COM","2020","141","5","146","2023-01-02"
"10107","2022","COM","2020","102","0","102","2023-01-02"
"10108","2022","COM","2020","81","0","81","2023-01-02"
"10109","2022","COM","2020","226","2","228","2023-01-02"
"10110","2022","COM","2020","568","18","586","2023-01-02"
"10111","2022","COM","2020","103","5","108","2023-01-02"
"10112","2022","COM","2020","178","2","180","2023-01-02"
"10113","2022","COM","2020","198","2","200","2023-01-02"
"10114","2022","COM","2020","706","15","721","2023-01-02"
"10115","2022","COM","2020","1997","34","2031","2023-01-02"
"10116","2022","COM","2020","317","4","321","2023-01-02"
"10117","2022","COM","2020","147","1","148","2023-01-02"
"10118","2022","COM","2020","92","4","96","2023-01-02"
"10119","2022","COM","2020","174","4","178","2023-01-02"
"10120","2022","COM","2020","200","2","202","2023-01-02"
"10121","2022","COM","2020","328","8","336","2023-01-02"
"10122","2022","COM","2020","223","4","227","2023-01-02"
"10123","2022","COM","2020","847","25","872","2023-01-02"
"10124","2022","COM","2020","266","4","270","2023-01-02"
"10125","2022","COM","2020","312","5","317","2023-01-02"
"10126","2022","COM","2020","129","4","133","2023-01-02"
"10127","2022","COM","2020","57","0","57","2023-01-02"
"10128","2022","COM","2020","74","1","75","2023-01-02"
"10129","2022","COM","2020","307","8","315","2023-01-02"
"10130","2022","COM","2020","98","6","104","2023-01-02"
"10131","2022","COM","2020","354","6","360","2023-01-02"
"10132","2022","COM","2020","241","0","241","2023-01-02"
"10133","2022","COM","2020","257","6","263","2023-01-02"
"10134","2022","COM","2020","86","6","92","2023-01-02"
"10135","2022","COM","2020","96","3","99","2023-01-02"
"10136","2022","COM","2020","117","1","118","2023-01-02"
"10137","2022","COM","2020","33","0","33","2023-01-02"
"10138","2022","COM","2020","142","2","144","2023-01-02"
"10139","2022","COM","2020","160","4","164","2023-01-02"
"10140","2022","COM","2020","1125","9","1134","2023-01-02"
"10141","2022","COM","2020","718","12","730","2023-01-02"
"10142","2022","COM","2020","1849","18","1867","2023-01-02"
"10143","2022","COM","2020","161","4","165","2023-01-02"
"10144","2022","COM","2020","155","6","161","2023-01-02"
"10145","2022","COM","2020","207","7","214","2023-01-02"
"10146","2022","COM","2020","92","3","95","2023-01-02"
"10147","2022","COM","2020","129","4","133","2023-01-02"
"10148","2022","COM","2020","409","6","415","2023-01-02"
"10149","2022","COM","2020","333","5","338","2023-01-02"
"10150","2022","COM","2020","250","5","255","2023-01-02"
"10151","2022","COM","2020","884","9","893","2023-01-02"
"10153","2022","COM","2020","611","14","625","2023-01-02"
"10154","2022","COM","2020","71","1","72","2023-01-02"
"10155","2022","COM","2020","182","6","188","2023-01-02"
"10156","2022","COM","2020","707","8","715","2023-01-02"
"10157","2022","COM","2020","214","6","220","2023-01-02"
"10158","2022","COM","2020","526","7","533","2023-01-02"
"10159","2022","COM","2020","86","1","87","2023-01-02"
"10160","2022","COM","2020","39","1","40","2023-01-02"
"10161","2022","COM","2020","49","3","52","2023-01-02"
"10162","2022","COM","2020","295","6","301","2023-01-02"
"10163","2022","COM","2020","41","2","43","2023-01-02"
"10164","2022","COM","2020","734","10","744","2023-01-02"
"10165","2022","COM","2020","336","6","342","2023-01-02"
"10166","2022","COM","2020","397","6","403","2023-01-02"
"10167","2022","COM","2020","90","1","91","2023-01-02"
"10168","2022","COM","2020","81","1","82","2023-01-02"
"10169","2022","COM","2020","219","8","227","2023-01-02"
"10170","2022","COM","2020","476","9","485","2023-01-02"
"10171","2022","COM","2020","227","7","234","2023-01-02"
"10172","2022","COM","2020","154","1","155","2023-01-02"
"10173","2022","COM","2020","460","8","468","2023-01-02"
"10174","2022","COM","2020","168","3","171","2023-01-02"
"10175","2022","COM","2020","171","4","175","2023-01-02"
"10176","2022","COM","2020","156","6","162","2023-01-02"
"10177","2022","COM","2020","150","7","157","2023-01-02"
"10178","2022","COM","2020","257","6","263","2023-01-02"
"10179","2022","COM","2020","471","10","481","2023-01-02"
"10180","2022","COM","2020","96","3","99","2023-01-02"
"10181","2022","COM","2020","214","12","226","2023-01-02"
"10182","2022","COM","2020","119","1","120","2023-01-02"
"10183","2022","COM","2020","35","1","36","2023-01-02"
"10184","2022","COM","2020","127","1","128","2023-01-02"
"10185","2022","COM","2020","209","4","213","2023-01-02"
"10186","2022","COM","2020","529","16","545","2023-01-02"
"10187","2022","COM","2020","391","10","401","2023-01-02"
"10188","2022","COM","2020","210","7","217","2023-01-02"
"10189","2022","COM","2020","58","0","58","2023-01-02"
"10190","2022","COM","2020","576","6","582","2023-01-02"
"10191","2022","COM","2020","896","9","905","2023-01-02"
"10192","2022","COM","2020","129","1","130","2023-01-02"
"10193","2022","COM","2020","302","4","306","2023-01-02"
"10194","2022","COM","2020","94","2","96","2023-01-02"
"10195","2022","COM","2020","287","6","293","2023-01-02"
"10196","2022","COM","2020","219","4","223","2023-01-02"
"10197","2022","COM","2020","170","10","180","2023-01-02"
"10198","2022","COM","2020","104","2","106","2023-01-02"
"10199","2022","COM","2020","347","6","353","2023-01-02"
"10200","2022","COM","2020","95","3","98","2023-01-02"
"10201","2022","COM","2020","69","0","69","2023-01-02"
"10202","2022","COM","2020","216","80","296","2023-01-02"
"10203","2022","COM","2020","374","13","387","2023-01-02"
"10204","2022","COM","2020","141","3","144","2023-01-02"
"10205","2022","COM","2020","85","2","87","2023-01-02"
"10206","2022","COM","2020","128","1","129","2023-01-02"
"10207","2022","COM","2020","130","1","131","2023-01-02"
"10208","2022","COM","2020","290","12","302","2023-01-02"
"10209","2022","COM","2020","2225","57","2282","2023-01-02"
"10210","2022","COM","2020","457","13","470","2023-01-02"
"10211","2022","COM","2020","997","16","1013","2023-01-02"
"10212","2022","COM","2020","113","3","116","2023-01-02"
"10213","2022","COM","2020","159","3","162","2023-01-02"
"10214","2022","COM","2020","90","1","91","2023-01-02"
"10215","2022","COM","2020","261","2","263","2023-01-02"
"10216","2022","COM","2020","2038","26","2064","2023-01-02"
"10217","2022","COM","2020","33","0","33","2023-01-02"
"10218","2022","COM","2020","168","1","169","2023-01-02"
"10219","2022","COM","2020","69","3","72","2023-01-02"
"10220","2022","COM","2020","1505","43","1548","2023-01-02"
"10221","2022","COM","2020","160","0","160","2023-01-02"
"10222","2022","COM","2020","434","7","441","2023-01-02"
"10223","2022","COM","2020","726","9","735","2023-01-02"
"10224","2022","COM","2020","1761","32","1793","2023-01-02"
"10225","2022","COM","2020","235","7","242","2023-01-02"
"10226","2022","COM","2020","113","2","115","2023-01-02"
"10227","2022","COM","2020","340","4","344","2023-01-02"
"10228","2022","COM","2020","204","2","206","2023-01-02"
"10229","2022","COM","2020","102","2","104","2023-01-02"
"10230","2022","COM","2020","674","9","683","2023-01-02"
"10231","2022","COM","2020","624","10","634","2023-01-02"
"10232","2022","COM","2020","325","3","328","2023-01-02"
"10233","2022","COM","2020","1488","43","1531","2023-01-02"
"10234","2022","COM","2020","271","0","271","2023-01-02"
"10235","2022","COM","2020","50","0","50","2023-01-02"
"10236","2022","COM","2020","56","1","57","2023-01-02"
"10237","2022","COM","2020","590","29","619","2023-01-02"
"10238","2022","COM","2020","439","9","448","2023-01-02"
"10239","2022","COM","2020","589","24","613","2023-01-02"
"10240","2022","COM","2020","467","10","477","2023-01-02"
"10241","2022","COM","2020","61","0","61","2023-01-02"
"10242","2022","COM","2020","158","3","161","2023-01-02"
"10243","2022","COM","2020","104","5","109","2023-01-02"
"10245","2022","COM","2020","812","27","839","2023-01-02"
"10246","2022","COM","2020","256","20","276","2023-01-02"
"10247","2022","COM","2020","120","4","124","2023-01-02"
"10248","2022","COM","2020","393","11","404","2023-01-02"
"10249","2022","COM","2020","403","8","411","2023-01-02"
"10250","2022","COM","2020","222","6","228","2023-01-02"
"10251","2022","COM","2020","254","8","262","2023-01-02"
"10252","2022","COM","2020","61","2","63","2023-01-02"
"10253","2022","COM","2020","143","1","144","2023-01-02"
"10254","2022","COM","2020","329","9","338","2023-01-02"
"10255","2022","COM","2020","287","5","292","2023-01-02"
"10256","2022","COM","2020","405","4","409","2023-01-02"
"10257","2022","COM","2020","29","0","29","2023-01-02"
"10258","2022","COM","2020","277","7","284","2023-01-02"
"10259","2022","COM","2020","361","3","364","2023-01-02"
"10260","2022","COM","2020","652","16","668","2023-01-02"
"10261","2022","COM","2020","1021","15","1036","2023-01-02"
"10262","2022","COM","2020","395","8","403","2023-01-02"
"10263","2022","COM","2020","446","6","452","2023-01-02"
"10264","2022","COM","2020","113","3","116","2023-01-02"
"10265","2022","COM","2020","3279","32","3311","2023-01-02"
"10266","2022","COM","2020","46","0","46","2023-01-02"
"10267","2022","COM","2020","297","6","303","2023-01-02"
"10268","2022","COM","2020","5946","116","6062","2023-01-02"
"10269","2022","COM","2020","153","4","157","2023-01-02"
"10270","2022","COM","2020","265","6","271","2023-01-02"
"10271","2022","COM","2020","598","7","605","2023-01-02"
"10272","2022","COM","2020","179","3","182","2023-01-02"
"10273","2022","COM","2020","23","0","23","2023-01-02"
"10274","2022","COM","2020","310","4","314","2023-01-02"
"10275","2022","COM","2020","596","7","603","2023-01-02"
"10276","2022","COM","2020","335","6","341","2023-01-02"
"10278","2022","COM","2020","136","4","140","2023-01-02"
"10279","2022","COM","2020","47","1","48","2023-01-02"
"10280","2022","COM","2020","816","8","824","2023-01-02"
"10281","2022","COM","2020","287","5","292","2023-01-02"
"10282","2022","COM","2020","1375","19","1394","2023-01-02"
"10283","2022","COM","2020","129","2","131","2023-01-02"
"10284","2022","COM","2020","150","3","153","2023-01-02"
"10285","2022","COM","2020","69","0","69","2023-01-02"
"10286","2022","COM","2020","206","7","213","2023-01-02"
"10287","2022","COM","2020","1477","16","1493","2023-01-02"
"10288","2022","COM","2020","265","4","269","2023-01-02"
"10289","2022","COM","2020","966","16","982","2023-01-02"
"10290","2022","COM","2020","232","3","235","2023-01-02"
"10291","2022","COM","2020","180","7","187","2023-01-02"
"10293","2022","COM","2020","159","2","161","2023-01-02"
"10294","2022","COM","2020","61","2","63","2023-01-02"
"10295","2022","COM","2020","324","6","330","2023-01-02"
"10296","2022","COM","2020","182","2","184","2023-01-02"
"10297","2022","COM","2020","5146","91","5237","2023-01-02"
"10298","2022","COM","2020","1160","20","1180","2023-01-02"
"10299","2022","COM","2020","513","17","530","2023-01-02"
"10300","2022","COM","2020","289","2","291","2023-01-02"
"10301","2022","COM","2020","176","4","180","2023-01-02"
"10302","2022","COM","2020","85","2","87","2023-01-02"
"10303","2022","COM","2020","77","1","78","2023-01-02"
"10304","2022","COM","2020","183","2","185","2023-01-02"
"10305","2022","COM","2020","87","1","88","2023-01-02"
"10306","2022","COM","2020","236","6","242","2023-01-02"
"10307","2022","COM","2020","365","10","375","2023-01-02"
"10308","2022","COM","2020","209","8","217","2023-01-02"
"10309","2022","COM","2020","96","2","98","2023-01-02"
"10310","2022","COM","2020","211","7","218","2023-01-02"
"10312","2022","COM","2020","169","4","173","2023-01-02"
"10313","2022","COM","2020","356","4","360","2023-01-02"
"10314","2022","COM","2020","410","4","414","2023-01-02"
"10315","2022","COM","2020","45","2","47","2023-01-02"
"10316","2022","COM","2020","216","3","219","2023-01-02"
"10317","2022","COM","2020","1207","23","1230","2023-01-02"
"10318","2022","COM","2020","156","2","158","2023-01-02"
"10319","2022","COM","2020","322","9","331","2023-01-02"
"10320","2022","COM","2020","230","5","235","2023-01-02"
"10321","2022","COM","2020","3621","66","3687","2023-01-02"
"10323","2022","COM","2020","14623","336","14959","2023-01-02"
"10324","2022","COM","2020","159","3","162","2023-01-02"
"10325","2022","COM","2020","4633","328","4961","2023-01-02"
"10326","2022","COM","2020","169","8","177","2023-01-02"
"10327","2022","COM","2020","116","1","117","2023-01-02"
"10328","2022","COM","2020","389","4","393","2023-01-02"
"10329","2022","COM","2020","521","38","559","2023-01-02"
"10330","2022","COM","2020","112","1","113","2023-01-02"
"10331","2022","COM","2020","568","10","578","2023-01-02"
"10332","2022","COM","2020","495","11","506","2023-01-02"
"10333","2022","COM","2020","12701","179","12880","2023-01-02"
"10334","2022","COM","2020","590","8","598","2023-01-02"
"10335","2022","COM","2020","237","5","242","2023-01-02"
"10336","2022","COM","2020","391","5","396","2023-01-02"
"10337","2022","COM","2020","33","1","34","2023-01-02"
"10338","2022","COM","2020","177","3","180","2023-01-02"
"10339","2022","COM","2020","294","6","300","2023-01-02"
"10340","2022","COM","2020","2305","48","2353","2023-01-02"
"10341","2022","COM","2020","355","9","364","2023-01-02"
"10342","2022","COM","2020","404","8","412","2023-01-02"
"10343","2022","COM","2020","6738","145","6883","2023-01-02"
"10344","2022","COM","2020","912","15","927","2023-01-02"
"10345","2022","COM","2020","383","11","394","2023-01-02"
"10346","2022","COM","2020","51","1","52","2023-01-02"
"10347","2022","COM","2020","207","6","213","2023-01-02"
"10348","2022","COM","2020","228","4","232","2023-01-02"
"10349","2022","COM","2020","2889","62","2951","2023-01-02"
"10350","2022","COM","2020","638","14","652","2023-01-02"
"10351","2022","COM","2020","365","5","370","2023-01-02"
"10352","2022","COM","2020","1752","294","2046","2023-01-02"
"10353","2022","COM","2020","891","11","902","2023-01-02"
"10354","2022","COM","2020","137","4","141","2023-01-02"
"10355","2022","COM","2020","69","0","69","2023-01-02"
"10356","2022","COM","2020","311","7","318","2023-01-02"
"10357","2022","COM","2020","3179","48","3227","2023-01-02"
"10358","2022","COM","2020","1062","18","1080","2023-01-02"
"10359","2022","COM","2020","510","11","521","2023-01-02"
"10360","2022","COM","2020","972","231","1203","2023-01-02"
"10361","2022","COM","2020","246","4","250","2023-01-02"
"10362","2022","COM","2020","10496","351","10847","2023-01-02"
"10363","2022","COM","2020","547","3","550","2023-01-02"
"10364","2022","COM","2020","72","2","74","2023-01-02"
"10365","2022","COM","2020","125","0","125","2023-01-02"
"10366","2022","COM","2020","63","2","65","2023-01-02"
"10367","2022","COM","2020","681","9","690","2023-01-02"
"10368","2022","COM","2020","1025","17","1042","2023-01-02"
"10369","2022","COM","2020","202","4","206","2023-01-02"
"10370","2022","COM","2020","250","6","256","2023-01-02"
"10371","2022","COM","2020","308","5","313","2023-01-02"
"10372","2022","COM","2020","419","6","425","2023-01-02"
"10373","2022","COM","2020","378","20","398","2023-01-02"
"10374","2022","COM","2020","153","1","154","2023-01-02"
"10375","2022","COM","2020","334","10","344","2023-01-02"
"10376","2022","COM","2020","154","3","157","2023-01-02"
"10377","2022","COM","2020","111","9","120","2023-01-02"
"10378","2022","COM","2020","68","3","71","2023-01-02"
"10379","2022","COM","2020","457","9","466","2023-01-02"
"10380","2022","COM","2020","77","2","79","2023-01-02"
"10381","2022","COM","2020","995","18","1013","2023-01-02"
"10382","2022","COM","2020","1036","13","1049","2023-01-02"
"10383","2022","COM","2020","184","3","187","2023-01-02"
"10384","2022","COM","2020","204","7","211","2023-01-02"
"10386","2022","COM","2020","217","6","223","2023-01-02"
"10387","2022","COM","2020","62597","1111","63708","2023-01-02"
"10388","2022","COM","2020","43","1","44","2023-01-02"
"10389","2022","COM","2020","112","4","116","2023-01-02"
"10390","2022","COM","2020","120","2","122","2023-01-02"
"10391","2022","COM","2020","298","1","299","2023-01-02"
"10392","2022","COM","2020","402","9","411","2023-01-02"
"10393","2022","COM","2020","180","1","181","2023-01-02"
"10394","2022","COM","2020","166","1","167","2023-01-02"
"10395","2022","COM","2020","293","4","297","2023-01-02"
"10396","2022","COM","2020","499","7","506","2023-01-02"
"10397","2022","COM","2020","167","2","169","2023-01-02"
"10398","2022","COM","2020","74","1","75","2023-01-02"
"10399","2022","COM","2020","721","8","729","2023-01-02"
"10400","2022","COM","2020","116","5","121","2023-01-02"
"10401","2022","COM","2020","2317","41","2358","2023-01-02"
"10402","2022","COM","2020","244","5","249","2023-01-02"
"10403","2022","COM","2020","52","1","53","2023-01-02"
"10404","2022","COM","2020","111","2","113","2023-01-02"
"10405","2022","COM","2020","58","0","58","2023-01-02"
"10406","2022","COM","2020","1858","37","1895","2023-01-02"
"10408","2022","COM","2020","134","5","139","2023-01-02"
"10409","2022","COM","2020","611","4","615","2023-01-02"
"10410","2022","COM","2020","105","4","109","2023-01-02"
"10411","2022","COM","2020","28","0","28","2023-01-02"
"10412","2022","COM","2020","949","20","969","2023-01-02"
"10414","2022","COM","2020","125","5","130","2023-01-02"
"10416","2022","COM","2020","243","4","247","2023-01-02"
"10417","2022","COM","2020","207","6","213","2023-01-02"
"10418","2022","COM","2020","198","10","208","2023-01-02"
"10419","2022","COM","2020","739","13","752","2023-01-02"
"10420","2022","COM","2020","2685","44","2729","2023-01-02"
"10421","2022","COM","2020","147","4","151","2023-01-02"
"10422","2022","COM","2020","185","2","187","2023-01-02"
"10423","2022","COM","2020","408","15","423","2023-01-02"
"10424","2022","COM","2020","63","2","65","2023-01-02"
"10425","2022","COM","2020","270","3","273","2023-01-02"
"10426","2022","COM","2020","907","12","919","2023-01-02"
"10427","2022","COM","2020","200","7","207","2023-01-02"
"10428","2022","COM","2020","99","5","104","2023-01-02"
"10429","2022","COM","2020","249","3","252","2023-01-02"
"10430","2022","COM","2020","84","2","86","2023-01-02"
"10431","2022","COM","2020","102","1","103","2023-01-02"
"10432","2022","COM","2020","71","1","72","2023-01-02"
"10433","2022","COM","2020","253","8","261","2023-01-02"
"10434","2022","COM","2020","57","1","58","2023-01-02"
"10435","2022","COM","2020","190","4","194","2023-01-02"
"10436","2022","COM","2020","176","5","181","2023-01-02"
"10437","2022","COM","2020","600","10","610","2023-01-02"
"10438","2022","COM","2020","222","2","224","2023-01-02"
"10439","2022","COM","2020","123","3","126","2023-01-02"
"10440","2022","COM","2020","144","6","150","2023-01-02"
"10441","2022","COM","2020","231","1","232","2023-01-02"
"10442","2022","COM","2020","699","9","708","2023-01-02"
"10443","2022","COM","2020","43","1","44","2023-01-02"
"10444","2022","COM","2020","226","3","229","2023-01-02"
"10445","2022","COM","2020","54","9","63","2023-01-02"
"11001","2022","COM","2020","550","11","561","2023-01-02"
"11002","2022","COM","2020","170","2","172","2023-01-02"
"11003","2022","COM","2020","201","3","204","2023-01-02"
"11004","2022","COM","2020","337","5","342","2023-01-02"
"11005","2022","COM","2020","1338","32","1370","2023-01-02"
"11006","2022","COM","2020","78","2","80","2023-01-02"
"11007","2022","COM","2020","119","4","123","2023-01-02"
"11008","2022","COM","2020","388","3","391","2023-01-02"
"11009","2022","COM","2020","1592","23","1615","2023-01-02"
"11010","2022","COM","2020","270","4","274","2023-01-02"
"11011","2022","COM","2020","467","14","481","2023-01-02"
"11012","2022","COM","2020","2155","36","2191","2023-01-02"
"11013","2022","COM","2020","355","6","361","2023-01-02"
"11014","2022","COM","2020","1495","30","1525","2023-01-02"
"11015","2022","COM","2020","261","3","264","2023-01-02"
"11016","2022","COM","2020","80","3","83","2023-01-02"
"11017","2022","COM","2020","75","1","76","2023-01-02"
"11018","2022","COM","2020","1211","33","1244","2023-01-02"
"11019","2022","COM","2020","62","0","62","2023-01-02"
"11020","2022","COM","2020","35","0","35","2023-01-02"
"11021","2022","COM","2020","513","9","522","2023-01-02"
"11022","2022","COM","2020","1123","23","1146","2023-01-02"
"11023","2022","COM","2020","745","14","759","2023-01-02"
"11024","2022","COM","2020","782","15","797","2023-01-02"
"11025","2022","COM","2020","308","3","311","2023-01-02"
"11026","2022","COM","2020","172","3","175","2023-01-02"
"11027","2022","COM","2020","793","22","815","2023-01-02"
"11028","2022","COM","2020","376","7","383","2023-01-02"
"11029","2022","COM","2020","61","3","64","2023-01-02"
"11030","2022","COM","2020","114","6","120","2023-01-02"
"11031","2022","COM","2020","21","2","23","2023-01-02"
"11032","2022","COM","2020","247","2","249","2023-01-02"
"11033","2022","COM","2020","1339","28","1367","2023-01-02"
"11034","2022","COM","2020","853","6","859","2023-01-02"
"11035","2022","COM","2020","238","9","247","2023-01-02"
"11036","2022","COM","2020","161","3","164","2023-01-02"
"11037","2022","COM","2020","950","10","960","2023-01-02"
"11038","2022","COM","2020","46","0","46","2023-01-02"
"11039","2022","COM","2020","47","1","48","2023-01-02"
"11040","2022","COM","2020","1754","28","1782","2023-01-02"
"11041","2022","COM","2020","1243","15","1258","2023-01-02"
"11042","2022","COM","2020","235","7","242","2023-01-02"
"11043","2022","COM","2020","221","6","227","2023-01-02"
"11044","2022","COM","2020","104","0","104","2023-01-02"
"11045","2022","COM","2020","144","1","145","2023-01-02"
"11046","2022","COM","2020","55","0","55","2023-01-02"
"11047","2022","COM","2020","48","0","48","2023-01-02"
"11048","2022","COM","2020","722","15","737","2023-01-02"
"11049","2022","COM","2020","3226","78","3304","2023-01-02"
"11051","2022","COM","2020","184","4","188","2023-01-02"
"11052","2022","COM","2020","340","5","345","2023-01-02"
"11053","2022","COM","2020","287","5","292","2023-01-02"
"11054","2022","COM","2020","269","11","280","2023-01-02"
"11055","2022","COM","2020","240","4","244","2023-01-02"
"11056","2022","COM","2020","167","4","171","2023-01-02"
"11057","2022","COM","2020","28","0","28","2023-01-02"
"11058","2022","COM","2020","251","10","261","2023-01-02"
"11059","2022","COM","2020","144","1","145","2023-01-02"
"11060","2022","COM","2020","50","1","51","2023-01-02"
"11061","2022","COM","2020","313","4","317","2023-01-02"
"11062","2022","COM","2020","19","0","19","2023-01-02"
"11063","2022","COM","2020","606","6","612","2023-01-02"
"11064","2022","COM","2020","373","4","377","2023-01-02"
"11065","2022","COM","2020","51","0","51","2023-01-02"
"11066","2022","COM","2020","104","1","105","2023-01-02"
"11067","2022","COM","2020","1832","18","1850","2023-01-02"
"11068","2022","COM","2020","1473","39","1512","2023-01-02"
"11069","2022","COM","2020","46673","1181","47854","2023-01-02"
"11070","2022","COM","2020","338","6","344","2023-01-02"
"11071","2022","COM","2020","223","7","230","2023-01-02"
"11072","2022","COM","2020","163","8","171","2023-01-02"
"11073","2022","COM","2020","59","0","59","2023-01-02"
"11074","2022","COM","2020","307","10","317","2023-01-02"
"11075","2022","COM","2020","134","2","136","2023-01-02"
"11076","2022","COM","2020","12467","511","12978","2023-01-02"
"11077","2022","COM","2020","500","12","512","2023-01-02"
"11078","2022","COM","2020","206","7","213","2023-01-02"
"11079","2022","COM","2020","215","3","218","2023-01-02"
"11080","2022","COM","2020","167","2","169","2023-01-02"
"11081","2022","COM","2020","1601","29","1630","2023-01-02"
"11082","2022","COM","2020","10","0","10","2023-01-02"
"11083","2022","COM","2020","56","0","56","2023-01-02"
"11084","2022","COM","2020","1005","23","1028","2023-01-02"
"11085","2022","COM","2020","960","41","1001","2023-01-02"
"11086","2022","COM","2020","897","11","908","2023-01-02"
"11087","2022","COM","2020","93","1","94","2023-01-02"
"11088","2022","COM","2020","1640","50","1690","2023-01-02"
"11089","2022","COM","2020","408","10","418","2023-01-02"
"11090","2022","COM","2020","615","17","632","2023-01-02"
"11091","2022","COM","2020","1139","12","1151","2023-01-02"
"11092","2022","COM","2020","91","3","94","2023-01-02"
"11093","2022","COM","2020","28","1","29","2023-01-02"
"11094","2022","COM","2020","27","0","27","2023-01-02"
"11095","2022","COM","2020","312","5","317","2023-01-02"
"11096","2022","COM","2020","32","0","32","2023-01-02"
"11098","2022","COM","2020","899","19","918","2023-01-02"
"11099","2022","COM","2020","2585","56","2641","2023-01-02"
"11100","2022","COM","2020","29","1","30","2023-01-02"
"11101","2022","COM","2020","52","2","54","2023-01-02"
"11102","2022","COM","2020","571","14","585","2023-01-02"
"11103","2022","COM","2020","1122","21","1143","2023-01-02"
"11104","2022","COM","2020","52","0","52","2023-01-02"
"11105","2022","COM","2020","706","23","729","2023-01-02"
"11106","2022","COM","2020","5785","95","5880","2023-01-02"
"11107","2022","COM","2020","77","1","78","2023-01-02"
"11108","2022","COM","2020","46","1","47","2023-01-02"
"11109","2022","COM","2020","52","1","53","2023-01-02"
"11110","2022","COM","2020","116","0","116","2023-01-02"
"11111","2022","COM","2020","921","9","930","2023-01-02"
"11112","2022","COM","2020","83","1","84","2023-01-02"
"11113","2022","COM","2020","113","5","118","2023-01-02"
"11114","2022","COM","2020","41","0","41","2023-01-02"
"11115","2022","COM","2020","916","12","928","2023-01-02"
"11116","2022","COM","2020","4044","71","4115","2023-01-02"
"11117","2022","COM","2020","114","2","116","2023-01-02"
"11118","2022","COM","2020","46","0","46","2023-01-02"
"11119","2022","COM","2020","293","4","297","2023-01-02"
"11120","2022","COM","2020","527","13","540","2023-01-02"
"11121","2022","COM","2020","111","1","112","2023-01-02"
"11122","2022","COM","2020","771","13","784","2023-01-02"
"11123","2022","COM","2020","148","3","151","2023-01-02"
"11124","2022","COM","2020","651","11","662","2023-01-02"
"11125","2022","COM","2020","152","0","152","2023-01-02"
"11126","2022","COM","2020","477","5","482","2023-01-02"
"11127","2022","COM","2020","71","4","75","2023-01-02"
"11128","2022","COM","2020","146","2","148","2023-01-02"
"11129","2022","COM","2020","1712","30","1742","2023-01-02"
"11130","2022","COM","2020","229","4","233","2023-01-02"
"11131","2022","COM","2020","582","13","595","2023-01-02"
"11132","2022","COM","2020","1256","15","1271","2023-01-02"
"11133","2022","COM","2020","45","0","45","2023-01-02"
"11134","2022","COM","2020","50","4","54","2023-01-02"
"11135","2022","COM","2020","12","0","12","2023-01-02"
"11136","2022","COM","2020","859","86","945","2023-01-02"
"11137","2022","COM","2020","129","5","134","2023-01-02"
"11138","2022","COM","2020","523","16","539","2023-01-02"
"11139","2022","COM","2020","77","0","77","2023-01-02"
"11140","2022","COM","2020","1256","21","1277","2023-01-02"
"11141","2022","COM","2020","124","1","125","2023-01-02"
"11142","2022","COM","2020","194","5","199","2023-01-02"
"11143","2022","COM","2020","110","0","110","2023-01-02"
"11144","2022","COM","2020","1096","15","1111","2023-01-02"
"11145","2022","COM","2020","3713","60","3773","2023-01-02"
"11146","2022","COM","2020","412","8","420","2023-01-02"
"11147","2022","COM","2020","5","0","5","2023-01-02"
"11148","2022","COM","2020","559","7","566","2023-01-02"
"11149","2022","COM","2020","79","1","80","2023-01-02"
"11150","2022","COM","2020","449","50","499","2023-01-02"
"11151","2022","COM","2020","523","11","534","2023-01-02"
"11152","2022","COM","2020","131","3","134","2023-01-02"
"11153","2022","COM","2020","250","7","257","2023-01-02"
"11154","2022","COM","2020","51","0","51","2023-01-02"
"11155","2022","COM","2020","79","1","80","2023-01-02"
"11156","2022","COM","2020","105","1","106","2023-01-02"
"11157","2022","COM","2020","212","5","217","2023-01-02"
"11158","2022","COM","2020","297","4","301","2023-01-02"
"11159","2022","COM","2020","137","2","139","2023-01-02"
"11160","2022","COM","2020","35","0","35","2023-01-02"
"11161","2022","COM","2020","127","4","131","2023-01-02"
"11162","2022","COM","2020","57","1","58","2023-01-02"
"11163","2022","COM","2020","46","1","47","2023-01-02"
"11164","2022","COM","2020","1515","21","1536","2023-01-02"
"11165","2022","COM","2020","303","9","312","2023-01-02"
"11166","2022","COM","2020","77","2","79","2023-01-02"
"11167","2022","COM","2020","125","5","130","2023-01-02"
"11168","2022","COM","2020","102","3","105","2023-01-02"
"11169","2022","COM","2020","90","5","95","2023-01-02"
"11170","2022","COM","2020","5131","84","5215","2023-01-02"
"11172","2022","COM","2020","597","11","608","2023-01-02"
"11173","2022","COM","2020","129","3","132","2023-01-02"
"11174","2022","COM","2020","56","0","56","2023-01-02"
"11175","2022","COM","2020","479","9","488","2023-01-02"
"11176","2022","COM","2020","56","0","56","2023-01-02"
"11177","2022","COM","2020","31","0","31","2023-01-02"
"11178","2022","COM","2020","1278","15","1293","2023-01-02"
"11179","2022","COM","2020","90","2","92","2023-01-02"
"11180","2022","COM","2020","61","0","61","2023-01-02"
"11181","2022","COM","2020","406","8","414","2023-01-02"
"11182","2022","COM","2020","175","3","178","2023-01-02"
"11183","2022","COM","2020","268","9","277","2023-01-02"
"11184","2022","COM","2020","93","3","96","2023-01-02"
"11185","2022","COM","2020","544","9","553","2023-01-02"
"11186","2022","COM","2020","54","0","54","2023-01-02"
"11187","2022","COM","2020","60","1","61","2023-01-02"
"11188","2022","COM","2020","1712","30","1742","2023-01-02"
"11189","2022","COM","2020","108","1","109","2023-01-02"
"11190","2022","COM","2020","1243","20","1263","2023-01-02"
"11191","2022","COM","2020","150","7","157","2023-01-02"
"11192","2022","COM","2020","783","31","814","2023-01-02"
"11193","2022","COM","2020","282","5","287","2023-01-02"
"11194","2022","COM","2020","155","3","158","2023-01-02"
"11195","2022","COM","2020","393","10","403","2023-01-02"
"11196","2022","COM","2020","181","7","188","2023-01-02"
"11197","2022","COM","2020","608","13","621","2023-01-02"
"11198","2022","COM","2020","1013","15","1028","2023-01-02"
"11199","2022","COM","2020","1517","28","1545","2023-01-02"
"11200","2022","COM","2020","134","3","137","2023-01-02"
"11201","2022","COM","2020","851","18","869","2023-01-02"
"11202","2022","COM","2020","4581","54","4635","2023-01-02"
"11203","2022","COM","2020","11112","226","11338","2023-01-02"
"11204","2022","COM","2020","43","0","43","2023-01-02"
"11205","2022","COM","2020","131","1","132","2023-01-02"
"11206","2022","COM","2020","10161","520","10681","2023-01-02"
"11207","2022","COM","2020","241","5","246","2023-01-02"
"11208","2022","COM","2020","81","3","84","2023-01-02"
"11209","2022","COM","2020","244","8","252","2023-01-02"
"11210","2022","COM","2020","1132","10","1142","2023-01-02"
"11211","2022","COM","2020","537","5","542","2023-01-02"
"11212","2022","COM","2020","577","11","588","2023-01-02"
"11213","2022","COM","2020","47","0","47","2023-01-02"
"11214","2022","COM","2020","426","13","439","2023-01-02"
"11215","2022","COM","2020","863","26","889","2023-01-02"
"11216","2022","COM","2020","365","12","377","2023-01-02"
"11217","2022","COM","2020","1309","28","1337","2023-01-02"
"11218","2022","COM","2020","82","0","82","2023-01-02"
"11219","2022","COM","2020","19","0","19","2023-01-02"
"11220","2022","COM","2020","702","13","715","2023-01-02"
"11221","2022","COM","2020","302","5","307","2023-01-02"
"11222","2022","COM","2020","176","5","181","2023-01-02"
"11223","2022","COM","2020","25","1","26","2023-01-02"
"11224","2022","COM","2020","27","1","28","2023-01-02"
"11225","2022","COM","2020","929","18","947","2023-01-02"
"11226","2022","COM","2020","84","1","85","2023-01-02"
"11227","2022","COM","2020","40","1","41","2023-01-02"
"11228","2022","COM","2020","148","4","152","2023-01-02"
"11229","2022","COM","2020","26","1","27","2023-01-02"
"11230","2022","COM","2020","32","0","32","2023-01-02"
"11231","2022","COM","2020","98","3","101","2023-01-02"
"11232","2022","COM","2020","46","0","46","2023-01-02"
"11233","2022","COM","2020","752","13","765","2023-01-02"
"11234","2022","COM","2020","185","5","190","2023-01-02"
"11235","2022","COM","2020","58","2","60","2023-01-02"
"11236","2022","COM","2020","245","2","247","2023-01-02"
"11238","2022","COM","2020","141","6","147","2023-01-02"
"11239","2022","COM","2020","81","2","83","2023-01-02"
"11240","2022","COM","2020","556","9","565","2023-01-02"
"11241","2022","COM","2020","339","1","340","2023-01-02"
"11242","2022","COM","2020","175","0","175","2023-01-02"
"11243","2022","COM","2020","625","10","635","2023-01-02"
"11244","2022","COM","2020","90","3","93","2023-01-02"
"11245","2022","COM","2020","38","0","38","2023-01-02"
"11246","2022","COM","2020","45","0","45","2023-01-02"
"11247","2022","COM","2020","38","0","38","2023-01-02"
"11248","2022","COM","2020","69","1","70","2023-01-02"
"11249","2022","COM","2020","83","1","84","2023-01-02"
"11250","2022","COM","2020","35","1","36","2023-01-02"
"11251","2022","COM","2020","737","14","751","2023-01-02"
"11252","2022","COM","2020","320","1","321","2023-01-02"
"11253","2022","COM","2020","833","14","847","2023-01-02"
"11254","2022","COM","2020","1980","191","2171","2023-01-02"
"11255","2022","COM","2020","1482","20","1502","2023-01-02"
"11256","2022","COM","2020","621","12","633","2023-01-02"
"11257","2022","COM","2020","234","3","237","2023-01-02"
"11258","2022","COM","2020","2041","47","2088","2023-01-02"
"11259","2022","COM","2020","1003","31","1034","2023-01-02"
"11260","2022","COM","2020","109","1","110","2023-01-02"
"11261","2022","COM","2020","707","8","715","2023-01-02"
"11262","2022","COM","2020","56123","1197","57320","2023-01-02"
"11263","2022","COM","2020","261","8","269","2023-01-02"
"11264","2022","COM","2020","1277","33","1310","2023-01-02"
"11265","2022","COM","2020","41","1","42","2023-01-02"
"11266","2022","COM","2020","5905","70","5975","2023-01-02"
"11267","2022","COM","2020","1113","25","1138","2023-01-02"
"11268","2022","COM","2020","117","0","117","2023-01-02"
"11269","2022","COM","2020","2554","51","2605","2023-01-02"
"11270","2022","COM","2020","140","0","140","2023-01-02"
"11271","2022","COM","2020","32","0","32","2023-01-02"
"11272","2022","COM","2020","2496","71","2567","2023-01-02"
"11273","2022","COM","2020","698","11","709","2023-01-02"
"11274","2022","COM","2020","374","15","389","2023-01-02"
"11275","2022","COM","2020","205","3","208","2023-01-02"
"11276","2022","COM","2020","525","17","542","2023-01-02"
"11277","2022","COM","2020","29","2","31","2023-01-02"
"11278","2022","COM","2020","75","2","77","2023-01-02"
"11279","2022","COM","2020","2714","50","2764","2023-01-02"
"11280","2022","COM","2020","1087","29","1116","2023-01-02"
"11281","2022","COM","2020","1241","33","1274","2023-01-02"
"11282","2022","COM","2020","53","2","55","2023-01-02"
"11283","2022","COM","2020","78","5","83","2023-01-02"
"11284","2022","COM","2020","466","16","482","2023-01-02"
"11285","2022","COM","2020","1143","22","1165","2023-01-02"
"11286","2022","COM","2020","1177","20","1197","2023-01-02"
"11287","2022","COM","2020","87","2","89","2023-01-02"
"11288","2022","COM","2020","1584","153","1737","2023-01-02"
"11289","2022","COM","2020","968","17","985","2023-01-02"
"11290","2022","COM","2020","117","2","119","2023-01-02"
"11291","2022","COM","2020","120","1","121","2023-01-02"
"11292","2022","COM","2020","177","1","178","2023-01-02"
"11293","2022","COM","2020","920","23","943","2023-01-02"
"11294","2022","COM","2020","56","1","57","2023-01-02"
"11295","2022","COM","2020","1322","21","1343","2023-01-02"
"11296","2022","COM","2020","576","5","581","2023-01-02"
"11297","2022","COM","2020","148","1","149","2023-01-02"
"11299","2022","COM","2020","625","14","639","2023-01-02"
"11300","2022","COM","2020","155","0","155","2023-01-02"
"11301","2022","COM","2020","1186","17","1203","2023-01-02"
"11302","2022","COM","2020","263","9","272","2023-01-02"
"11303","2022","COM","2020","436","16","452","2023-01-02"
"11304","2022","COM","2020","3141","96","3237","2023-01-02"
"11305","2022","COM","2020","48","0","48","2023-01-02"
"11306","2022","COM","2020","51","1","52","2023-01-02"
"11307","2022","COM","2020","258","6","264","2023-01-02"
"11308","2022","COM","2020","462","9","471","2023-01-02"
"11309","2022","COM","2020","91","1","92","2023-01-02"
"11310","2022","COM","2020","197","2","199","2023-01-02"
"11311","2022","COM","2020","267","3","270","2023-01-02"
"11312","2022","COM","2020","109","5","114","2023-01-02"
"11313","2022","COM","2020","310","6","316","2023-01-02"
"11314","2022","COM","2020","85","7","92","2023-01-02"
"11315","2022","COM","2020","1937","25","1962","2023-01-02"
"11316","2022","COM","2020","212","3","215","2023-01-02"
"11317","2022","COM","2020","107","2","109","2023-01-02"
"11318","2022","COM","2020","131","6","137","2023-01-02"
"11319","2022","COM","2020","77","2","79","2023-01-02"
"11320","2022","COM","2020","291","10","301","2023-01-02"
"11321","2022","COM","2020","83","0","83","2023-01-02"
"11322","2022","COM","2020","1005","18","1023","2023-01-02"
"11323","2022","COM","2020","273","3","276","2023-01-02"
"11324","2022","COM","2020","503","13","516","2023-01-02"
"11325","2022","COM","2020","453","11","464","2023-01-02"
"11326","2022","COM","2020","76","1","77","2023-01-02"
"11327","2022","COM","2020","508","11","519","2023-01-02"
"11328","2022","COM","2020","238","3","241","2023-01-02"
"11330","2022","COM","2020","509","11","520","2023-01-02"
"11331","2022","COM","2020","60","3","63","2023-01-02"
"11332","2022","COM","2020","1377","17","1394","2023-01-02"
"11333","2022","COM","2020","107","3","110","2023-01-02"
"11334","2022","COM","2020","118","2","120","2023-01-02"
"11335","2022","COM","2020","45","0","45","2023-01-02"
"11336","2022","COM","2020","438","5","443","2023-01-02"
"11337","2022","COM","2020","381","4","385","2023-01-02"
"11338","2022","COM","2020","40","1","41","2023-01-02"
"11339","2022","COM","2020","500","12","512","2023-01-02"
"11340","2022","COM","2020","518","10","528","2023-01-02"
"11341","2022","COM","2020","110","2","112","2023-01-02"
"11342","2022","COM","2020","236","4","240","2023-01-02"
"11343","2022","COM","2020","116","2","118","2023-01-02"
"11344","2022","COM","2020","713","14","727","2023-01-02"
"11345","2022","COM","2020","263","0","263","2023-01-02"
"11346","2022","COM","2020","131","4","135","2023-01-02"
"11347","2022","COM","2020","104","2","106","2023-01-02"
"11348","2022","COM","2020","85","2","87","2023-01-02"
"11350","2022","COM","2020","51","3","54","2023-01-02"
"11351","2022","COM","2020","735","15","750","2023-01-02"
"11352","2022","COM","2020","51","2","53","2023-01-02"
"11353","2022","COM","2020","2028","46","2074","2023-01-02"
"11354","2022","COM","2020","28","1","29","2023-01-02"
"11355","2022","COM","2020","370","8","378","2023-01-02"
"11356","2022","COM","2020","1117","24","1141","2023-01-02"
"11357","2022","COM","2020","212","7","219","2023-01-02"
"11358","2022","COM","2020","24","0","24","2023-01-02"
"11359","2022","COM","2020","481","6","487","2023-01-02"
"11360","2022","COM","2020","2076","37","2113","2023-01-02"
"11361","2022","COM","2020","866","14","880","2023-01-02"
"11362","2022","COM","2020","204","4","208","2023-01-02"
"11363","2022","COM","2020","182","5","187","2023-01-02"
"11364","2022","COM","2020","141","2","143","2023-01-02"
"11365","2022","COM","2020","41","2","43","2023-01-02"
"11366","2022","COM","2020","536","10","546","2023-01-02"
"11367","2022","COM","2020","919","23","942","2023-01-02"
"11368","2022","COM","2020","121","2","123","2023-01-02"
"11369","2022","COM","2020","3039","43","3082","2023-01-02"
"11370","2022","COM","2020","3251","76","3327","2023-01-02"
"11371","2022","COM","2020","715","13","728","2023-01-02"
"11372","2022","COM","2020","378","4","382","2023-01-02"
"11373","2022","COM","2020","69","1","70","2023-01-02"
"11374","2022","COM","2020","20","0","20","2023-01-02"
"11375","2022","COM","2020","29","1","30","2023-01-02"
"11376","2022","COM","2020","95","4","99","2023-01-02"
"11377","2022","COM","2020","81","0","81","2023-01-02"
"11378","2022","COM","2020","198","6","204","2023-01-02"
"11379","2022","COM","2020","5542","98","5640","2023-01-02"
"11380","2022","COM","2020","133","1","134","2023-01-02"
"11381","2022","COM","2020","124","4","128","2023-01-02"
"11382","2022","COM","2020","359","58","417","2023-01-02"
"11383","2022","COM","2020","333","11","344","2023-01-02"
"11384","2022","COM","2020","128","1","129","2023-01-02"
"11385","2022","COM","2020","234","7","241","2023-01-02"
"11386","2022","COM","2020","467","8","475","2023-01-02"
"11387","2022","COM","2020","110","1","111","2023-01-02"
"11388","2022","COM","2020","47","0","47","2023-01-02"
"11389","2022","COM","2020","15","0","15","2023-01-02"
"11390","2022","COM","2020","554","10","564","2023-01-02"
"11391","2022","COM","2020","24","2","26","2023-01-02"
"11392","2022","COM","2020","268","4","272","2023-01-02"
"11393","2022","COM","2020","489","7","496","2023-01-02"
"11394","2022","COM","2020","130","0","130","2023-01-02"
"11395","2022","COM","2020","28","0","28","2023-01-02"
"11396","2022","COM","2020","598","3","601","2023-01-02"
"11397","2022","COM","2020","5438","122","5560","2023-01-02"
"11398","2022","COM","2020","255","5","260","2023-01-02"
"11399","2022","COM","2020","106","5","111","2023-01-02"
"11400","2022","COM","2020","105","1","106","2023-01-02"
"11401","2022","COM","2020","790","12","802","2023-01-02"
"11402","2022","COM","2020","24","0","24","2023-01-02"
"11404","2022","COM","2020","955","31","986","2023-01-02"
"11405","2022","COM","2020","575","10","585","2023-01-02"
"11406","2022","COM","2020","32","2","34","2023-01-02"
"11407","2022","COM","2020","286","6","292","2023-01-02"
"11408","2022","COM","2020","489","14","503","2023-01-02"
"11409","2022","COM","2020","105","1","106","2023-01-02"
"11410","2022","COM","2020","970","17","987","2023-01-02"
"11411","2022","COM","2020","137","3","140","2023-01-02"
"11412","2022","COM","2020","56","0","56","2023-01-02"
"11413","2022","COM","2020","500","10","510","2023-01-02"
"11414","2022","COM","2020","24","1","25","2023-01-02"
"11415","2022","COM","2020","125","0","125","2023-01-02"
"11416","2022","COM","2020","257","5","262","2023-01-02"
"11417","2022","COM","2020","98","0","98","2023-01-02"
"11418","2022","COM","2020","1212","40","1252","2023-01-02"
"11419","2022","COM","2020","64","0","64","2023-01-02"
"11420","2022","COM","2020","139","3","142","2023-01-02"
"11421","2022","COM","2020","554","8","562","2023-01-02"
"11422","2022","COM","2020","345","15","360","2023-01-02"
"11423","2022","COM","2020","156","4","160","2023-01-02"
"11424","2022","COM","2020","85","1","86","2023-01-02"
"11425","2022","COM","2020","1658","53","1711","2023-01-02"
"11426","2022","COM","2020","1196","24","1220","2023-01-02"
"11427","2022","COM","2020","299","8","307","2023-01-02"
"11428","2022","COM","2020","247","7","254","2023-01-02"
"11429","2022","COM","2020","4501","82","4583","2023-01-02"
"11430","2022","COM","2020","1380","41","1421","2023-01-02"
"11431","2022","COM","2020","251","7","258","2023-01-02"
"11432","2022","COM","2020","335","11","346","2023-01-02"
"11433","2022","COM","2020","955","17","972","2023-01-02"
"11434","2022","COM","2020","1260","27","1287","2023-01-02"
"11435","2022","COM","2020","157","6","163","2023-01-02"
"11436","2022","COM","2020","370","2","372","2023-01-02"
"11437","2022","COM","2020","899","26","925","2023-01-02"
"11438","2022","COM","2020","381","10","391","2023-01-02"
"11439","2022","COM","2020","408","8","416","2023-01-02"
"11440","2022","COM","2020","34","0","34","2023-01-02"
"11441","2022","COM","2020","2662","54","2716","2023-01-02"
"12001","2022","COM","2020","1086","26","1112","2023-01-02"
"12002","2022","COM","2020","887","29","916","2023-01-02"
"12003","2022","COM","2020","342","5","347","2023-01-02"
"12004","2022","COM","2020","441","19","460","2023-01-02"
"12006","2022","COM","2020","345","10","355","2023-01-02"
"12007","2022","COM","2020","177","8","185","2023-01-02"
"12008","2022","COM","2020","918","20","938","2023-01-02"
"12009","2022","COM","2020","36","1","37","2023-01-02"
"12010","2022","COM","2020","158","2","160","2023-01-02"
"12011","2022","COM","2020","764","27","791","2023-01-02"
"12012","2022","COM","2020","755","9","764","2023-01-02"
"12013","2022","COM","2020","3640","137","3777","2023-01-02"
"12015","2022","COM","2020","229","5","234","2023-01-02"
"12016","2022","COM","2020","817","21","838","2023-01-02"
"12017","2022","COM","2020","218","5","223","2023-01-02"
"12018","2022","COM","2020","180","7","187","2023-01-02"
"12019","2022","COM","2020","88","4","92","2023-01-02"
"12021","2022","COM","2020","1576","30","1606","2023-01-02"
"12022","2022","COM","2020","113","0","113","2023-01-02"
"12023","2022","COM","2020","104","1","105","2023-01-02"
"12024","2022","COM","2020","193","3","196","2023-01-02"
"12025","2022","COM","2020","970","12","982","2023-01-02"
"12026","2022","COM","2020","1060","21","1081","2023-01-02"
"12027","2022","COM","2020","209","7","216","2023-01-02"
"12028","2022","COM","2020","520","10","530","2023-01-02"
"12029","2022","COM","2020","200","5","205","2023-01-02"
"12030","2022","COM","2020","376","17","393","2023-01-02"
"12031","2022","COM","2020","346","15","361","2023-01-02"
"12032","2022","COM","2020","598","18","616","2023-01-02"
"12033","2022","COM","2020","2951","86","3037","2023-01-02"
"12034","2022","COM","2020","295","8","303","2023-01-02"
"12035","2022","COM","2020","173","7","180","2023-01-02"
"12036","2022","COM","2020","637","8","645","2023-01-02"
"12037","2022","COM","2020","609","15","624","2023-01-02"
"12038","2022","COM","2020","165","4","169","2023-01-02"
"12039","2022","COM","2020","261","4","265","2023-01-02"
"12041","2022","COM","2020","268","6","274","2023-01-02"
"12042","2022","COM","2020","201","7","208","2023-01-02"
"12043","2022","COM","2020","2184","77","2261","2023-01-02"
"12044","2022","COM","2020","1025","30","1055","2023-01-02"
"12045","2022","COM","2020","380","13","393","2023-01-02"
"12046","2022","COM","2020","574","10","584","2023-01-02"
"12047","2022","COM","2020","450","5","455","2023-01-02"
"12048","2022","COM","2020","341","8","349","2023-01-02"
"12049","2022","COM","2020","457","10","467","2023-01-02"
"12050","2022","COM","2020","447","12","459","2023-01-02"
"12051","2022","COM","2020","310","4","314","2023-01-02"
"12052","2022","COM","2020","4400","116","4516","2023-01-02"
"12053","2022","COM","2020","337","6","343","2023-01-02"
"12054","2022","COM","2020","347","8","355","2023-01-02"
"12055","2022","COM","2020","83","0","83","2023-01-02"
"12056","2022","COM","2020","3158","101","3259","2023-01-02"
"12057","2022","COM","2020","936","33","969","2023-01-02"
"12058","2022","COM","2020","105","5","110","2023-01-02"
"12059","2022","COM","2020","516","24","540","2023-01-02"
"12060","2022","COM","2020","113","4","117","2023-01-02"
"12061","2022","COM","2020","570","11","581","2023-01-02"
"12062","2022","COM","2020","348","2","350","2023-01-02"
"12063","2022","COM","2020","2188","31","2219","2023-01-02"
"12064","2022","COM","2020","274","6","280","2023-01-02"
"12065","2022","COM","2020","464","15","479","2023-01-02"
"12066","2022","COM","2020","1146","26","1172","2023-01-02"
"12067","2022","COM","2020","75","0","75","2023-01-02"
"12068","2022","COM","2020","872","27","899","2023-01-02"
"12069","2022","COM","2020","261","7","268","2023-01-02"
"12070","2022","COM","2020","518","26","544","2023-01-02"
"12071","2022","COM","2020","337","7","344","2023-01-02"
"12072","2022","COM","2020","228","7","235","2023-01-02"
"12073","2022","COM","2020","628","19","647","2023-01-02"
"12074","2022","COM","2020","292","14","306","2023-01-02"
"12075","2022","COM","2020","104","2","106","2023-01-02"
"12076","2022","COM","2020","1586","54","1640","2023-01-02"
"12077","2022","COM","2020","514","12","526","2023-01-02"
"12078","2022","COM","2020","180","4","184","2023-01-02"
"12079","2022","COM","2020","488","19","507","2023-01-02"
"12080","2022","COM","2020","363","9","372","2023-01-02"
"12082","2022","COM","2020","191","2","193","2023-01-02"
"12083","2022","COM","2020","1472","43","1515","2023-01-02"
"12084","2022","COM","2020","1558","55","1613","2023-01-02"
"12085","2022","COM","2020","315","0","315","2023-01-02"
"12086","2022","COM","2020","323","16","339","2023-01-02"
"12088","2022","COM","2020","223","4","227","2023-01-02"
"12089","2022","COM","2020","5196","212","5408","2023-01-02"
"12090","2022","COM","2020","3196","93","3289","2023-01-02"
"12091","2022","COM","2020","458","11","469","2023-01-02"
"12092","2022","COM","2020","523","10","533","2023-01-02"
"12093","2022","COM","2020","181","4","185","2023-01-02"
"12094","2022","COM","2020","981","18","999","2023-01-02"
"12095","2022","COM","2020","242","6","248","2023-01-02"
"12096","2022","COM","2020","4643","155","4798","2023-01-02"
"12097","2022","COM","2020","250","3","253","2023-01-02"
"12098","2022","COM","2020","476","16","492","2023-01-02"
"12099","2022","COM","2020","238","4","242","2023-01-02"
"12100","2022","COM","2020","2363","64","2427","2023-01-02"
"12101","2022","COM","2020","1081","32","1113","2023-01-02"
"12102","2022","COM","2020","2365","76","2441","2023-01-02"
"12103","2022","COM","2020","283","8","291","2023-01-02"
"12104","2022","COM","2020","487","10","497","2023-01-02"
"12105","2022","COM","2020","1108","30","1138","2023-01-02"
"12106","2022","COM","2020","549","11","560","2023-01-02"
"12107","2022","COM","2020","318","5","323","2023-01-02"
"12108","2022","COM","2020","374","6","380","2023-01-02"
"12109","2022","COM","2020","98","2","100","2023-01-02"
"12110","2022","COM","2020","340","12","352","2023-01-02"
"12111","2022","COM","2020","488","18","506","2023-01-02"
"12113","2022","COM","2020","517","11","528","2023-01-02"
"12115","2022","COM","2020","308","5","313","2023-01-02"
"12116","2022","COM","2020","261","6","267","2023-01-02"
"12118","2022","COM","2020","525","9","534","2023-01-02"
"12119","2022","COM","2020","1230","27","1257","2023-01-02"
"12120","2022","COM","2020","2153","103","2256","2023-01-02"
"12121","2022","COM","2020","726","16","742","2023-01-02"
"12122","2022","COM","2020","124","8","132","2023-01-02"
"12124","2022","COM","2020","315","9","324","2023-01-02"
"12125","2022","COM","2020","277","4","281","2023-01-02"
"12127","2022","COM","2020","638","20","658","2023-01-02"
"12128","2022","COM","2020","219","7","226","2023-01-02"
"12129","2022","COM","2020","448","13","461","2023-01-02"
"12130","2022","COM","2020","1123","30","1153","2023-01-02"
"12131","2022","COM","2020","1518","43","1561","2023-01-02"
"12133","2022","COM","2020","5962","164","6126","2023-01-02"
"12134","2022","COM","2020","351","7","358","2023-01-02"
"12135","2022","COM","2020","439","7","446","2023-01-02"
"12136","2022","COM","2020","936","18","954","2023-01-02"
"12137","2022","COM","2020","841","11","852","2023-01-02"
"12138","2022","COM","2020","1724","54","1778","2023-01-02"
"12139","2022","COM","2020","138","1","139","2023-01-02"
"12140","2022","COM","2020","975","24","999","2023-01-02"
"12141","2022","COM","2020","219","8","227","2023-01-02"
"12142","2022","COM","2020","629","16","645","2023-01-02"
"12143","2022","COM","2020","62","0","62","2023-01-02"
"12144","2022","COM","2020","122","2","124","2023-01-02"
"12145","2022","COM","2020","21482","696","22178","2023-01-02"
"12146","2022","COM","2020","2306","79","2385","2023-01-02"
"12147","2022","COM","2020","141","1","142","2023-01-02"
"12148","2022","COM","2020","1417","41","1458","2023-01-02"
"12149","2022","COM","2020","150","5","155","2023-01-02"
"12150","2022","COM","2020","481","88","569","2023-01-02"
"12151","2022","COM","2020","218","9","227","2023-01-02"
"12152","2022","COM","2020","128","2","130","2023-01-02"
"12153","2022","COM","2020","426","7","433","2023-01-02"
"12154","2022","COM","2020","633","10","643","2023-01-02"
"12155","2022","COM","2020","334","9","343","2023-01-02"
"12156","2022","COM","2020","528","10","538","2023-01-02"
"12157","2022","COM","2020","1717","50","1767","2023-01-02"
"12158","2022","COM","2020","326","8","334","2023-01-02"
"12159","2022","COM","2020","556","25","581","2023-01-02"
"12160","2022","COM","2020","320","5","325","2023-01-02"
"12161","2022","COM","2020","549","13","562","2023-01-02"
"12162","2022","COM","2020","1076","28","1104","2023-01-02"
"12163","2022","COM","2020","211","4","215","2023-01-02"
"12164","2022","COM","2020","696","14","710","2023-01-02"
"12165","2022","COM","2020","362","15","377","2023-01-02"
"12166","2022","COM","2020","113","1","114","2023-01-02"
"12167","2022","COM","2020","701","22","723","2023-01-02"
"12168","2022","COM","2020","992","18","1010","2023-01-02"
"12169","2022","COM","2020","2023","149","2172","2023-01-02"
"12170","2022","COM","2020","373","8","381","2023-01-02"
"12171","2022","COM","2020","588","17","605","2023-01-02"
"12172","2022","COM","2020","528","12","540","2023-01-02"
"12174","2022","COM","2020","3471","102","3573","2023-01-02"
"12175","2022","COM","2020","189","2","191","2023-01-02"
"12176","2022","COM","2020","11797","574","12371","2023-01-02"
"12177","2022","COM","2020","1028","15","1043","2023-01-02"
"12178","2022","COM","2020","371","10","381","2023-01-02"
"12179","2022","COM","2020","85","2","87","2023-01-02"
"12180","2022","COM","2020","73","2","75","2023-01-02"
"12181","2022","COM","2020","210","6","216","2023-01-02"
"12182","2022","COM","2020","284","5","289","2023-01-02"
"12183","2022","COM","2020","219","3","222","2023-01-02"
"12184","2022","COM","2020","120","6","126","2023-01-02"
"12185","2022","COM","2020","1632","72","1704","2023-01-02"
"12186","2022","COM","2020","212","2","214","2023-01-02"
"12187","2022","COM","2020","348","4","352","2023-01-02"
"12188","2022","COM","2020","319","10","329","2023-01-02"
"12189","2022","COM","2020","354","6","360","2023-01-02"
"12190","2022","COM","2020","288","11","299","2023-01-02"
"12191","2022","COM","2020","324","10","334","2023-01-02"
"12192","2022","COM","2020","186","4","190","2023-01-02"
"12193","2022","COM","2020","282","10","292","2023-01-02"
"12194","2022","COM","2020","852","21","873","2023-01-02"
"12195","2022","COM","2020","270","3","273","2023-01-02"
"12197","2022","COM","2020","1978","78","2056","2023-01-02"
"12198","2022","COM","2020","1940","75","2015","2023-01-02"
"12199","2022","COM","2020","2006","141","2147","2023-01-02"
"12200","2022","COM","2020","1029","27","1056","2023-01-02"
"12201","2022","COM","2020","1071","45","1116","2023-01-02"
"12202","2022","COM","2020","24397","1869","26266","2023-01-02"
"12203","2022","COM","2020","555","15","570","2023-01-02"
"12204","2022","COM","2020","177","4","181","2023-01-02"
"12205","2022","COM","2020","770","16","786","2023-01-02"
"12206","2022","COM","2020","631","18","649","2023-01-02"
"12207","2022","COM","2020","346","14","360","2023-01-02"
"12208","2022","COM","2020","8018","633","8651","2023-01-02"
"12209","2022","COM","2020","749","13","762","2023-01-02"
"12210","2022","COM","2020","455","5","460","2023-01-02"
"12211","2022","COM","2020","133","1","134","2023-01-02"
"12212","2022","COM","2020","87","7","94","2023-01-02"
"12213","2022","COM","2020","624","16","640","2023-01-02"
"12214","2022","COM","2020","518","13","531","2023-01-02"
"12215","2022","COM","2020","1171","47","1218","2023-01-02"
"12216","2022","COM","2020","1426","38","1464","2023-01-02"
"12217","2022","COM","2020","744","20","764","2023-01-02"
"12219","2022","COM","2020","377","8","385","2023-01-02"
"12220","2022","COM","2020","299","0","299","2023-01-02"
"12221","2022","COM","2020","354","6","360","2023-01-02"
"12222","2022","COM","2020","187","4","191","2023-01-02"
"12223","2022","COM","2020","1602","39","1641","2023-01-02"
"12224","2022","COM","2020","2217","39","2256","2023-01-02"
"12225","2022","COM","2020","1606","55","1661","2023-01-02"
"12226","2022","COM","2020","424","14","438","2023-01-02"
"12227","2022","COM","2020","178","5","183","2023-01-02"
"12228","2022","COM","2020","308","7","315","2023-01-02"
"12229","2022","COM","2020","244","11","255","2023-01-02"
"12230","2022","COM","2020","393","16","409","2023-01-02"
"12231","2022","COM","2020","717","7","724","2023-01-02"
"12232","2022","COM","2020","281","8","289","2023-01-02"
"12233","2022","COM","2020","294","3","297","2023-01-02"
"12234","2022","COM","2020","624","8","632","2023-01-02"
"12235","2022","COM","2020","204","8","212","2023-01-02"
"12236","2022","COM","2020","153","5","158","2023-01-02"
"12237","2022","COM","2020","648","82","730","2023-01-02"
"12238","2022","COM","2020","425","16","441","2023-01-02"
"12239","2022","COM","2020","324","13","337","2023-01-02"
"12240","2022","COM","2020","401","10","411","2023-01-02"
"12241","2022","COM","2020","1759","67","1826","2023-01-02"
"12242","2022","COM","2020","306","15","321","2023-01-02"
"12243","2022","COM","2020","957","13","970","2023-01-02"
"12244","2022","COM","2020","889","10","899","2023-01-02"
"12246","2022","COM","2020","530","15","545","2023-01-02"
"12247","2022","COM","2020","297","3","300","2023-01-02"
"12248","2022","COM","2020","607","103","710","2023-01-02"
"12249","2022","COM","2020","189","6","195","2023-01-02"
"12250","2022","COM","2020","210","6","216","2023-01-02"
"12251","2022","COM","2020","322","7","329","2023-01-02"
"12252","2022","COM","2020","439","12","451","2023-01-02"
"12253","2022","COM","2020","1005","30","1035","2023-01-02"
"12254","2022","COM","2020","2286","71","2357","2023-01-02"
"12255","2022","COM","2020","762","26","788","2023-01-02"
"12256","2022","COM","2020","367","10","377","2023-01-02"
"12257","2022","COM","2020","797","17","814","2023-01-02"
"12258","2022","COM","2020","989","15","1004","2023-01-02"
"12259","2022","COM","2020","643","18","661","2023-01-02"
"12260","2022","COM","2020","169","2","171","2023-01-02"
"12261","2022","COM","2020","124","4","128","2023-01-02"
"12262","2022","COM","2020","713","14","727","2023-01-02"
"12263","2022","COM","2020","752","25","777","2023-01-02"
"12264","2022","COM","2020","3330","90","3420","2023-01-02"
"12265","2022","COM","2020","529","15","544","2023-01-02"
"12266","2022","COM","2020","547","5","552","2023-01-02"
"12267","2022","COM","2020","626","12","638","2023-01-02"
"12268","2022","COM","2020","424","16","440","2023-01-02"
"12269","2022","COM","2020","126","3","129","2023-01-02"
"12270","2022","COM","2020","4079","119","4198","2023-01-02"
"12272","2022","COM","2020","519","13","532","2023-01-02"
"12273","2022","COM","2020","298","8","306","2023-01-02"
"12274","2022","COM","2020","114","2","116","2023-01-02"
"12275","2022","COM","2020","35","1","36","2023-01-02"
"12276","2022","COM","2020","359","12","371","2023-01-02"
"12277","2022","COM","2020","523","9","532","2023-01-02"
"12278","2022","COM","2020","185","2","187","2023-01-02"
"12280","2022","COM","2020","391","13","404","2023-01-02"
"12281","2022","COM","2020","745","23","768","2023-01-02"
"12282","2022","COM","2020","424","7","431","2023-01-02"
"12283","2022","COM","2020","476","15","491","2023-01-02"
"12284","2022","COM","2020","344","1","345","2023-01-02"
"12286","2022","COM","2020","1219","31","1250","2023-01-02"
"12287","2022","COM","2020","636","18","654","2023-01-02"
"12288","2022","COM","2020","1595","38","1633","2023-01-02"
"12289","2022","COM","2020","206","8","214","2023-01-02"
"12290","2022","COM","2020","490","10","500","2023-01-02"
"12291","2022","COM","2020","378","9","387","2023-01-02"
"12292","2022","COM","2020","416","14","430","2023-01-02"
"12293","2022","COM","2020","136","1","137","2023-01-02"
"12294","2022","COM","2020","649","18","667","2023-01-02"
"12295","2022","COM","2020","97","2","99","2023-01-02"
"12296","2022","COM","2020","528","13","541","2023-01-02"
"12297","2022","COM","2020","510","19","529","2023-01-02"
"12298","2022","COM","2020","417","8","425","2023-01-02"
"12299","2022","COM","2020","684","26","710","2023-01-02"
"12300","2022","COM","2020","11681","514","12195","2023-01-02"
"12301","2022","COM","2020","1976","46","2022","2023-01-02"
"12303","2022","COM","2020","251","5","256","2023-01-02"
"12305","2022","COM","2020","1227","21","1248","2023-01-02"
"12307","2022","COM","2020","293","15","308","2023-01-02"
"13001","2022","COM","2020","147122","3236","150358","2023-01-02"
"13002","2022","COM","2020","21546","223","21769","2023-01-02"
"13003","2022","COM","2020","2695","67","2762","2023-01-02"
"13004","2022","COM","2020","50968","723","51691","2023-01-02"
"13005","2022","COM","2020","47190","450","47640","2023-01-02"
"13006","2022","COM","2020","1545","30","1575","2023-01-02"
"13007","2022","COM","2020","12667","167","12834","2023-01-02"
"13008","2022","COM","2020","565","16","581","2023-01-02"
"13009","2022","COM","2020","845","34","879","2023-01-02"
"13010","2022","COM","2020","4228","139","4367","2023-01-02"
"13011","2022","COM","2020","315","4","319","2023-01-02"
"13012","2022","COM","2020","600","57","657","2023-01-02"
"13013","2022","COM","2020","1917","37","1954","2023-01-02"
"13014","2022","COM","2020","13834","69","13903","2023-01-02"
"13015","2022","COM","2020","14984","273","15257","2023-01-02"
"13016","2022","COM","2020","6316","82","6398","2023-01-02"
"13017","2022","COM","2020","1516","18","1534","2023-01-02"
"13018","2022","COM","2020","4471","59","4530","2023-01-02"
"13019","2022","COM","2020","10006","326","10332","2023-01-02"
"13020","2022","COM","2020","2179","44","2223","2023-01-02"
"13021","2022","COM","2020","5705","126","5831","2023-01-02"
"13022","2022","COM","2020","6782","107","6889","2023-01-02"
"13023","2022","COM","2020","4801","111","4912","2023-01-02"
"13024","2022","COM","2020","2655","36","2691","2023-01-02"
"13025","2022","COM","2020","2358","75","2433","2023-01-02"
"13026","2022","COM","2020","17809","74","17883","2023-01-02"
"13027","2022","COM","2020","16201","253","16454","2023-01-02"
"13028","2022","COM","2020","36441","371","36812","2023-01-02"
"13029","2022","COM","2020","1494","24","1518","2023-01-02"
"13030","2022","COM","2020","5380","54","5434","2023-01-02"
"13031","2022","COM","2020","3803","45","3848","2023-01-02"
"13032","2022","COM","2020","8076","146","8222","2023-01-02"
"13033","2022","COM","2020","5739","97","5836","2023-01-02"
"13034","2022","COM","2020","1730","30","1760","2023-01-02"
"13035","2022","COM","2020","6854","160","7014","2023-01-02"
"13036","2022","COM","2020","4421","129","4550","2023-01-02"
"13037","2022","COM","2020","8800","106","8906","2023-01-02"
"13038","2022","COM","2020","3531","68","3599","2023-01-02"
"13039","2022","COM","2020","15512","173","15685","2023-01-02"
"13040","2022","COM","2020","10164","187","10351","2023-01-02"
"13041","2022","COM","2020","21501","349","21850","2023-01-02"
"13042","2022","COM","2020","6698","129","6827","2023-01-02"
"13043","2022","COM","2020","9899","91","9990","2023-01-02"
"13044","2022","COM","2020","5201","85","5286","2023-01-02"
"13045","2022","COM","2020","4854","75","4929","2023-01-02"
"13046","2022","COM","2020","4281","80","4361","2023-01-02"
"13047","2022","COM","2020","44438","681","45119","2023-01-02"
"13048","2022","COM","2020","4436","101","4537","2023-01-02"
"13049","2022","COM","2020","2044","41","2085","2023-01-02"
"13050","2022","COM","2020","10018","255","10273","2023-01-02"
"13051","2022","COM","2020","9052","123","9175","2023-01-02"
"13052","2022","COM","2020","2705","33","2738","2023-01-02"
"13053","2022","COM","2020","6184","162","6346","2023-01-02"
"13054","2022","COM","2020","32515","220","32735","2023-01-02"
"13055","2022","COM","2020","870321","6281","876602","2023-01-02"
"13056","2022","COM","2020","48506","531","49037","2023-01-02"
"13057","2022","COM","2020","516","10","526","2023-01-02"
"13058","2022","COM","2020","2396","49","2445","2023-01-02"
"13059","2022","COM","2020","3843","63","3906","2023-01-02"
"13060","2022","COM","2020","5786","88","5874","2023-01-02"
"13061","2022","COM","2020","219","4","223","2023-01-02"
"13062","2022","COM","2020","4158","74","4232","2023-01-02"
"13063","2022","COM","2020","26433","374","26807","2023-01-02"
"13064","2022","COM","2020","2662","29","2691","2023-01-02"
"13065","2022","COM","2020","3400","47","3447","2023-01-02"
"13066","2022","COM","2020","5827","66","5893","2023-01-02"
"13067","2022","COM","2020","2752","34","2786","2023-01-02"
"13068","2022","COM","2020","2145","38","2183","2023-01-02"
"13069","2022","COM","2020","10561","266","10827","2023-01-02"
"13070","2022","COM","2020","6521","53","6574","2023-01-02"
"13071","2022","COM","2020","21897","277","22174","2023-01-02"
"13072","2022","COM","2020","3567","74","3641","2023-01-02"
"13073","2022","COM","2020","5604","77","5681","2023-01-02"
"13074","2022","COM","2020","5129","88","5217","2023-01-02"
"13075","2022","COM","2020","11522","90","11612","2023-01-02"
"13076","2022","COM","2020","3562","49","3611","2023-01-02"
"13077","2022","COM","2020","16290","132","16422","2023-01-02"
"13078","2022","COM","2020","8370","77","8447","2023-01-02"
"13079","2022","COM","2020","1785","119","1904","2023-01-02"
"13080","2022","COM","2020","5866","114","5980","2023-01-02"
"13081","2022","COM","2020","12136","103","12239","2023-01-02"
"13082","2022","COM","2020","4616","124","4740","2023-01-02"
"13083","2022","COM","2020","4036","58","4094","2023-01-02"
"13084","2022","COM","2020","5411","123","5534","2023-01-02"
"13085","2022","COM","2020","5937","67","6004","2023-01-02"
"13086","2022","COM","2020","8569","122","8691","2023-01-02"
"13087","2022","COM","2020","4977","140","5117","2023-01-02"
"13088","2022","COM","2020","5193","47","5240","2023-01-02"
"13089","2022","COM","2020","3396","55","3451","2023-01-02"
"13090","2022","COM","2020","125","4","129","2023-01-02"
"13091","2022","COM","2020","5648","113","5761","2023-01-02"
"13092","2022","COM","2020","8617","135","8752","2023-01-02"
"13093","2022","COM","2020","379","8","387","2023-01-02"
"13094","2022","COM","2020","2492","43","2535","2023-01-02"
"13095","2022","COM","2020","1229","68","1297","2023-01-02"
"13096","2022","COM","2020","2123","22","2145","2023-01-02"
"13097","2022","COM","2020","13364","297","13661","2023-01-02"
"13098","2022","COM","2020","5818","111","5929","2023-01-02"
"13099","2022","COM","2020","891","13","904","2023-01-02"
"13100","2022","COM","2020","9692","196","9888","2023-01-02"
"13101","2022","COM","2020","3481","59","3540","2023-01-02"
"13102","2022","COM","2020","6609","51","6660","2023-01-02"
"13103","2022","COM","2020","45009","586","45595","2023-01-02"
"13104","2022","COM","2020","7570","118","7688","2023-01-02"
"13105","2022","COM","2020","6878","88","6966","2023-01-02"
"13106","2022","COM","2020","11366","68","11434","2023-01-02"
"13107","2022","COM","2020","5917","125","6042","2023-01-02"
"13108","2022","COM","2020","15508","131","15639","2023-01-02"
"13109","2022","COM","2020","2355","60","2415","2023-01-02"
"13110","2022","COM","2020","10507","173","10680","2023-01-02"
"13111","2022","COM","2020","1024","21","1045","2023-01-02"
"13112","2022","COM","2020","8579","150","8729","2023-01-02"
"13113","2022","COM","2020","8432","165","8597","2023-01-02"
"13114","2022","COM","2020","5381","138","5519","2023-01-02"
"13115","2022","COM","2020","2062","43","2105","2023-01-02"
"13116","2022","COM","2020","805","15","820","2023-01-02"
"13117","2022","COM","2020","34418","396","34814","2023-01-02"
"13118","2022","COM","2020","3668","51","3719","2023-01-02"
"13119","2022","COM","2020","6623","83","6706","2023-01-02"
"13201","2022","ARM","2020","39265","182","39447","2023-01-02"
"13202","2022","ARM","2020","23898","69","23967","2023-01-02"
"13203","2022","ARM","2020","52277","159","52436","2023-01-02"
"13204","2022","ARM","2020","49636","325","49961","2023-01-02"
"13205","2022","ARM","2020","45098","276","45374","2023-01-02"
"13206","2022","ARM","2020","40734","386","41120","2023-01-02"
"13207","2022","ARM","2020","34596","303","34899","2023-01-02"
"13208","2022","ARM","2020","82155","1268","83423","2023-01-02"
"13209","2022","ARM","2020","76053","644","76697","2023-01-02"
"13210","2022","ARM","2020","59131","343","59474","2023-01-02"
"13211","2022","ARM","2020","57519","460","57979","2023-01-02"
"13212","2022","ARM","2020","61931","530","62461","2023-01-02"
"13213","2022","ARM","2020","91959","705","92664","2023-01-02"
"13214","2022","ARM","2020","60968","254","61222","2023-01-02"
"13215","2022","ARM","2020","79092","271","79363","2023-01-02"
"13216","2022","ARM","2020","16009","106","16115","2023-01-02"
"14001","2022","COM","2020","1194","43","1237","2023-01-02"
"14003","2022","COM","2020","310","7","317","2023-01-02"
"14005","2022","COM","2020","1700","39","1739","2023-01-02"
"14006","2022","COM","2020","1067","21","1088","2023-01-02"
"14007","2022","COM","2020","224","4","228","2023-01-02"
"14009","2022","COM","2020","1378","19","1397","2023-01-02"
"14011","2022","COM","2020","1899","22","1921","2023-01-02"
"14012","2022","COM","2020","195","1","196","2023-01-02"
"14014","2022","COM","2020","1256","20","1276","2023-01-02"
"14015","2022","COM","2020","742","22","764","2023-01-02"
"14016","2022","COM","2020","490","13","503","2023-01-02"
"14019","2022","COM","2020","216","3","219","2023-01-02"
"14020","2022","COM","2020","3798","31","3829","2023-01-02"
"14021","2022","COM","2020","465","11","476","2023-01-02"
"14022","2022","COM","2020","603","9","612","2023-01-02"
"14023","2022","COM","2020","69","1","70","2023-01-02"
"14024","2022","COM","2020","591","12","603","2023-01-02"
"14025","2022","COM","2020","315","3","318","2023-01-02"
"14026","2022","COM","2020","1125","20","1145","2023-01-02"
"14027","2022","COM","2020","4595","64","4659","2023-01-02"
"14030","2022","COM","2020","1666","48","1714","2023-01-02"
"14032","2022","COM","2020","275","11","286","2023-01-02"
"14033","2022","COM","2020","212","2","214","2023-01-02"
"14034","2022","COM","2020","572","2","574","2023-01-02"
"14035","2022","COM","2020","1346","75","1421","2023-01-02"
"14036","2022","COM","2020","171","1","172","2023-01-02"
"14037","2022","COM","2020","567","11","578","2023-01-02"
"14038","2022","COM","2020","792","11","803","2023-01-02"
"14039","2022","COM","2020","802","18","820","2023-01-02"
"14040","2022","COM","2020","210","3","213","2023-01-02"
"14041","2022","COM","2020","123","5","128","2023-01-02"
"14042","2022","COM","2020","1005","21","1026","2023-01-02"
"14043","2022","COM","2020","69","0","69","2023-01-02"
"14044","2022","COM","2020","1065","17","1082","2023-01-02"
"14045","2022","COM","2020","249","2","251","2023-01-02"
"14046","2022","COM","2020","1932","14","1946","2023-01-02"
"14047","2022","COM","2020","12640","326","12966","2023-01-02"
"14049","2022","COM","2020","141","6","147","2023-01-02"
"14050","2022","COM","2020","185","2","187","2023-01-02"
"14053","2022","COM","2020","167","3","170","2023-01-02"
"14054","2022","COM","2020","202","4","206","2023-01-02"
"14055","2022","COM","2020","409","8","417","2023-01-02"
"14057","2022","COM","2020","1470","9","1479","2023-01-02"
"14059","2022","COM","2020","420","32","452","2023-01-02"
"14060","2022","COM","2020","2039","26","2065","2023-01-02"
"14061","2022","COM","2020","8848","147","8995","2023-01-02"
"14062","2022","COM","2020","444","6","450","2023-01-02"
"14063","2022","COM","2020","213","5","218","2023-01-02"
"14064","2022","COM","2020","221","7","228","2023-01-02"
"14066","2022","COM","2020","2330","34","2364","2023-01-02"
"14068","2022","COM","2020","3646","87","3733","2023-01-02"
"14069","2022","COM","2020","1331","26","1357","2023-01-02"
"14070","2022","COM","2020","197","2","199","2023-01-02"
"14076","2022","COM","2020","5761","75","5836","2023-01-02"
"14077","2022","COM","2020","728","56","784","2023-01-02"
"14078","2022","COM","2020","364","4","368","2023-01-02"
"14079","2022","COM","2020","1552","35","1587","2023-01-02"
"14080","2022","COM","2020","125","4","129","2023-01-02"
"14082","2022","COM","2020","189","8","197","2023-01-02"
"14083","2022","COM","2020","666","15","681","2023-01-02"
"14084","2022","COM","2020","398","8","406","2023-01-02"
"14085","2022","COM","2020","814","19","833","2023-01-02"
"14086","2022","COM","2020","321","12","333","2023-01-02"
"14087","2022","COM","2020","122","1","123","2023-01-02"
"14088","2022","COM","2020","401","9","410","2023-01-02"
"14089","2022","COM","2020","390","9","399","2023-01-02"
"14090","2022","COM","2020","778","7","785","2023-01-02"
"14091","2022","COM","2020","100","0","100","2023-01-02"
"14092","2022","COM","2020","2304","26","2330","2023-01-02"
"14093","2022","COM","2020","198","5","203","2023-01-02"
"14096","2022","COM","2020","236","5","241","2023-01-02"
"14097","2022","COM","2020","303","3","306","2023-01-02"
"14098","2022","COM","2020","6150","62","6212","2023-01-02"
"14100","2022","COM","2020","1912","25","1937","2023-01-02"
"14101","2022","COM","2020","4069","71","4140","2023-01-02"
"14102","2022","COM","2020","994","22","1016","2023-01-02"
"14103","2022","COM","2020","415","7","422","2023-01-02"
"14104","2022","COM","2020","178","5","183","2023-01-02"
"14106","2022","COM","2020","659","6","665","2023-01-02"
"14107","2022","COM","2020","155","0","155","2023-01-02"
"14110","2022","COM","2020","126","1","127","2023-01-02"
"14111","2022","COM","2020","437","5","442","2023-01-02"
"14116","2022","COM","2020","113","5","118","2023-01-02"
"14117","2022","COM","2020","3511","30","3541","2023-01-02"
"14118","2022","COM","2020","107250","2151","109401","2023-01-02"
"14119","2022","COM","2020","2003","14","2017","2023-01-02"
"14120","2022","COM","2020","1400","21","1421","2023-01-02"
"14121","2022","COM","2020","256","1","257","2023-01-02"
"14122","2022","COM","2020","158","1","159","2023-01-02"
"14123","2022","COM","2020","2029","50","2079","2023-01-02"
"14124","2022","COM","2020","548","9","557","2023-01-02"
"14125","2022","COM","2020","1717","49","1766","2023-01-02"
"14126","2022","COM","2020","1322","36","1358","2023-01-02"
"14127","2022","COM","2020","555","5","560","2023-01-02"
"14130","2022","COM","2020","186","4","190","2023-01-02"
"14131","2022","COM","2020","226","4","230","2023-01-02"
"14132","2022","COM","2020","205","0","205","2023-01-02"
"14134","2022","COM","2020","190","4","194","2023-01-02"
"14135","2022","COM","2020","281","2","283","2023-01-02"
"14136","2022","COM","2020","96","0","96","2023-01-02"
"14137","2022","COM","2020","3137","28","3165","2023-01-02"
"14138","2022","COM","2020","295","5","300","2023-01-02"
"14140","2022","COM","2020","352","6","358","2023-01-02"
"14141","2022","COM","2020","160","2","162","2023-01-02"
"14143","2022","COM","2020","2394","26","2420","2023-01-02"
"14145","2022","COM","2020","550","4","554","2023-01-02"
"14146","2022","COM","2020","169","4","173","2023-01-02"
"14147","2022","COM","2020","139","1","140","2023-01-02"
"14149","2022","COM","2020","416","13","429","2023-01-02"
"14150","2022","COM","2020","1365","19","1384","2023-01-02"
"14159","2022","COM","2020","229","12","241","2023-01-02"
"14160","2022","COM","2020","187","6","193","2023-01-02"
"14161","2022","COM","2020","331","14","345","2023-01-02"
"14162","2022","COM","2020","1305","14","1319","2023-01-02"
"14163","2022","COM","2020","387","3","390","2023-01-02"
"14165","2022","COM","2020","184","1","185","2023-01-02"
"14166","2022","COM","2020","2546","42","2588","2023-01-02"
"14167","2022","COM","2020","7029","35","7064","2023-01-02"
"14168","2022","COM","2020","205","5","210","2023-01-02"
"14169","2022","COM","2020","157","0","157","2023-01-02"
"14171","2022","COM","2020","144","1","145","2023-01-02"
"14172","2022","COM","2020","445","8","453","2023-01-02"
"14173","2022","COM","2020","434","14","448","2023-01-02"
"14174","2022","COM","2020","6296","309","6605","2023-01-02"
"14175","2022","COM","2020","298","5","303","2023-01-02"
"14177","2022","COM","2020","844","16","860","2023-01-02"
"14179","2022","COM","2020","164","4","168","2023-01-02"
"14180","2022","COM","2020","155","3","158","2023-01-02"
"14181","2022","COM","2020","5093","43","5136","2023-01-02"
"14182","2022","COM","2020","397","5","402","2023-01-02"
"14183","2022","COM","2020","107","0","107","2023-01-02"
"14184","2022","COM","2020","230","6","236","2023-01-02"
"14190","2022","COM","2020","127","4","131","2023-01-02"
"14191","2022","COM","2020","4185","52","4237","2023-01-02"
"14193","2022","COM","2020","665","19","684","2023-01-02"
"14194","2022","COM","2020","642","20","662","2023-01-02"
"14195","2022","COM","2020","270","1","271","2023-01-02"
"14196","2022","COM","2020","212","8","220","2023-01-02"
"14197","2022","COM","2020","1099","27","1126","2023-01-02"
"14198","2022","COM","2020","252","9","261","2023-01-02"
"14200","2022","COM","2020","2260","62","2322","2023-01-02"
"14202","2022","COM","2020","267","5","272","2023-01-02"
"14203","2022","COM","2020","189","2","191","2023-01-02"
"14204","2022","COM","2020","172","2","174","2023-01-02"
"14205","2022","COM","2020","218","6","224","2023-01-02"
"14206","2022","COM","2020","291","0","291","2023-01-02"
"14207","2022","COM","2020","648","9","657","2023-01-02"
"14209","2022","COM","2020","505","10","515","2023-01-02"
"14211","2022","COM","2020","366","1","367","2023-01-02"
"14214","2022","COM","2020","183","1","184","2023-01-02"
"14215","2022","COM","2020","2284","32","2316","2023-01-02"
"14216","2022","COM","2020","239","3","242","2023-01-02"
"14218","2022","COM","2020","404","5","409","2023-01-02"
"14220","2022","COM","2020","3567","48","3615","2023-01-02"
"14221","2022","COM","2020","3063","41","3104","2023-01-02"
"14223","2022","COM","2020","88","2","90","2023-01-02"
"14224","2022","COM","2020","47","2","49","2023-01-02"
"14225","2022","COM","2020","5234","169","5403","2023-01-02"
"14226","2022","COM","2020","302","2","304","2023-01-02"
"14227","2022","COM","2020","214","1","215","2023-01-02"
"14228","2022","COM","2020","5076","202","5278","2023-01-02"
"14229","2022","COM","2020","2314","21","2335","2023-01-02"
"14230","2022","COM","2020","114","0","114","2023-01-02"
"14231","2022","COM","2020","439","12","451","2023-01-02"
"14232","2022","COM","2020","172","3","175","2023-01-02"
"14236","2022","COM","2020","608","7","615","2023-01-02"
"14237","2022","COM","2020","633","7","640","2023-01-02"
"14238","2022","COM","2020","112","2","114","2023-01-02"
"14239","2022","COM","2020","103","0","103","2023-01-02"
"14240","2022","COM","2020","508","12","520","2023-01-02"
"14241","2022","COM","2020","624","14","638","2023-01-02"
"14242","2022","COM","2020","1655","24","1679","2023-01-02"
"14243","2022","COM","2020","1580","25","1605","2023-01-02"
"14244","2022","COM","2020","294","10","304","2023-01-02"
"14245","2022","COM","2020","319","10","329","2023-01-02"
"14246","2022","COM","2020","809","6","815","2023-01-02"
"14248","2022","COM","2020","250","5","255","2023-01-02"
"14249","2022","COM","2020","1436","22","1458","2023-01-02"
"14250","2022","COM","2020","279","6","285","2023-01-02"
"14251","2022","COM","2020","550","6","556","2023-01-02"
"14252","2022","COM","2020","265","3","268","2023-01-02"
"14254","2022","COM","2020","1644","26","1670","2023-01-02"
"14256","2022","COM","2020","330","5","335","2023-01-02"
"14257","2022","COM","2020","2020","26","2046","2023-01-02"
"14258","2022","COM","2020","7849","234","8083","2023-01-02"
"14260","2022","COM","2020","241","7","248","2023-01-02"
"14261","2022","COM","2020","335","7","342","2023-01-02"
"14266","2022","COM","2020","1443","21","1464","2023-01-02"
"14269","2022","COM","2020","228","4","232","2023-01-02"
"14270","2022","COM","2020","387","9","396","2023-01-02"
"14271","2022","COM","2020","4981","70","5051","2023-01-02"
"14272","2022","COM","2020","99","2","101","2023-01-02"
"14273","2022","COM","2020","140","1","141","2023-01-02"
"14274","2022","COM","2020","2682","65","2747","2023-01-02"
"14275","2022","COM","2020","494","6","500","2023-01-02"
"14276","2022","COM","2020","355","3","358","2023-01-02"
"14277","2022","COM","2020","1946","14","1960","2023-01-02"
"14278","2022","COM","2020","1197","18","1215","2023-01-02"
"14280","2022","COM","2020","259","8","267","2023-01-02"
"14281","2022","COM","2020","744","10","754","2023-01-02"
"14282","2022","COM","2020","213","6","219","2023-01-02"
"14283","2022","COM","2020","220","7","227","2023-01-02"
"14284","2022","COM","2020","155","3","158","2023-01-02"
"14285","2022","COM","2020","76","2","78","2023-01-02"
"14286","2022","COM","2020","477","20","497","2023-01-02"
"14287","2022","COM","2020","1981","15","1996","2023-01-02"
"14288","2022","COM","2020","949","25","974","2023-01-02"
"14289","2022","COM","2020","580","13","593","2023-01-02"
"14290","2022","COM","2020","804","9","813","2023-01-02"
"14291","2022","COM","2020","297","4","301","2023-01-02"
"14293","2022","COM","2020","272","2","274","2023-01-02"
"14297","2022","COM","2020","597","7","604","2023-01-02"
"14298","2022","COM","2020","132","3","135","2023-01-02"
"14299","2022","COM","2020","844","17","861","2023-01-02"
"14300","2022","COM","2020","51","0","51","2023-01-02"
"14301","2022","COM","2020","4881","48","4929","2023-01-02"
"14302","2022","COM","2020","164","5","169","2023-01-02"
"14303","2022","COM","2020","926","21","947","2023-01-02"
"14304","2022","COM","2020","873","23","896","2023-01-02"
"14305","2022","COM","2020","670","6","676","2023-01-02"
"14306","2022","COM","2020","389","5","394","2023-01-02"
"14308","2022","COM","2020","301","0","301","2023-01-02"
"14309","2022","COM","2020","834","4","838","2023-01-02"
"14310","2022","COM","2020","733","8","741","2023-01-02"
"14311","2022","COM","2020","1049","9","1058","2023-01-02"
"14312","2022","COM","2020","1533","22","1555","2023-01-02"
"14316","2022","COM","2020","276","3","279","2023-01-02"
"14318","2022","COM","2020","731","7","738","2023-01-02"
"14319","2022","COM","2020","964","8","972","2023-01-02"
"14320","2022","COM","2020","282","7","289","2023-01-02"
"14322","2022","COM","2020","246","5","251","2023-01-02"
"14325","2022","COM","2020","3144","43","3187","2023-01-02"
"14326","2022","COM","2020","825","18","843","2023-01-02"
"14327","2022","COM","2020","22150","238","22388","2023-01-02"
"14328","2022","COM","2020","1349","7","1356","2023-01-02"
"14329","2022","COM","2020","115","4","119","2023-01-02"
"14332","2022","COM","2020","664","11","675","2023-01-02"
"14333","2022","COM","2020","6742","191","6933","2023-01-02"
"14334","2022","COM","2020","318","6","324","2023-01-02"
"14335","2022","COM","2020","298","3","301","2023-01-02"
"14336","2022","COM","2020","473","5","478","2023-01-02"
"14337","2022","COM","2020","329","10","339","2023-01-02"
"14338","2022","COM","2020","1689","39","1728","2023-01-02"
"14341","2022","COM","2020","11902","221","12123","2023-01-02"
"14342","2022","COM","2020","3590","40","3630","2023-01-02"
"14343","2022","COM","2020","67","0","67","2023-01-02"
"14344","2022","COM","2020","386","9","395","2023-01-02"
"14345","2022","COM","2020","301","2","303","2023-01-02"
"14346","2022","COM","2020","685","10","695","2023-01-02"
"14347","2022","COM","2020","1027","12","1039","2023-01-02"
"14348","2022","COM","2020","82","1","83","2023-01-02"
"14349","2022","COM","2020","2130","31","2161","2023-01-02"
"14352","2022","COM","2020","839","17","856","2023-01-02"
"14353","2022","COM","2020","451","5","456","2023-01-02"
"14354","2022","COM","2020","1948","47","1995","2023-01-02"
"14355","2022","COM","2020","1217","21","1238","2023-01-02"
"14357","2022","COM","2020","903","19","922","2023-01-02"
"14358","2022","COM","2020","88","1","89","2023-01-02"
"14360","2022","COM","2020","219","2","221","2023-01-02"
"14362","2022","COM","2020","159","0","159","2023-01-02"
"14364","2022","COM","2020","466","13","479","2023-01-02"
"14365","2022","COM","2020","2499","40","2539","2023-01-02"
"14366","2022","COM","2020","19755","611","20366","2023-01-02"
"14367","2022","COM","2020","434","5","439","2023-01-02"
"14368","2022","COM","2020","263","11","274","2023-01-02"
"14369","2022","COM","2020","286","3","289","2023-01-02"
"14370","2022","COM","2020","3030","39","3069","2023-01-02"
"14371","2022","COM","2020","6183","111","6294","2023-01-02"
"14374","2022","COM","2020","144","2","146","2023-01-02"
"14375","2022","COM","2020","170","3","173","2023-01-02"
"14377","2022","COM","2020","585","9","594","2023-01-02"
"14378","2022","COM","2020","270","8","278","2023-01-02"
"14379","2022","COM","2020","361","4","365","2023-01-02"
"14380","2022","COM","2020","186","5","191","2023-01-02"
"14381","2022","COM","2020","60","1","61","2023-01-02"
"14383","2022","COM","2020","2666","37","2703","2023-01-02"
"14384","2022","COM","2020","3241","60","3301","2023-01-02"
"14385","2022","COM","2020","160","8","168","2023-01-02"
"14389","2022","COM","2020","260","12","272","2023-01-02"
"14390","2022","COM","2020","188","4","192","2023-01-02"
"14391","2022","COM","2020","405","13","418","2023-01-02"
"14393","2022","COM","2020","368","7","375","2023-01-02"
"14394","2022","COM","2020","431","14","445","2023-01-02"
"14396","2022","COM","2020","1025","15","1040","2023-01-02"
"14397","2022","COM","2020","326","8","334","2023-01-02"
"14398","2022","COM","2020","547","16","563","2023-01-02"
"14399","2022","COM","2020","268","10","278","2023-01-02"
"14400","2022","COM","2020","211","6","217","2023-01-02"
"14401","2022","COM","2020","139","6","145","2023-01-02"
"14402","2022","COM","2020","104","1","105","2023-01-02"
"14403","2022","COM","2020","744","21","765","2023-01-02"
"14404","2022","COM","2020","121","1","122","2023-01-02"
"14405","2022","COM","2020","328","7","335","2023-01-02"
"14406","2022","COM","2020","1088","26","1114","2023-01-02"
"14407","2022","COM","2020","2318","58","2376","2023-01-02"
"14408","2022","COM","2020","2016","19","2035","2023-01-02"
"14409","2022","COM","2020","2195","33","2228","2023-01-02"
"14410","2022","COM","2020","1078","13","1091","2023-01-02"
"14411","2022","COM","2020","319","5","324","2023-01-02"
"14412","2022","COM","2020","80","0","80","2023-01-02"
"14419","2022","COM","2020","253","8","261","2023-01-02"
"14421","2022","COM","2020","591","8","599","2023-01-02"
"14424","2022","COM","2020","188","3","191","2023-01-02"
"14425","2022","COM","2020","161","6","167","2023-01-02"
"14426","2022","COM","2020","162","7","169","2023-01-02"
"14427","2022","COM","2020","291","3","294","2023-01-02"
"14430","2022","COM","2020","136","3","139","2023-01-02"
"14431","2022","COM","2020","9624","110","9734","2023-01-02"
"14435","2022","COM","2020","202","3","205","2023-01-02"
"14436","2022","COM","2020","556","5","561","2023-01-02"
"14437","2022","COM","2020","10054","231","10285","2023-01-02"
"14438","2022","COM","2020","558","7","565","2023-01-02"
"14439","2022","COM","2020","91","2","93","2023-01-02"
"14445","2022","COM","2020","90","2","92","2023-01-02"
"14446","2022","COM","2020","99","2","101","2023-01-02"
"14448","2022","COM","2020","66","0","66","2023-01-02"
"14449","2022","COM","2020","408","6","414","2023-01-02"
"14452","2022","COM","2020","616","10","626","2023-01-02"
"14453","2022","COM","2020","351","7","358","2023-01-02"
"14454","2022","COM","2020","1683","28","1711","2023-01-02"
"14455","2022","COM","2020","276","3","279","2023-01-02"
"14456","2022","COM","2020","3344","46","3390","2023-01-02"
"14457","2022","COM","2020","129","1","130","2023-01-02"
"14458","2022","COM","2020","515","79","594","2023-01-02"
"14460","2022","COM","2020","1342","29","1371","2023-01-02"
"14461","2022","COM","2020","506","5","511","2023-01-02"
"14465","2022","COM","2020","505","13","518","2023-01-02"
"14466","2022","COM","2020","342","9","351","2023-01-02"
"14467","2022","COM","2020","318","7","325","2023-01-02"
"14468","2022","COM","2020","346","6","352","2023-01-02"
"14469","2022","COM","2020","92","1","93","2023-01-02"
"14473","2022","COM","2020","111","3","114","2023-01-02"
"14474","2022","COM","2020","201","3","204","2023-01-02"
"14475","2022","COM","2020","2399","47","2446","2023-01-02"
"14476","2022","COM","2020","182","3","185","2023-01-02"
"14478","2022","COM","2020","1943","49","1992","2023-01-02"
"14480","2022","COM","2020","514","5","519","2023-01-02"
"14482","2022","COM","2020","241","2","243","2023-01-02"
"14483","2022","COM","2020","190","2","192","2023-01-02"
"14484","2022","COM","2020","247","5","252","2023-01-02"
"14486","2022","COM","2020","572","9","581","2023-01-02"
"14487","2022","COM","2020","756","21","777","2023-01-02"
"14488","2022","COM","2020","9438","120","9558","2023-01-02"
"14491","2022","COM","2020","195","11","206","2023-01-02"
"14492","2022","COM","2020","313","7","320","2023-01-02"
"14494","2022","COM","2020","124","7","131","2023-01-02"
"14495","2022","COM","2020","566","11","577","2023-01-02"
"14496","2022","COM","2020","57","4","61","2023-01-02"
"14497","2022","COM","2020","337","7","344","2023-01-02"
"14498","2022","COM","2020","238","4","242","2023-01-02"
"14499","2022","COM","2020","547","6","553","2023-01-02"
"14500","2022","COM","2020","157","6","163","2023-01-02"
"14501","2022","COM","2020","242","5","247","2023-01-02"
"14502","2022","COM","2020","87","1","88","2023-01-02"
"14504","2022","COM","2020","813","21","834","2023-01-02"
"14506","2022","COM","2020","249","3","252","2023-01-02"
"14509","2022","COM","2020","210","5","215","2023-01-02"
"14510","2022","COM","2020","59","3","62","2023-01-02"
"14511","2022","COM","2020","67","0","67","2023-01-02"
"14512","2022","COM","2020","70","0","70","2023-01-02"
"14514","2022","COM","2020","4790","72","4862","2023-01-02"
"14515","2022","COM","2020","1921","17","1938","2023-01-02"
"14516","2022","COM","2020","2072","20","2092","2023-01-02"
"14519","2022","COM","2020","126","0","126","2023-01-02"
"14520","2022","COM","2020","858","22","880","2023-01-02"
"14522","2022","COM","2020","388","7","395","2023-01-02"
"14524","2022","COM","2020","303","7","310","2023-01-02"
"14527","2022","COM","2020","543","8","551","2023-01-02"
"14528","2022","COM","2020","399","5","404","2023-01-02"
"14529","2022","COM","2020","269","3","272","2023-01-02"
"14530","2022","COM","2020","1962","28","1990","2023-01-02"
"14531","2022","COM","2020","49","0","49","2023-01-02"
"14533","2022","COM","2020","100","4","104","2023-01-02"
"14534","2022","COM","2020","396","3","399","2023-01-02"
"14535","2022","COM","2020","550","12","562","2023-01-02"
"14536","2022","COM","2020","2551","45","2596","2023-01-02"
"14538","2022","COM","2020","1699","33","1732","2023-01-02"
"14540","2022","COM","2020","287","13","300","2023-01-02"
"14541","2022","COM","2020","115","1","116","2023-01-02"
"14542","2022","COM","2020","536","11","547","2023-01-02"
"14543","2022","COM","2020","2474","50","2524","2023-01-02"
"14546","2022","COM","2020","223","2","225","2023-01-02"
"14547","2022","COM","2020","152","3","155","2023-01-02"
"14550","2022","COM","2020","90","1","91","2023-01-02"
"14552","2022","COM","2020","499","14","513","2023-01-02"
"14554","2022","COM","2020","1716","21","1737","2023-01-02"
"14555","2022","COM","2020","451","5","456","2023-01-02"
"14556","2022","COM","2020","1814","22","1836","2023-01-02"
"14557","2022","COM","2020","1118","15","1133","2023-01-02"
"14558","2022","COM","2020","1122","16","1138","2023-01-02"
"14559","2022","COM","2020","226","2","228","2023-01-02"
"14562","2022","COM","2020","2162","36","2198","2023-01-02"
"14563","2022","COM","2020","441","9","450","2023-01-02"
"14565","2022","COM","2020","259","3","262","2023-01-02"
"14566","2022","COM","2020","2515","49","2564","2023-01-02"
"14569","2022","COM","2020","239","6","245","2023-01-02"
"14570","2022","COM","2020","2517","42","2559","2023-01-02"
"14571","2022","COM","2020","306","6","312","2023-01-02"
"14572","2022","COM","2020","771","7","778","2023-01-02"
"14574","2022","COM","2020","1746","88","1834","2023-01-02"
"14575","2022","COM","2020","381","21","402","2023-01-02"
"14576","2022","COM","2020","518","13","531","2023-01-02"
"14578","2022","COM","2020","1345","31","1376","2023-01-02"
"14579","2022","COM","2020","1310","24","1334","2023-01-02"
"14582","2022","COM","2020","718","22","740","2023-01-02"
"14586","2022","COM","2020","157","6","163","2023-01-02"
"14587","2022","COM","2020","2405","45","2450","2023-01-02"
"14588","2022","COM","2020","343","2","345","2023-01-02"
"14589","2022","COM","2020","957","9","966","2023-01-02"
"14590","2022","COM","2020","136","1","137","2023-01-02"
"14591","2022","COM","2020","720","11","731","2023-01-02"
"14592","2022","COM","2020","1341","21","1362","2023-01-02"
"14593","2022","COM","2020","692","13","705","2023-01-02"
"14595","2022","COM","2020","242","5","247","2023-01-02"
"14598","2022","COM","2020","241","5","246","2023-01-02"
"14601","2022","COM","2020","167","4","171","2023-01-02"
"14602","2022","COM","2020","269","3","272","2023-01-02"
"14603","2022","COM","2020","507","8","515","2023-01-02"
"14605","2022","COM","2020","260","8","268","2023-01-02"
"14606","2022","COM","2020","224","2","226","2023-01-02"
"14607","2022","COM","2020","141","1","142","2023-01-02"
"14609","2022","COM","2020","555","9","564","2023-01-02"
"14610","2022","COM","2020","2016","100","2116","2023-01-02"
"14613","2022","COM","2020","90","1","91","2023-01-02"
"14614","2022","COM","2020","771","9","780","2023-01-02"
"14619","2022","COM","2020","125","2","127","2023-01-02"
"14620","2022","COM","2020","425","6","431","2023-01-02"
"14621","2022","COM","2020","467","11","478","2023-01-02"
"14622","2022","COM","2020","125","0","125","2023-01-02"
"14623","2022","COM","2020","2519","45","2564","2023-01-02"
"14625","2022","COM","2020","776","14","790","2023-01-02"
"14626","2022","COM","2020","947","22","969","2023-01-02"
"14627","2022","COM","2020","393","8","401","2023-01-02"
"14630","2022","COM","2020","714","20","734","2023-01-02"
"14635","2022","COM","2020","189","1","190","2023-01-02"
"14637","2022","COM","2020","209","3","212","2023-01-02"
"14639","2022","COM","2020","257","8","265","2023-01-02"
"14640","2022","COM","2020","244","1","245","2023-01-02"
"14643","2022","COM","2020","832","14","846","2023-01-02"
"14644","2022","COM","2020","655","14","669","2023-01-02"
"14645","2022","COM","2020","162","9","171","2023-01-02"
"14646","2022","COM","2020","459","9","468","2023-01-02"
"14648","2022","COM","2020","454","19","473","2023-01-02"
"14649","2022","COM","2020","464","6","470","2023-01-02"
"14650","2022","COM","2020","188","4","192","2023-01-02"
"14651","2022","COM","2020","273","2","275","2023-01-02"
"14652","2022","COM","2020","77","2","79","2023-01-02"
"14654","2022","COM","2020","7325","340","7665","2023-01-02"
"14656","2022","COM","2020","985","14","999","2023-01-02"
"14657","2022","COM","2020","315","4","319","2023-01-02"
"14658","2022","COM","2020","4326","87","4413","2023-01-02"
"14659","2022","COM","2020","1445","25","1470","2023-01-02"
"14660","2022","COM","2020","101","3","104","2023-01-02"
"14661","2022","COM","2020","157","0","157","2023-01-02"
"14663","2022","COM","2020","2529","53","2582","2023-01-02"
"14664","2022","COM","2020","316","4","320","2023-01-02"
"14665","2022","COM","2020","296","4","300","2023-01-02"
"14666","2022","COM","2020","1892","19","1911","2023-01-02"
"14667","2022","COM","2020","221","4","225","2023-01-02"
"14668","2022","COM","2020","323","2","325","2023-01-02"
"14669","2022","COM","2020","208","2","210","2023-01-02"
"14672","2022","COM","2020","881","14","895","2023-01-02"
"14674","2022","COM","2020","124","4","128","2023-01-02"
"14675","2022","COM","2020","2079","30","2109","2023-01-02"
"14676","2022","COM","2020","987","23","1010","2023-01-02"
"14677","2022","COM","2020","252","4","256","2023-01-02"
"14678","2022","COM","2020","588","10","598","2023-01-02"
"14679","2022","COM","2020","667","15","682","2023-01-02"
"14680","2022","COM","2020","160","6","166","2023-01-02"
"14681","2022","COM","2020","147","4","151","2023-01-02"
"14682","2022","COM","2020","463","12","475","2023-01-02"
"14684","2022","COM","2020","249","3","252","2023-01-02"
"14685","2022","COM","2020","1795","34","1829","2023-01-02"
"14687","2022","COM","2020","193","3","196","2023-01-02"
"14689","2022","COM","2020","3599","48","3647","2023-01-02"
"14692","2022","COM","2020","1766","23","1789","2023-01-02"
"14694","2022","COM","2020","541","20","561","2023-01-02"
"14698","2022","COM","2020","400","2","402","2023-01-02"
"14699","2022","COM","2020","3744","63","3807","2023-01-02"
"14700","2022","COM","2020","674","8","682","2023-01-02"
"14701","2022","COM","2020","803","15","818","2023-01-02"
"14705","2022","COM","2020","149","1","150","2023-01-02"
"14706","2022","COM","2020","246","6","252","2023-01-02"
"14707","2022","COM","2020","1115","13","1128","2023-01-02"
"14708","2022","COM","2020","298","7","305","2023-01-02"
"14709","2022","COM","2020","345","7","352","2023-01-02"
"14710","2022","COM","2020","103","0","103","2023-01-02"
"14711","2022","COM","2020","918","10","928","2023-01-02"
"14712","2022","COM","2020","3435","91","3526","2023-01-02"
"14713","2022","COM","2020","572","11","583","2023-01-02"
"14714","2022","COM","2020","783","11","794","2023-01-02"
"14715","2022","COM","2020","4603","86","4689","2023-01-02"
"14716","2022","COM","2020","211","3","214","2023-01-02"
"14719","2022","COM","2020","725","6","731","2023-01-02"
"14720","2022","COM","2020","852","28","880","2023-01-02"
"14721","2022","COM","2020","659","7","666","2023-01-02"
"14723","2022","COM","2020","267","4","271","2023-01-02"
"14724","2022","COM","2020","1019","12","1031","2023-01-02"
"14726","2022","COM","2020","5735","104","5839","2023-01-02"
"14728","2022","COM","2020","580","7","587","2023-01-02"
"14731","2022","COM","2020","193","12","205","2023-01-02"
"14732","2022","COM","2020","299","11","310","2023-01-02"
"14733","2022","COM","2020","317","9","326","2023-01-02"
"14734","2022","COM","2020","332","8","340","2023-01-02"
"14735","2022","COM","2020","807","11","818","2023-01-02"
"14737","2022","COM","2020","498","10","508","2023-01-02"
"14738","2022","COM","2020","3657","53","3710","2023-01-02"
"14739","2022","COM","2020","1648","36","1684","2023-01-02"
"14740","2022","COM","2020","1181","26","1207","2023-01-02"
"14741","2022","COM","2020","119","3","122","2023-01-02"
"14742","2022","COM","2020","73","0","73","2023-01-02"
"14743","2022","COM","2020","85","3","88","2023-01-02"
"14744","2022","COM","2020","288","4","292","2023-01-02"
"14745","2022","COM","2020","231","4","235","2023-01-02"
"14747","2022","COM","2020","675","8","683","2023-01-02"
"14748","2022","COM","2020","76","1","77","2023-01-02"
"14751","2022","COM","2020","292","8","300","2023-01-02"
"14752","2022","COM","2020","3147","40","3187","2023-01-02"
"14753","2022","COM","2020","740","22","762","2023-01-02"
"14754","2022","COM","2020","2507","52","2559","2023-01-02"
"14755","2022","COM","2020","591","12","603","2023-01-02"
"14756","2022","COM","2020","233","3","236","2023-01-02"
"14758","2022","COM","2020","796","18","814","2023-01-02"
"14759","2022","COM","2020","265","10","275","2023-01-02"
"14760","2022","COM","2020","733","6","739","2023-01-02"
"14761","2022","COM","2020","826","15","841","2023-01-02"
"14762","2022","COM","2020","16935","849","17784","2023-01-02"
"14764","2022","COM","2020","961","13","974","2023-01-02"
"15001","2022","COM","2020","796","10","806","2023-01-02"
"15002","2022","COM","2020","223","4","227","2023-01-02"
"15003","2022","COM","2020","599","11","610","2023-01-02"
"15004","2022","COM","2020","474","9","483","2023-01-02"
"15005","2022","COM","2020","369","12","381","2023-01-02"
"15006","2022","COM","2020","708","23","731","2023-01-02"
"15007","2022","COM","2020","122","5","127","2023-01-02"
"15008","2022","COM","2020","284","7","291","2023-01-02"
"15009","2022","COM","2020","186","4","190","2023-01-02"
"15010","2022","COM","2020","196","3","199","2023-01-02"
"15011","2022","COM","2020","182","3","185","2023-01-02"
"15012","2022","COM","2020","6313","196","6509","2023-01-02"
"15013","2022","COM","2020","145","1","146","2023-01-02"
"15014","2022","COM","2020","25703","1270","26973","2023-01-02"
"15015","2022","COM","2020","166","3","169","2023-01-02"
"15016","2022","COM","2020","625","14","639","2023-01-02"
"15017","2022","COM","2020","140","7","147","2023-01-02"
"15018","2022","COM","2020","136","1","137","2023-01-02"
"15019","2022","COM","2020","225","4","229","2023-01-02"
"15020","2022","COM","2020","93","0","93","2023-01-02"
"15021","2022","COM","2020","644","19","663","2023-01-02"
"15022","2022","COM","2020","162","5","167","2023-01-02"
"15024","2022","COM","2020","76","0","76","2023-01-02"
"15025","2022","COM","2020","237","8","245","2023-01-02"
"15026","2022","COM","2020","183","1","184","2023-01-02"
"15027","2022","COM","2020","739","14","753","2023-01-02"
"15028","2022","COM","2020","367","6","373","2023-01-02"
"15029","2022","COM","2020","505","16","521","2023-01-02"
"15030","2022","COM","2020","295","13","308","2023-01-02"
"15032","2022","COM","2020","58","3","61","2023-01-02"
"15033","2022","COM","2020","214","4","218","2023-01-02"
"15034","2022","COM","2020","143","6","149","2023-01-02"
"15036","2022","COM","2020","471","8","479","2023-01-02"
"15037","2022","COM","2020","1040","22","1062","2023-01-02"
"15038","2022","COM","2020","1015","15","1030","2023-01-02"
"15040","2022","COM","2020","99","6","105","2023-01-02"
"15041","2022","COM","2020","254","4","258","2023-01-02"
"15042","2022","COM","2020","249","4","253","2023-01-02"
"15043","2022","COM","2020","82","2","84","2023-01-02"
"15045","2022","COM","2020","818","11","829","2023-01-02"
"15046","2022","COM","2020","219","4","223","2023-01-02"
"15048","2022","COM","2020","30","1","31","2023-01-02"
"15049","2022","COM","2020","222","6","228","2023-01-02"
"15050","2022","COM","2020","166","3","169","2023-01-02"
"15051","2022","COM","2020","210","5","215","2023-01-02"
"15052","2022","COM","2020","157","10","167","2023-01-02"
"15053","2022","COM","2020","433","9","442","2023-01-02"
"15054","2022","COM","2020","985","29","1014","2023-01-02"
"15055","2022","COM","2020","444","14","458","2023-01-02"
"15056","2022","COM","2020","861","20","881","2023-01-02"
"15057","2022","COM","2020","187","4","191","2023-01-02"
"15058","2022","COM","2020","146","1","147","2023-01-02"
"15059","2022","COM","2020","122","7","129","2023-01-02"
"15060","2022","COM","2020","52","1","53","2023-01-02"
"15061","2022","COM","2020","261","5","266","2023-01-02"
"15063","2022","COM","2020","323","13","336","2023-01-02"
"15064","2022","COM","2020","84","1","85","2023-01-02"
"15065","2022","COM","2020","77","1","78","2023-01-02"
"15066","2022","COM","2020","118","2","120","2023-01-02"
"15067","2022","COM","2020","28","0","28","2023-01-02"
"15069","2022","COM","2020","244","6","250","2023-01-02"
"15070","2022","COM","2020","201","2","203","2023-01-02"
"15072","2022","COM","2020","220","9","229","2023-01-02"
"15073","2022","COM","2020","93","2","95","2023-01-02"
"15074","2022","COM","2020","752","21","773","2023-01-02"
"15075","2022","COM","2020","73","4","77","2023-01-02"
"15076","2022","COM","2020","170","4","174","2023-01-02"
"15077","2022","COM","2020","63","0","63","2023-01-02"
"15078","2022","COM","2020","158","2","160","2023-01-02"
"15079","2022","COM","2020","368","10","378","2023-01-02"
"15080","2022","COM","2020","146","5","151","2023-01-02"
"15081","2022","COM","2020","96","2","98","2023-01-02"
"15082","2022","COM","2020","293","11","304","2023-01-02"
"15083","2022","COM","2020","2027","65","2092","2023-01-02"
"15084","2022","COM","2020","291","9","300","2023-01-02"
"15085","2022","COM","2020","488","12","500","2023-01-02"
"15086","2022","COM","2020","58","1","59","2023-01-02"
"15087","2022","COM","2020","368","11","379","2023-01-02"
"15088","2022","COM","2020","508","14","522","2023-01-02"
"15089","2022","COM","2020","444","13","457","2023-01-02"
"15090","2022","COM","2020","592","15","607","2023-01-02"
"15091","2022","COM","2020","91","4","95","2023-01-02"
"15092","2022","COM","2020","1386","17","1403","2023-01-02"
"15093","2022","COM","2020","100","3","103","2023-01-02"
"15094","2022","COM","2020","804","16","820","2023-01-02"
"15095","2022","COM","2020","352","3","355","2023-01-02"
"15096","2022","COM","2020","279","7","286","2023-01-02"
"15097","2022","COM","2020","110","5","115","2023-01-02"
"15098","2022","COM","2020","90","0","90","2023-01-02"
"15100","2022","COM","2020","131","2","133","2023-01-02"
"15101","2022","COM","2020","517","10","527","2023-01-02"
"15102","2022","COM","2020","108","0","108","2023-01-02"
"15103","2022","COM","2020","239","6","245","2023-01-02"
"15104","2022","COM","2020","351","11","362","2023-01-02"
"15105","2022","COM","2020","34","3","37","2023-01-02"
"15106","2022","COM","2020","161","2","163","2023-01-02"
"15107","2022","COM","2020","170","4","174","2023-01-02"
"15108","2022","COM","2020","994","22","1016","2023-01-02"
"15110","2022","COM","2020","122","7","129","2023-01-02"
"15111","2022","COM","2020","209","7","216","2023-01-02"
"15112","2022","COM","2020","90","4","94","2023-01-02"
"15113","2022","COM","2020","180","4","184","2023-01-02"
"15114","2022","COM","2020","514","8","522","2023-01-02"
"15116","2022","COM","2020","147","4","151","2023-01-02"
"15117","2022","COM","2020","585","70","655","2023-01-02"
"15118","2022","COM","2020","722","31","753","2023-01-02"
"15119","2022","COM","2020","1801","68","1869","2023-01-02"
"15120","2022","COM","2020","3489","212","3701","2023-01-02"
"15121","2022","COM","2020","108","1","109","2023-01-02"
"15122","2022","COM","2020","2107","61","2168","2023-01-02"
"15123","2022","COM","2020","161","0","161","2023-01-02"
"15124","2022","COM","2020","531","24","555","2023-01-02"
"15125","2022","COM","2020","130","3","133","2023-01-02"
"15126","2022","COM","2020","80","3","83","2023-01-02"
"15127","2022","COM","2020","278","5","283","2023-01-02"
"15128","2022","COM","2020","122","1","123","2023-01-02"
"15129","2022","COM","2020","166","6","172","2023-01-02"
"15130","2022","COM","2020","143","4","147","2023-01-02"
"15131","2022","COM","2020","284","8","292","2023-01-02"
"15132","2022","COM","2020","41","1","42","2023-01-02"
"15133","2022","COM","2020","134","2","136","2023-01-02"
"15134","2022","COM","2020","812","11","823","2023-01-02"
"15135","2022","COM","2020","114","6","120","2023-01-02"
"15137","2022","COM","2020","262","3","265","2023-01-02"
"15138","2022","COM","2020","1815","98","1913","2023-01-02"
"15139","2022","COM","2020","68","0","68","2023-01-02"
"15140","2022","COM","2020","2116","62","2178","2023-01-02"
"15141","2022","COM","2020","1728","37","1765","2023-01-02"
"15142","2022","COM","2020","1720","44","1764","2023-01-02"
"15143","2022","COM","2020","101","1","102","2023-01-02"
"15144","2022","COM","2020","325","10","335","2023-01-02"
"15146","2022","COM","2020","124","5","129","2023-01-02"
"15147","2022","COM","2020","457","8","465","2023-01-02"
"15148","2022","COM","2020","430","12","442","2023-01-02"
"15149","2022","COM","2020","258","3","261","2023-01-02"
"15151","2022","COM","2020","148","0","148","2023-01-02"
"15152","2022","COM","2020","905","19","924","2023-01-02"
"15153","2022","COM","2020","1454","34","1488","2023-01-02"
"15154","2022","COM","2020","1195","24","1219","2023-01-02"
"15155","2022","COM","2020","85","1","86","2023-01-02"
"15156","2022","COM","2020","685","16","701","2023-01-02"
"15157","2022","COM","2020","355","42","397","2023-01-02"
"15158","2022","COM","2020","103","2","105","2023-01-02"
"15159","2022","COM","2020","269","9","278","2023-01-02"
"15160","2022","COM","2020","1089","22","1111","2023-01-02"
"15161","2022","COM","2020","108","3","111","2023-01-02"
"15162","2022","COM","2020","2454","40","2494","2023-01-02"
"15163","2022","COM","2020","1109","34","1143","2023-01-02"
"15164","2022","COM","2020","605","24","629","2023-01-02"
"15165","2022","COM","2020","203","4","207","2023-01-02"
"15166","2022","COM","2020","316","10","326","2023-01-02"
"15167","2022","COM","2020","115","8","123","2023-01-02"
"15168","2022","COM","2020","712","25","737","2023-01-02"
"15169","2022","COM","2020","821","14","835","2023-01-02"
"15170","2022","COM","2020","232","2","234","2023-01-02"
"15172","2022","COM","2020","91","0","91","2023-01-02"
"15173","2022","COM","2020","115","5","120","2023-01-02"
"15174","2022","COM","2020","270","3","273","2023-01-02"
"15175","2022","COM","2020","1062","23","1085","2023-01-02"
"15176","2022","COM","2020","239","8","247","2023-01-02"
"15178","2022","COM","2020","143","7","150","2023-01-02"
"15179","2022","COM","2020","249","3","252","2023-01-02"
"15180","2022","COM","2020","75","4","79","2023-01-02"
"15181","2022","COM","2020","574","11","585","2023-01-02"
"15182","2022","COM","2020","130","2","132","2023-01-02"
"15183","2022","COM","2020","135","0","135","2023-01-02"
"15184","2022","COM","2020","782","19","801","2023-01-02"
"15185","2022","COM","2020","246","7","253","2023-01-02"
"15186","2022","COM","2020","231","3","234","2023-01-02"
"15187","2022","COM","2020","6451","541","6992","2023-01-02"
"15188","2022","COM","2020","1190","27","1217","2023-01-02"
"15189","2022","COM","2020","224","6","230","2023-01-02"
"15190","2022","COM","2020","98","2","100","2023-01-02"
"15191","2022","COM","2020","635","11","646","2023-01-02"
"15192","2022","COM","2020","291","4","295","2023-01-02"
"15194","2022","COM","2020","103","7","110","2023-01-02"
"15196","2022","COM","2020","1546","55","1601","2023-01-02"
"15198","2022","COM","2020","109","2","111","2023-01-02"
"15199","2022","COM","2020","72","0","72","2023-01-02"
"15200","2022","COM","2020","147","3","150","2023-01-02"
"15201","2022","COM","2020","223","3","226","2023-01-02"
"15202","2022","COM","2020","708","15","723","2023-01-02"
"15203","2022","COM","2020","182","6","188","2023-01-02"
"15204","2022","COM","2020","1536","45","1581","2023-01-02"
"15205","2022","COM","2020","105","4","109","2023-01-02"
"15206","2022","COM","2020","143","1","144","2023-01-02"
"15207","2022","COM","2020","354","6","360","2023-01-02"
"15208","2022","COM","2020","133","4","137","2023-01-02"
"15209","2022","COM","2020","123","5","128","2023-01-02"
"15211","2022","COM","2020","294","5","299","2023-01-02"
"15212","2022","COM","2020","361","10","371","2023-01-02"
"15213","2022","COM","2020","202","6","208","2023-01-02"
"15214","2022","COM","2020","174","5","179","2023-01-02"
"15215","2022","COM","2020","1127","37","1164","2023-01-02"
"15216","2022","COM","2020","398","14","412","2023-01-02"
"15217","2022","COM","2020","106","3","109","2023-01-02"
"15218","2022","COM","2020","69","2","71","2023-01-02"
"15219","2022","COM","2020","321","6","327","2023-01-02"
"15220","2022","COM","2020","143","2","145","2023-01-02"
"15221","2022","COM","2020","1352","42","1394","2023-01-02"
"15222","2022","COM","2020","212","7","219","2023-01-02"
"15223","2022","COM","2020","214","6","220","2023-01-02"
"15224","2022","COM","2020","129","7","136","2023-01-02"
"15225","2022","COM","2020","217","4","221","2023-01-02"
"15226","2022","COM","2020","209","4","213","2023-01-02"
"15228","2022","COM","2020","460","11","471","2023-01-02"
"15229","2022","COM","2020","81","2","83","2023-01-02"
"15230","2022","COM","2020","197","9","206","2023-01-02"
"15231","2022","COM","2020","602","27","629","2023-01-02"
"15232","2022","COM","2020","225","9","234","2023-01-02"
"15233","2022","COM","2020","304","5","309","2023-01-02"
"15234","2022","COM","2020","330","6","336","2023-01-02"
"15235","2022","COM","2020","568","24","592","2023-01-02"
"15236","2022","COM","2020","602","15","617","2023-01-02"
"15237","2022","COM","2020","170","11","181","2023-01-02"
"15238","2022","COM","2020","127","3","130","2023-01-02"
"15240","2022","COM","2020","172","7","179","2023-01-02"
"15241","2022","COM","2020","48","3","51","2023-01-02"
"15242","2022","COM","2020","101","2","103","2023-01-02"
"15243","2022","COM","2020","482","14","496","2023-01-02"
"15244","2022","COM","2020","468","10","478","2023-01-02"
"15245","2022","COM","2020","250","4","254","2023-01-02"
"15246","2022","COM","2020","239","3","242","2023-01-02"
"15247","2022","COM","2020","23","0","23","2023-01-02"
"15248","2022","COM","2020","563","11","574","2023-01-02"
"15249","2022","COM","2020","60","2","62","2023-01-02"
"15250","2022","COM","2020","511","18","529","2023-01-02"
"15251","2022","COM","2020","134","6","140","2023-01-02"
"15252","2022","COM","2020","404","18","422","2023-01-02"
"15253","2022","COM","2020","65","2","67","2023-01-02"
"15254","2022","COM","2020","120","4","124","2023-01-02"
"15255","2022","COM","2020","1269","35","1304","2023-01-02"
"15256","2022","COM","2020","56","2","58","2023-01-02"
"15257","2022","COM","2020","127","5","132","2023-01-02"
"15258","2022","COM","2020","1862","37","1899","2023-01-02"
"15259","2022","COM","2020","241","3","244","2023-01-02"
"15260","2022","COM","2020","107","4","111","2023-01-02"
"15261","2022","COM","2020","827","19","846","2023-01-02"
"15262","2022","COM","2020","563","12","575","2023-01-02"
"15263","2022","COM","2020","119","3","122","2023-01-02"
"15264","2022","COM","2020","268","6","274","2023-01-02"
"15265","2022","COM","2020","1632","25","1657","2023-01-02"
"15266","2022","COM","2020","565","10","575","2023-01-02"
"15267","2022","COM","2020","4329","107","4436","2023-01-02"
"15268","2022","COM","2020","1268","25","1293","2023-01-02"
"15269","2022","COM","2020","129","3","132","2023-01-02"
"16001","2022","COM","2020","507","1","508","2023-01-02"
"16002","2022","COM","2020","526","16","542","2023-01-02"
"16003","2022","COM","2020","859","10","869","2023-01-02"
"16005","2022","COM","2020","1595","20","1615","2023-01-02"
"16007","2022","COM","2020","469","11","480","2023-01-02"
"16008","2022","COM","2020","306","2","308","2023-01-02"
"16009","2022","COM","2020","379","6","385","2023-01-02"
"16011","2022","COM","2020","563","21","584","2023-01-02"
"16012","2022","COM","2020","498","9","507","2023-01-02"
"16013","2022","COM","2020","313","8","321","2023-01-02"
"16014","2022","COM","2020","133","1","134","2023-01-02"
"16015","2022","COM","2020","41407","1672","43079","2023-01-02"
"16016","2022","COM","2020","825","17","842","2023-01-02"
"16018","2022","COM","2020","704","18","722","2023-01-02"
"16019","2022","COM","2020","1265","22","1287","2023-01-02"
"16020","2022","COM","2020","329","4","333","2023-01-02"
"16023","2022","COM","2020","574","11","585","2023-01-02"
"16024","2022","COM","2020","518","9","527","2023-01-02"
"16025","2022","COM","2020","1235","31","1266","2023-01-02"
"16026","2022","COM","2020","1371","26","1397","2023-01-02"
"16027","2022","COM","2020","130","2","132","2023-01-02"
"16028","2022","COM","2020","4751","173","4924","2023-01-02"
"16029","2022","COM","2020","225","5","230","2023-01-02"
"16030","2022","COM","2020","1063","22","1085","2023-01-02"
"16031","2022","COM","2020","409","11","420","2023-01-02"
"16032","2022","COM","2020","517","7","524","2023-01-02"
"16034","2022","COM","2020","145","2","147","2023-01-02"
"16035","2022","COM","2020","197","5","202","2023-01-02"
"16036","2022","COM","2020","291","9","300","2023-01-02"
"16037","2022","COM","2020","140","5","145","2023-01-02"
"16038","2022","COM","2020","307","8","315","2023-01-02"
"16039","2022","COM","2020","472","12","484","2023-01-02"
"16040","2022","COM","2020","310","6","316","2023-01-02"
"16041","2022","COM","2020","113","1","114","2023-01-02"
"16042","2022","COM","2020","108","5","113","2023-01-02"
"16044","2022","COM","2020","209","7","216","2023-01-02"
"16045","2022","COM","2020","369","5","374","2023-01-02"
"16046","2022","COM","2020","997","16","1013","2023-01-02"
"16047","2022","COM","2020","287","7","294","2023-01-02"
"16048","2022","COM","2020","127","0","127","2023-01-02"
"16049","2022","COM","2020","368","8","376","2023-01-02"
"16050","2022","COM","2020","247","8","255","2023-01-02"
"16052","2022","COM","2020","235","3","238","2023-01-02"
"16053","2022","COM","2020","120","1","121","2023-01-02"
"16054","2022","COM","2020","175","1","176","2023-01-02"
"16055","2022","COM","2020","884","13","897","2023-01-02"
"16056","2022","COM","2020","884","16","900","2023-01-02"
"16057","2022","COM","2020","322","6","328","2023-01-02"
"16058","2022","COM","2020","1405","50","1455","2023-01-02"
"16059","2022","COM","2020","166","6","172","2023-01-02"
"16060","2022","COM","2020","449","12","461","2023-01-02"
"16061","2022","COM","2020","4222","80","4302","2023-01-02"
"16062","2022","COM","2020","128","2","130","2023-01-02"
"16063","2022","COM","2020","161","0","161","2023-01-02"
"16064","2022","COM","2020","1110","12","1122","2023-01-02"
"16065","2022","COM","2020","626","6","632","2023-01-02"
"16066","2022","COM","2020","462","9","471","2023-01-02"
"16067","2022","COM","2020","464","9","473","2023-01-02"
"16068","2022","COM","2020","571","6","577","2023-01-02"
"16069","2022","COM","2020","385","3","388","2023-01-02"
"16070","2022","COM","2020","1561","30","1591","2023-01-02"
"16071","2022","COM","2020","598","15","613","2023-01-02"
"16072","2022","COM","2020","513","10","523","2023-01-02"
"16073","2022","COM","2020","1786","30","1816","2023-01-02"
"16074","2022","COM","2020","336","8","344","2023-01-02"
"16075","2022","COM","2020","241","4","245","2023-01-02"
"16076","2022","COM","2020","879","9","888","2023-01-02"
"16077","2022","COM","2020","482","9","491","2023-01-02"
"16078","2022","COM","2020","5155","116","5271","2023-01-02"
"16079","2022","COM","2020","356","2","358","2023-01-02"
"16081","2022","COM","2020","215","5","220","2023-01-02"
"16082","2022","COM","2020","667","13","680","2023-01-02"
"16083","2022","COM","2020","338","6","344","2023-01-02"
"16084","2022","COM","2020","338","4","342","2023-01-02"
"16085","2022","COM","2020","3100","281","3381","2023-01-02"
"16086","2022","COM","2020","857","17","874","2023-01-02"
"16087","2022","COM","2020","144","4","148","2023-01-02"
"16088","2022","COM","2020","1097","38","1135","2023-01-02"
"16089","2022","COM","2020","3766","65","3831","2023-01-02"
"16090","2022","COM","2020","3546","57","3603","2023-01-02"
"16091","2022","COM","2020","172","2","174","2023-01-02"
"16093","2022","COM","2020","1575","25","1600","2023-01-02"
"16095","2022","COM","2020","128","4","132","2023-01-02"
"16096","2022","COM","2020","420","3","423","2023-01-02"
"16097","2022","COM","2020","2293","101","2394","2023-01-02"
"16098","2022","COM","2020","139","1","140","2023-01-02"
"16099","2022","COM","2020","223","1","224","2023-01-02"
"16100","2022","COM","2020","775","14","789","2023-01-02"
"16101","2022","COM","2020","1064","18","1082","2023-01-02"
"16102","2022","COM","2020","18606","424","19030","2023-01-02"
"16103","2022","COM","2020","122","4","126","2023-01-02"
"16104","2022","COM","2020","468","9","477","2023-01-02"
"16105","2022","COM","2020","616","16","632","2023-01-02"
"16106","2022","COM","2020","2720","153","2873","2023-01-02"
"16107","2022","COM","2020","541","6","547","2023-01-02"
"16108","2022","COM","2020","130","1","131","2023-01-02"
"16109","2022","COM","2020","751","11","762","2023-01-02"
"16110","2022","COM","2020","776","21","797","2023-01-02"
"16111","2022","COM","2020","174","2","176","2023-01-02"
"16112","2022","COM","2020","57","2","59","2023-01-02"
"16113","2022","COM","2020","7742","258","8000","2023-01-02"
"16114","2022","COM","2020","167","3","170","2023-01-02"
"16116","2022","COM","2020","381","10","391","2023-01-02"
"16117","2022","COM","2020","120","3","123","2023-01-02"
"16118","2022","COM","2020","135","0","135","2023-01-02"
"16119","2022","COM","2020","1356","15","1371","2023-01-02"
"16120","2022","COM","2020","1521","22","1543","2023-01-02"
"16121","2022","COM","2020","434","13","447","2023-01-02"
"16122","2022","COM","2020","138","4","142","2023-01-02"
"16123","2022","COM","2020","483","10","493","2023-01-02"
"16124","2022","COM","2020","558","10","568","2023-01-02"
"16125","2022","COM","2020","268","3","271","2023-01-02"
"16127","2022","COM","2020","94","3","97","2023-01-02"
"16128","2022","COM","2020","169","6","175","2023-01-02"
"16130","2022","COM","2020","183","7","190","2023-01-02"
"16131","2022","COM","2020","501","7","508","2023-01-02"
"16132","2022","COM","2020","996","8","1004","2023-01-02"
"16133","2022","COM","2020","199","3","202","2023-01-02"
"16134","2022","COM","2020","1013","26","1039","2023-01-02"
"16135","2022","COM","2020","312","1","313","2023-01-02"
"16136","2022","COM","2020","572","12","584","2023-01-02"
"16137","2022","COM","2020","303","2","305","2023-01-02"
"16138","2022","COM","2020","3865","105","3970","2023-01-02"
"16139","2022","COM","2020","239","2","241","2023-01-02"
"16140","2022","COM","2020","436","5","441","2023-01-02"
"16141","2022","COM","2020","322","11","333","2023-01-02"
"16142","2022","COM","2020","205","4","209","2023-01-02"
"16143","2022","COM","2020","704","13","717","2023-01-02"
"16144","2022","COM","2020","428","5","433","2023-01-02"
"16145","2022","COM","2020","641","20","661","2023-01-02"
"16146","2022","COM","2020","2124","34","2158","2023-01-02"
"16147","2022","COM","2020","259","6","265","2023-01-02"
"16148","2022","COM","2020","999","20","1019","2023-01-02"
"16150","2022","COM","2020","1589","42","1631","2023-01-02"
"16151","2022","COM","2020","886","20","906","2023-01-02"
"16152","2022","COM","2020","719","20","739","2023-01-02"
"16153","2022","COM","2020","1171","22","1193","2023-01-02"
"16154","2022","COM","2020","6017","99","6116","2023-01-02"
"16155","2022","COM","2020","105","3","108","2023-01-02"
"16157","2022","COM","2020","156","3","159","2023-01-02"
"16158","2022","COM","2020","305","5","310","2023-01-02"
"16160","2022","COM","2020","485","6","491","2023-01-02"
"16161","2022","COM","2020","163","4","167","2023-01-02"
"16162","2022","COM","2020","183","0","183","2023-01-02"
"16163","2022","COM","2020","1152","22","1174","2023-01-02"
"16164","2022","COM","2020","241","2","243","2023-01-02"
"16165","2022","COM","2020","376","6","382","2023-01-02"
"16166","2022","COM","2020","5633","118","5751","2023-01-02"
"16167","2022","COM","2020","4447","133","4580","2023-01-02"
"16168","2022","COM","2020","816","7","823","2023-01-02"
"16169","2022","COM","2020","569","11","580","2023-01-02"
"16170","2022","COM","2020","395","2","397","2023-01-02"
"16171","2022","COM","2020","652","14","666","2023-01-02"
"16173","2022","COM","2020","181","4","185","2023-01-02"
"16174","2022","COM","2020","516","11","527","2023-01-02"
"16175","2022","COM","2020","1371","31","1402","2023-01-02"
"16176","2022","COM","2020","299","7","306","2023-01-02"
"16177","2022","COM","2020","118","2","120","2023-01-02"
"16178","2022","COM","2020","187","5","192","2023-01-02"
"16180","2022","COM","2020","247","6","253","2023-01-02"
"16181","2022","COM","2020","521","11","532","2023-01-02"
"16182","2022","COM","2020","444","13","457","2023-01-02"
"16183","2022","COM","2020","173","4","177","2023-01-02"
"16184","2022","COM","2020","86","1","87","2023-01-02"
"16185","2022","COM","2020","154","2","156","2023-01-02"
"16186","2022","COM","2020","712","21","733","2023-01-02"
"16187","2022","COM","2020","2096","48","2144","2023-01-02"
"16188","2022","COM","2020","339","4","343","2023-01-02"
"16189","2022","COM","2020","254","6","260","2023-01-02"
"16190","2022","COM","2020","186","6","192","2023-01-02"
"16191","2022","COM","2020","181","1","182","2023-01-02"
"16192","2022","COM","2020","3867","104","3971","2023-01-02"
"16193","2022","COM","2020","991","16","1007","2023-01-02"
"16194","2022","COM","2020","110","1","111","2023-01-02"
"16195","2022","COM","2020","294","8","302","2023-01-02"
"16196","2022","COM","2020","720","8","728","2023-01-02"
"16197","2022","COM","2020","114","7","121","2023-01-02"
"16198","2022","COM","2020","459","4","463","2023-01-02"
"16199","2022","COM","2020","3223","63","3286","2023-01-02"
"16200","2022","COM","2020","481","4","485","2023-01-02"
"16203","2022","COM","2020","119","0","119","2023-01-02"
"16204","2022","COM","2020","1282","33","1315","2023-01-02"
"16205","2022","COM","2020","535","5","540","2023-01-02"
"16206","2022","COM","2020","1681","20","1701","2023-01-02"
"16207","2022","COM","2020","486","9","495","2023-01-02"
"16208","2022","COM","2020","393","4","397","2023-01-02"
"16209","2022","COM","2020","824","19","843","2023-01-02"
"16210","2022","COM","2020","815","8","823","2023-01-02"
"16211","2022","COM","2020","560","6","566","2023-01-02"
"16212","2022","COM","2020","389","6","395","2023-01-02"
"16213","2022","COM","2020","297","5","302","2023-01-02"
"16215","2022","COM","2020","154","5","159","2023-01-02"
"16216","2022","COM","2020","833","14","847","2023-01-02"
"16217","2022","COM","2020","1100","24","1124","2023-01-02"
"16218","2022","COM","2020","411","13","424","2023-01-02"
"16220","2022","COM","2020","720","15","735","2023-01-02"
"16221","2022","COM","2020","234","3","237","2023-01-02"
"16222","2022","COM","2020","323","5","328","2023-01-02"
"16223","2022","COM","2020","2001","30","2031","2023-01-02"
"16224","2022","COM","2020","717","18","735","2023-01-02"
"16225","2022","COM","2020","653","30","683","2023-01-02"
"16226","2022","COM","2020","712","9","721","2023-01-02"
"16227","2022","COM","2020","140","0","140","2023-01-02"
"16229","2022","COM","2020","244","4","248","2023-01-02"
"16230","2022","COM","2020","2517","87","2604","2023-01-02"
"16231","2022","COM","2020","324","2","326","2023-01-02"
"16232","2022","COM","2020","2137","48","2185","2023-01-02"
"16233","2022","COM","2020","1002","17","1019","2023-01-02"
"16234","2022","COM","2020","708","12","720","2023-01-02"
"16236","2022","COM","2020","2377","73","2450","2023-01-02"
"16237","2022","COM","2020","222","2","224","2023-01-02"
"16238","2022","COM","2020","118","0","118","2023-01-02"
"16239","2022","COM","2020","136","2","138","2023-01-02"
"16240","2022","COM","2020","100","0","100","2023-01-02"
"16241","2022","COM","2020","207","4","211","2023-01-02"
"16242","2022","COM","2020","1381","17","1398","2023-01-02"
"16243","2022","COM","2020","1047","21","1068","2023-01-02"
"16244","2022","COM","2020","2314","53","2367","2023-01-02"
"16245","2022","COM","2020","918","14","932","2023-01-02"
"16246","2022","COM","2020","256","8","264","2023-01-02"
"16248","2022","COM","2020","150","2","152","2023-01-02"
"16249","2022","COM","2020","385","3","388","2023-01-02"
"16250","2022","COM","2020","216","2","218","2023-01-02"
"16251","2022","COM","2020","250","7","257","2023-01-02"
"16252","2022","COM","2020","151","1","152","2023-01-02"
"16253","2022","COM","2020","362","3","365","2023-01-02"
"16254","2022","COM","2020","217","8","225","2023-01-02"
"16255","2022","COM","2020","139","5","144","2023-01-02"
"16256","2022","COM","2020","244","4","248","2023-01-02"
"16258","2022","COM","2020","494","9","503","2023-01-02"
"16260","2022","COM","2020","273","7","280","2023-01-02"
"16261","2022","COM","2020","479","14","493","2023-01-02"
"16263","2022","COM","2020","396","5","401","2023-01-02"
"16264","2022","COM","2020","320","6","326","2023-01-02"
"16267","2022","COM","2020","94","1","95","2023-01-02"
"16268","2022","COM","2020","214","2","216","2023-01-02"
"16269","2022","COM","2020","902","11","913","2023-01-02"
"16270","2022","COM","2020","340","5","345","2023-01-02"
"16271","2022","COM","2020","2382","133","2515","2023-01-02"
"16272","2022","COM","2020","555","9","564","2023-01-02"
"16273","2022","COM","2020","121","6","127","2023-01-02"
"16275","2022","COM","2020","177","2","179","2023-01-02"
"16276","2022","COM","2020","741","11","752","2023-01-02"
"16277","2022","COM","2020","589","11","600","2023-01-02"
"16279","2022","COM","2020","225","3","228","2023-01-02"
"16280","2022","COM","2020","2007","29","2036","2023-01-02"
"16281","2022","COM","2020","3984","129","4113","2023-01-02"
"16282","2022","COM","2020","533","11","544","2023-01-02"
"16283","2022","COM","2020","570","8","578","2023-01-02"
"16284","2022","COM","2020","120","1","121","2023-01-02"
"16285","2022","COM","2020","406","5","411","2023-01-02"
"16286","2022","COM","2020","2940","43","2983","2023-01-02"
"16287","2022","COM","2020","4295","68","4363","2023-01-02"
"16289","2022","COM","2020","299","3","302","2023-01-02"
"16290","2022","COM","2020","239","2","241","2023-01-02"
"16291","2022","COM","2020","7364","195","7559","2023-01-02"
"16292","2022","COM","2020","3370","150","3520","2023-01-02"
"16293","2022","COM","2020","491","6","497","2023-01-02"
"16295","2022","COM","2020","1322","24","1346","2023-01-02"
"16297","2022","COM","2020","327","9","336","2023-01-02"
"16298","2022","COM","2020","357","5","362","2023-01-02"
"16300","2022","COM","2020","1318","12","1330","2023-01-02"
"16301","2022","COM","2020","226","4","230","2023-01-02"
"16302","2022","COM","2020","217","2","219","2023-01-02"
"16303","2022","COM","2020","406","12","418","2023-01-02"
"16304","2022","COM","2020","965","19","984","2023-01-02"
"16306","2022","COM","2020","314","8","322","2023-01-02"
"16307","2022","COM","2020","327","12","339","2023-01-02"
"16308","2022","COM","2020","1047","19","1066","2023-01-02"
"16310","2022","COM","2020","215","2","217","2023-01-02"
"16312","2022","COM","2020","821","12","833","2023-01-02"
"16315","2022","COM","2020","105","0","105","2023-01-02"
"16316","2022","COM","2020","386","6","392","2023-01-02"
"16317","2022","COM","2020","436","2","438","2023-01-02"
"16318","2022","COM","2020","364","2","366","2023-01-02"
"16320","2022","COM","2020","895","14","909","2023-01-02"
"16321","2022","COM","2020","45","0","45","2023-01-02"
"16323","2022","COM","2020","468","10","478","2023-01-02"
"16325","2022","COM","2020","128","3","131","2023-01-02"
"16326","2022","COM","2020","134","0","134","2023-01-02"
"16329","2022","COM","2020","763","11","774","2023-01-02"
"16330","2022","COM","2020","824","28","852","2023-01-02"
"16331","2022","COM","2020","90","2","92","2023-01-02"
"16334","2022","COM","2020","123","3","126","2023-01-02"
"16335","2022","COM","2020","124","3","127","2023-01-02"
"16336","2022","COM","2020","343","2","345","2023-01-02"
"16337","2022","COM","2020","899","30","929","2023-01-02"
"16338","2022","COM","2020","315","5","320","2023-01-02"
"16339","2022","COM","2020","802","16","818","2023-01-02"
"16340","2022","COM","2020","1028","27","1055","2023-01-02"
"16341","2022","COM","2020","3225","38","3263","2023-01-02"
"16342","2022","COM","2020","304","7","311","2023-01-02"
"16343","2022","COM","2020","295","9","304","2023-01-02"
"16345","2022","COM","2020","212","5","217","2023-01-02"
"16346","2022","COM","2020","247","9","256","2023-01-02"
"16347","2022","COM","2020","511","11","522","2023-01-02"
"16348","2022","COM","2020","1288","33","1321","2023-01-02"
"16349","2022","COM","2020","508","11","519","2023-01-02"
"16350","2022","COM","2020","803","10","813","2023-01-02"
"16352","2022","COM","2020","223","8","231","2023-01-02"
"16353","2022","COM","2020","802","11","813","2023-01-02"
"16354","2022","COM","2020","124","3","127","2023-01-02"
"16355","2022","COM","2020","1186","16","1202","2023-01-02"
"16356","2022","COM","2020","32","0","32","2023-01-02"
"16357","2022","COM","2020","138","2","140","2023-01-02"
"16358","2022","COM","2020","7499","241","7740","2023-01-02"
"16359","2022","COM","2020","1010","27","1037","2023-01-02"
"16360","2022","COM","2020","403","85","488","2023-01-02"
"16361","2022","COM","2020","313","6","319","2023-01-02"
"16362","2022","COM","2020","321","12","333","2023-01-02"
"16363","2022","COM","2020","529","9","538","2023-01-02"
"16364","2022","COM","2020","66","2","68","2023-01-02"
"16365","2022","COM","2020","103","2","105","2023-01-02"
"16366","2022","COM","2020","2076","77","2153","2023-01-02"
"16368","2022","COM","2020","895","20","915","2023-01-02"
"16369","2022","COM","2020","976","21","997","2023-01-02"
"16370","2022","COM","2020","1157","40","1197","2023-01-02"
"16372","2022","COM","2020","135","1","136","2023-01-02"
"16373","2022","COM","2020","192","6","198","2023-01-02"
"16374","2022","COM","2020","9969","309","10278","2023-01-02"
"16375","2022","COM","2020","384","6","390","2023-01-02"
"16377","2022","COM","2020","112","2","114","2023-01-02"
"16378","2022","COM","2020","573","15","588","2023-01-02"
"16379","2022","COM","2020","1477","27","1504","2023-01-02"
"16380","2022","COM","2020","417","3","420","2023-01-02"
"16381","2022","COM","2020","166","2","168","2023-01-02"
"16382","2022","COM","2020","718","30","748","2023-01-02"
"16383","2022","COM","2020","774","10","784","2023-01-02"
"16384","2022","COM","2020","565","7","572","2023-01-02"
"16385","2022","COM","2020","1151","27","1178","2023-01-02"
"16387","2022","COM","2020","463","60","523","2023-01-02"
"16388","2022","COM","2020","933","22","955","2023-01-02"
"16389","2022","COM","2020","85","3","88","2023-01-02"
"16390","2022","COM","2020","228","11","239","2023-01-02"
"16392","2022","COM","2020","185","5","190","2023-01-02"
"16393","2022","COM","2020","2166","31","2197","2023-01-02"
"16394","2022","COM","2020","82","2","84","2023-01-02"
"16395","2022","COM","2020","298","3","301","2023-01-02"
"16396","2022","COM","2020","123","0","123","2023-01-02"
"16397","2022","COM","2020","381","7","388","2023-01-02"
"16398","2022","COM","2020","99","5","104","2023-01-02"
"16399","2022","COM","2020","344","9","353","2023-01-02"
"16400","2022","COM","2020","603","11","614","2023-01-02"
"16401","2022","COM","2020","146","2","148","2023-01-02"
"16402","2022","COM","2020","284","5","289","2023-01-02"
"16403","2022","COM","2020","129","0","129","2023-01-02"
"16404","2022","COM","2020","111","2","113","2023-01-02"
"16405","2022","COM","2020","163","10","173","2023-01-02"
"16406","2022","COM","2020","781","13","794","2023-01-02"
"16408","2022","COM","2020","714","19","733","2023-01-02"
"16409","2022","COM","2020","993","11","1004","2023-01-02"
"16412","2022","COM","2020","338","1","339","2023-01-02"
"16413","2022","COM","2020","135","2","137","2023-01-02"
"16414","2022","COM","2020","318","3","321","2023-01-02"
"16415","2022","COM","2020","1081","23","1104","2023-01-02"
"16416","2022","COM","2020","499","8","507","2023-01-02"
"16418","2022","COM","2020","1555","30","1585","2023-01-02"
"16419","2022","COM","2020","326","2","328","2023-01-02"
"16420","2022","COM","2020","238","4","242","2023-01-02"
"16421","2022","COM","2020","412","5","417","2023-01-02"
"16422","2022","COM","2020","829","8","837","2023-01-02"
"16423","2022","COM","2020","247","2","249","2023-01-02"
"16424","2022","COM","2020","533","8","541","2023-01-02"
"16425","2022","COM","2020","559","9","568","2023-01-02"
"17002","2022","COM","2020","133","4","137","2023-01-02"
"17003","2022","COM","2020","4343","74","4417","2023-01-02"
"17004","2022","COM","2020","209","4","213","2023-01-02"
"17005","2022","COM","2020","196","1","197","2023-01-02"
"17006","2022","COM","2020","250","4","254","2023-01-02"
"17007","2022","COM","2020","316","7","323","2023-01-02"
"17008","2022","COM","2020","2295","37","2332","2023-01-02"
"17009","2022","COM","2020","1204","11","1215","2023-01-02"
"17010","2022","COM","2020","4063","100","4163","2023-01-02"
"17011","2022","COM","2020","395","4","399","2023-01-02"
"17012","2022","COM","2020","155","5","160","2023-01-02"
"17013","2022","COM","2020","348","4","352","2023-01-02"
"17015","2022","COM","2020","745","10","755","2023-01-02"
"17016","2022","COM","2020","775","12","787","2023-01-02"
"17017","2022","COM","2020","702","5","707","2023-01-02"
"17018","2022","COM","2020","856","13","869","2023-01-02"
"17019","2022","COM","2020","1302","24","1326","2023-01-02"
"17020","2022","COM","2020","350","4","354","2023-01-02"
"17021","2022","COM","2020","3672","74","3746","2023-01-02"
"17022","2022","COM","2020","984","25","1009","2023-01-02"
"17023","2022","COM","2020","374","7","381","2023-01-02"
"17024","2022","COM","2020","1324","23","1347","2023-01-02"
"17025","2022","COM","2020","703","29","732","2023-01-02"
"17026","2022","COM","2020","390","5","395","2023-01-02"
"17027","2022","COM","2020","470","7","477","2023-01-02"
"17028","2022","COM","2020","9397","148","9545","2023-01-02"
"17029","2022","COM","2020","199","3","202","2023-01-02"
"17030","2022","COM","2020","559","5","564","2023-01-02"
"17031","2022","COM","2020","198","3","201","2023-01-02"
"17032","2022","COM","2020","809","17","826","2023-01-02"
"17033","2022","COM","2020","496","5","501","2023-01-02"
"17034","2022","COM","2020","459","7","466","2023-01-02"
"17035","2022","COM","2020","109","4","113","2023-01-02"
"17036","2022","COM","2020","780","14","794","2023-01-02"
"17037","2022","COM","2020","651","9","660","2023-01-02"
"17038","2022","COM","2020","693","6","699","2023-01-02"
"17039","2022","COM","2020","214","1","215","2023-01-02"
"17041","2022","COM","2020","1715","16","1731","2023-01-02"
"17042","2022","COM","2020","445","10","455","2023-01-02"
"17043","2022","COM","2020","744","13","757","2023-01-02"
"17044","2022","COM","2020","1149","23","1172","2023-01-02"
"17045","2022","COM","2020","1022","17","1039","2023-01-02"
"17046","2022","COM","2020","375","6","381","2023-01-02"
"17047","2022","COM","2020","237","1","238","2023-01-02"
"17048","2022","COM","2020","321","4","325","2023-01-02"
"17049","2022","COM","2020","78","5","83","2023-01-02"
"17050","2022","COM","2020","519","145","664","2023-01-02"
"17051","2022","COM","2020","2280","30","2310","2023-01-02"
"17052","2022","COM","2020","700","4","704","2023-01-02"
"17053","2022","COM","2020","1317","26","1343","2023-01-02"
"17054","2022","COM","2020","203","9","212","2023-01-02"
"17055","2022","COM","2020","348","4","352","2023-01-02"
"17056","2022","COM","2020","612","13","625","2023-01-02"
"17057","2022","COM","2020","911","16","927","2023-01-02"
"17058","2022","COM","2020","3515","129","3644","2023-01-02"
"17059","2022","COM","2020","1394","25","1419","2023-01-02"
"17060","2022","COM","2020","229","2","231","2023-01-02"
"17061","2022","COM","2020","139","2","141","2023-01-02"
"17062","2022","COM","2020","220","1","221","2023-01-02"
"17063","2022","COM","2020","460","11","471","2023-01-02"
"17064","2022","COM","2020","3031","64","3095","2023-01-02"
"17065","2022","COM","2020","1823","54","1877","2023-01-02"
"17066","2022","COM","2020","232","3","235","2023-01-02"
"17067","2022","COM","2020","172","4","176","2023-01-02"
"17068","2022","COM","2020","246","3","249","2023-01-02"
"17069","2022","COM","2020","231","7","238","2023-01-02"
"17070","2022","COM","2020","940","15","955","2023-01-02"
"17071","2022","COM","2020","513","8","521","2023-01-02"
"17072","2022","COM","2020","1324","26","1350","2023-01-02"
"17073","2022","COM","2020","1282","44","1326","2023-01-02"
"17074","2022","COM","2020","1069","16","1085","2023-01-02"
"17075","2022","COM","2020","1422","23","1445","2023-01-02"
"17076","2022","COM","2020","321","3","324","2023-01-02"
"17077","2022","COM","2020","1267","20","1287","2023-01-02"
"17078","2022","COM","2020","514","8","522","2023-01-02"
"17079","2022","COM","2020","1628","33","1661","2023-01-02"
"17080","2022","COM","2020","978","12","990","2023-01-02"
"17081","2022","COM","2020","369","7","376","2023-01-02"
"17082","2022","COM","2020","516","16","532","2023-01-02"
"17083","2022","COM","2020","620","12","632","2023-01-02"
"17084","2022","COM","2020","683","8","691","2023-01-02"
"17085","2022","COM","2020","407","5","412","2023-01-02"
"17086","2022","COM","2020","3585","82","3667","2023-01-02"
"17087","2022","COM","2020","207","1","208","2023-01-02"
"17089","2022","COM","2020","1005","25","1030","2023-01-02"
"17091","2022","COM","2020","2007","27","2034","2023-01-02"
"17092","2022","COM","2020","164","4","168","2023-01-02"
"17093","2022","COM","2020","4312","79","4391","2023-01-02"
"17094","2022","COM","2020","6024","94","6118","2023-01-02"
"17095","2022","COM","2020","213","6","219","2023-01-02"
"17096","2022","COM","2020","77","2","79","2023-01-02"
"17097","2022","COM","2020","798","28","826","2023-01-02"
"17098","2022","COM","2020","592","13","605","2023-01-02"
"17099","2022","COM","2020","655","7","662","2023-01-02"
"17100","2022","COM","2020","1125","17","1142","2023-01-02"
"17101","2022","COM","2020","327","1","328","2023-01-02"
"17102","2022","COM","2020","1271","36","1307","2023-01-02"
"17104","2022","COM","2020","1099","106","1205","2023-01-02"
"17105","2022","COM","2020","311","1","312","2023-01-02"
"17106","2022","COM","2020","316","5","321","2023-01-02"
"17107","2022","COM","2020","1509","25","1534","2023-01-02"
"17108","2022","COM","2020","411","15","426","2023-01-02"
"17109","2022","COM","2020","1458","20","1478","2023-01-02"
"17110","2022","COM","2020","975","15","990","2023-01-02"
"17111","2022","COM","2020","829","11","840","2023-01-02"
"17112","2022","COM","2020","714","16","730","2023-01-02"
"17113","2022","COM","2020","713","8","721","2023-01-02"
"17114","2022","COM","2020","207","2","209","2023-01-02"
"17115","2022","COM","2020","305","7","312","2023-01-02"
"17116","2022","COM","2020","232","5","237","2023-01-02"
"17117","2022","COM","2020","138","0","138","2023-01-02"
"17118","2022","COM","2020","333","2","335","2023-01-02"
"17119","2022","COM","2020","1177","22","1199","2023-01-02"
"17120","2022","COM","2020","1908","28","1936","2023-01-02"
"17121","2022","COM","2020","1103","18","1121","2023-01-02"
"17122","2022","COM","2020","233","4","237","2023-01-02"
"17124","2022","COM","2020","431","4","435","2023-01-02"
"17125","2022","COM","2020","457","10","467","2023-01-02"
"17126","2022","COM","2020","302","6","308","2023-01-02"
"17127","2022","COM","2020","1879","27","1906","2023-01-02"
"17128","2022","COM","2020","700","12","712","2023-01-02"
"17129","2022","COM","2020","418","6","424","2023-01-02"
"17130","2022","COM","2020","476","13","489","2023-01-02"
"17131","2022","COM","2020","2144","44","2188","2023-01-02"
"17132","2022","COM","2020","648","18","666","2023-01-02"
"17133","2022","COM","2020","878","76","954","2023-01-02"
"17134","2022","COM","2020","436","8","444","2023-01-02"
"17135","2022","COM","2020","222","2","224","2023-01-02"
"17136","2022","COM","2020","1298","29","1327","2023-01-02"
"17137","2022","COM","2020","223","3","226","2023-01-02"
"17138","2022","COM","2020","279","7","286","2023-01-02"
"17139","2022","COM","2020","348","4","352","2023-01-02"
"17140","2022","COM","2020","3142","66","3208","2023-01-02"
"17141","2022","COM","2020","474","9","483","2023-01-02"
"17142","2022","COM","2020","5803","147","5950","2023-01-02"
"17143","2022","COM","2020","700","13","713","2023-01-02"
"17145","2022","COM","2020","485","8","493","2023-01-02"
"17146","2022","COM","2020","3548","68","3616","2023-01-02"
"17147","2022","COM","2020","1386","21","1407","2023-01-02"
"17148","2022","COM","2020","453","10","463","2023-01-02"
"17149","2022","COM","2020","60","2","62","2023-01-02"
"17150","2022","COM","2020","525","7","532","2023-01-02"
"17151","2022","COM","2020","887","16","903","2023-01-02"
"17152","2022","COM","2020","880","8","888","2023-01-02"
"17153","2022","COM","2020","2079","32","2111","2023-01-02"
"17154","2022","COM","2020","718","8","726","2023-01-02"
"17155","2022","COM","2020","2667","43","2710","2023-01-02"
"17156","2022","COM","2020","135","3","138","2023-01-02"
"17157","2022","COM","2020","162","2","164","2023-01-02"
"17158","2022","COM","2020","1183","8","1191","2023-01-02"
"17159","2022","COM","2020","361","7","368","2023-01-02"
"17160","2022","COM","2020","433","13","446","2023-01-02"
"17161","2022","COM","2020","2903","48","2951","2023-01-02"
"17162","2022","COM","2020","197","1","198","2023-01-02"
"17163","2022","COM","2020","511","10","521","2023-01-02"
"17164","2022","COM","2020","2317","54","2371","2023-01-02"
"17165","2022","COM","2020","391","13","404","2023-01-02"
"17166","2022","COM","2020","1321","13","1334","2023-01-02"
"17167","2022","COM","2020","770","11","781","2023-01-02"
"17168","2022","COM","2020","3998","71","4069","2023-01-02"
"17171","2022","COM","2020","772","11","783","2023-01-02"
"17172","2022","COM","2020","2945","37","2982","2023-01-02"
"17173","2022","COM","2020","229","4","233","2023-01-02"
"17174","2022","COM","2020","922","10","932","2023-01-02"
"17175","2022","COM","2020","647","8","655","2023-01-02"
"17176","2022","COM","2020","104","4","108","2023-01-02"
"17177","2022","COM","2020","117","0","117","2023-01-02"
"17178","2022","COM","2020","72","1","73","2023-01-02"
"17179","2022","COM","2020","1793","88","1881","2023-01-02"
"17180","2022","COM","2020","88","4","92","2023-01-02"
"17181","2022","COM","2020","315","6","321","2023-01-02"
"17182","2022","COM","2020","549","11","560","2023-01-02"
"17183","2022","COM","2020","943","13","956","2023-01-02"
"17184","2022","COM","2020","585","12","597","2023-01-02"
"17185","2022","COM","2020","2103","34","2137","2023-01-02"
"17186","2022","COM","2020","968","11","979","2023-01-02"
"17187","2022","COM","2020","495","16","511","2023-01-02"
"17188","2022","COM","2020","454","10","464","2023-01-02"
"17190","2022","COM","2020","2861","56","2917","2023-01-02"
"17191","2022","COM","2020","429","9","438","2023-01-02"
"17192","2022","COM","2020","859","19","878","2023-01-02"
"17193","2022","COM","2020","2567","55","2622","2023-01-02"
"17194","2022","COM","2020","3371","75","3446","2023-01-02"
"17195","2022","COM","2020","278","3","281","2023-01-02"
"17196","2022","COM","2020","546","15","561","2023-01-02"
"17197","2022","COM","2020","3542","224","3766","2023-01-02"
"17198","2022","COM","2020","305","6","311","2023-01-02"
"17199","2022","COM","2020","156","0","156","2023-01-02"
"17200","2022","COM","2020","7193","157","7350","2023-01-02"
"17201","2022","COM","2020","482","5","487","2023-01-02"
"17202","2022","COM","2020","575","13","588","2023-01-02"
"17203","2022","COM","2020","758","11","769","2023-01-02"
"17204","2022","COM","2020","303","8","311","2023-01-02"
"17205","2022","COM","2020","390","7","397","2023-01-02"
"17206","2022","COM","2020","283","3","286","2023-01-02"
"17207","2022","COM","2020","735","19","754","2023-01-02"
"17208","2022","COM","2020","1055","10","1065","2023-01-02"
"17209","2022","COM","2020","270","4","274","2023-01-02"
"17210","2022","COM","2020","506","4","510","2023-01-02"
"17211","2022","COM","2020","754","11","765","2023-01-02"
"17212","2022","COM","2020","168","2","170","2023-01-02"
"17213","2022","COM","2020","134","4","138","2023-01-02"
"17214","2022","COM","2020","529","11","540","2023-01-02"
"17215","2022","COM","2020","47","0","47","2023-01-02"
"17216","2022","COM","2020","1019","13","1032","2023-01-02"
"17217","2022","COM","2020","291","7","298","2023-01-02"
"17218","2022","COM","2020","4512","72","4584","2023-01-02"
"17219","2022","COM","2020","6203","101","6304","2023-01-02"
"17220","2022","COM","2020","412","17","429","2023-01-02"
"17221","2022","COM","2020","929","19","948","2023-01-02"
"17222","2022","COM","2020","3190","94","3284","2023-01-02"
"17223","2022","COM","2020","183","1","184","2023-01-02"
"17224","2022","COM","2020","2178","79","2257","2023-01-02"
"17225","2022","COM","2020","2178","32","2210","2023-01-02"
"17226","2022","COM","2020","988","14","1002","2023-01-02"
"17227","2022","COM","2020","221","3","224","2023-01-02"
"17228","2022","COM","2020","3011","73","3084","2023-01-02"
"17229","2022","COM","2020","225","3","228","2023-01-02"
"17230","2022","COM","2020","3131","70","3201","2023-01-02"
"17231","2022","COM","2020","105","5","110","2023-01-02"
"17232","2022","COM","2020","1536","21","1557","2023-01-02"
"17233","2022","COM","2020","330","1","331","2023-01-02"
"17234","2022","COM","2020","356","4","360","2023-01-02"
"17235","2022","COM","2020","714","11","725","2023-01-02"
"17236","2022","COM","2020","1520","29","1549","2023-01-02"
"17237","2022","COM","2020","596","4","600","2023-01-02"
"17239","2022","COM","2020","446","7","453","2023-01-02"
"17240","2022","COM","2020","3222","52","3274","2023-01-02"
"17241","2022","COM","2020","1564","19","1583","2023-01-02"
"17242","2022","COM","2020","879","13","892","2023-01-02"
"17243","2022","COM","2020","1217","10","1227","2023-01-02"
"17244","2022","COM","2020","688","9","697","2023-01-02"
"17245","2022","COM","2020","908","13","921","2023-01-02"
"17246","2022","COM","2020","531","6","537","2023-01-02"
"17247","2022","COM","2020","859","13","872","2023-01-02"
"17248","2022","COM","2020","922","17","939","2023-01-02"
"17249","2022","COM","2020","171","1","172","2023-01-02"
"17250","2022","COM","2020","477","5","482","2023-01-02"
"17252","2022","COM","2020","306","7","313","2023-01-02"
"17253","2022","COM","2020","1351","16","1367","2023-01-02"
"17254","2022","COM","2020","193","2","195","2023-01-02"
"17255","2022","COM","2020","796","11","807","2023-01-02"
"17256","2022","COM","2020","323","13","336","2023-01-02"
"17257","2022","COM","2020","658","5","663","2023-01-02"
"17258","2022","COM","2020","302","4","306","2023-01-02"
"17259","2022","COM","2020","155","2","157","2023-01-02"
"17260","2022","COM","2020","469","5","474","2023-01-02"
"17261","2022","COM","2020","307","5","312","2023-01-02"
"17262","2022","COM","2020","1266","22","1288","2023-01-02"
"17263","2022","COM","2020","588","12","600","2023-01-02"
"17264","2022","COM","2020","5811","146","5957","2023-01-02"
"17265","2022","COM","2020","1221","18","1239","2023-01-02"
"17266","2022","COM","2020","724","7","731","2023-01-02"
"17267","2022","COM","2020","1196","18","1214","2023-01-02"
"17268","2022","COM","2020","191","7","198","2023-01-02"
"17269","2022","COM","2020","697","7","704","2023-01-02"
"17270","2022","COM","2020","616","13","629","2023-01-02"
"17271","2022","COM","2020","325","6","331","2023-01-02"
"17273","2022","COM","2020","998","18","1016","2023-01-02"
"17274","2022","COM","2020","8741","191","8932","2023-01-02"
"17275","2022","COM","2020","786","26","812","2023-01-02"
"17276","2022","COM","2020","74","1","75","2023-01-02"
"17277","2022","COM","2020","1059","81","1140","2023-01-02"
"17278","2022","COM","2020","777","9","786","2023-01-02"
"17279","2022","COM","2020","641","13","654","2023-01-02"
"17280","2022","COM","2020","760","11","771","2023-01-02"
"17281","2022","COM","2020","160","3","163","2023-01-02"
"17282","2022","COM","2020","213","2","215","2023-01-02"
"17283","2022","COM","2020","4206","250","4456","2023-01-02"
"17284","2022","COM","2020","1788","288","2076","2023-01-02"
"17285","2022","COM","2020","1151","27","1178","2023-01-02"
"17286","2022","COM","2020","593","8","601","2023-01-02"
"17287","2022","COM","2020","266","2","268","2023-01-02"
"17288","2022","COM","2020","315","6","321","2023-01-02"
"17289","2022","COM","2020","437","18","455","2023-01-02"
"17290","2022","COM","2020","293","9","302","2023-01-02"
"17291","2022","COM","2020","6659","127","6786","2023-01-02"
"17292","2022","COM","2020","513","5","518","2023-01-02"
"17293","2022","COM","2020","700","12","712","2023-01-02"
"17294","2022","COM","2020","195","3","198","2023-01-02"
"17295","2022","COM","2020","781","16","797","2023-01-02"
"17296","2022","COM","2020","1059","14","1073","2023-01-02"
"17297","2022","COM","2020","2320","45","2365","2023-01-02"
"17298","2022","COM","2020","987","22","1009","2023-01-02"
"17299","2022","COM","2020","23410","632","24042","2023-01-02"
"17300","2022","COM","2020","77210","2113","79323","2023-01-02"
"17301","2022","COM","2020","70","1","71","2023-01-02"
"17302","2022","COM","2020","589","9","598","2023-01-02"
"17303","2022","COM","2020","1021","17","1038","2023-01-02"
"17304","2022","COM","2020","494","5","499","2023-01-02"
"17305","2022","COM","2020","407","9","416","2023-01-02"
"17306","2022","COM","2020","18638","536","19174","2023-01-02"
"17307","2022","COM","2020","1396","32","1428","2023-01-02"
"17308","2022","COM","2020","2737","61","2798","2023-01-02"
"17309","2022","COM","2020","1887","40","1927","2023-01-02"
"17310","2022","COM","2020","1147","14","1161","2023-01-02"
"17311","2022","COM","2020","1421","18","1439","2023-01-02"
"17312","2022","COM","2020","825","14","839","2023-01-02"
"17313","2022","COM","2020","383","13","396","2023-01-02"
"17314","2022","COM","2020","903","17","920","2023-01-02"
"17315","2022","COM","2020","1376","29","1405","2023-01-02"
"17316","2022","COM","2020","388","11","399","2023-01-02"
"17317","2022","COM","2020","564","5","569","2023-01-02"
"17318","2022","COM","2020","691","11","702","2023-01-02"
"17319","2022","COM","2020","104","1","105","2023-01-02"
"17320","2022","COM","2020","409","6","415","2023-01-02"
"17321","2022","COM","2020","355","7","362","2023-01-02"
"17322","2022","COM","2020","687","5","692","2023-01-02"
"17323","2022","COM","2020","1297","24","1321","2023-01-02"
"17324","2022","COM","2020","111","0","111","2023-01-02"
"17325","2022","COM","2020","526","6","532","2023-01-02"
"17326","2022","COM","2020","286","3","289","2023-01-02"
"17327","2022","COM","2020","317","3","320","2023-01-02"
"17328","2022","COM","2020","908","11","919","2023-01-02"
"17329","2022","COM","2020","368","2","370","2023-01-02"
"17330","2022","COM","2020","1348","19","1367","2023-01-02"
"17331","2022","COM","2020","1241","52","1293","2023-01-02"
"17332","2022","COM","2020","391","6","397","2023-01-02"
"17333","2022","COM","2020","5246","110","5356","2023-01-02"
"17334","2022","COM","2020","227","3","230","2023-01-02"
"17335","2022","COM","2020","286","3","289","2023-01-02"
"17336","2022","COM","2020","2779","70","2849","2023-01-02"
"17337","2022","COM","2020","3845","55","3900","2023-01-02"
"17338","2022","COM","2020","1807","21","1828","2023-01-02"
"17339","2022","COM","2020","1295","123","1418","2023-01-02"
"17340","2022","COM","2020","1517","91","1608","2023-01-02"
"17341","2022","COM","2020","182","4","186","2023-01-02"
"17342","2022","COM","2020","413","11","424","2023-01-02"
"17343","2022","COM","2020","145","3","148","2023-01-02"
"17344","2022","COM","2020","1328","26","1354","2023-01-02"
"17345","2022","COM","2020","297","14","311","2023-01-02"
"17346","2022","COM","2020","1475","25","1500","2023-01-02"
"17347","2022","COM","2020","6744","428","7172","2023-01-02"
"17348","2022","COM","2020","693","10","703","2023-01-02"
"17349","2022","COM","2020","2997","44","3041","2023-01-02"
"17350","2022","COM","2020","864","16","880","2023-01-02"
"17351","2022","COM","2020","2046","34","2080","2023-01-02"
"17353","2022","COM","2020","2264","62","2326","2023-01-02"
"17354","2022","COM","2020","653","14","667","2023-01-02"
"17355","2022","COM","2020","511","8","519","2023-01-02"
"17356","2022","COM","2020","309","4","313","2023-01-02"
"17357","2022","COM","2020","531","8","539","2023-01-02"
"17358","2022","COM","2020","307","6","313","2023-01-02"
"17359","2022","COM","2020","1210","20","1230","2023-01-02"
"17360","2022","COM","2020","3356","108","3464","2023-01-02"
"17361","2022","COM","2020","112","5","117","2023-01-02"
"17362","2022","COM","2020","299","7","306","2023-01-02"
"17363","2022","COM","2020","547","14","561","2023-01-02"
"17364","2022","COM","2020","430","14","444","2023-01-02"
"17365","2022","COM","2020","469","9","478","2023-01-02"
"17366","2022","COM","2020","489","4","493","2023-01-02"
"17367","2022","COM","2020","156","4","160","2023-01-02"
"17369","2022","COM","2020","2220","20","2240","2023-01-02"
"17372","2022","COM","2020","82","1","83","2023-01-02"
"17373","2022","COM","2020","2333","43","2376","2023-01-02"
"17374","2022","COM","2020","237","6","243","2023-01-02"
"17375","2022","COM","2020","1205","20","1225","2023-01-02"
"17376","2022","COM","2020","1983","31","2014","2023-01-02"
"17377","2022","COM","2020","128","5","133","2023-01-02"
"17378","2022","COM","2020","432","6","438","2023-01-02"
"17379","2022","COM","2020","209","3","212","2023-01-02"
"17380","2022","COM","2020","3920","82","4002","2023-01-02"
"17381","2022","COM","2020","222","3","225","2023-01-02"
"17382","2022","COM","2020","550","6","556","2023-01-02"
"17383","2022","COM","2020","347","4","351","2023-01-02"
"17384","2022","COM","2020","261","2","263","2023-01-02"
"17385","2022","COM","2020","6585","97","6682","2023-01-02"
"17386","2022","COM","2020","348","10","358","2023-01-02"
"17387","2022","COM","2020","1920","27","1947","2023-01-02"
"17388","2022","COM","2020","254","6","260","2023-01-02"
"17389","2022","COM","2020","579","8","587","2023-01-02"
"17390","2022","COM","2020","114","1","115","2023-01-02"
"17391","2022","COM","2020","2425","50","2475","2023-01-02"
"17393","2022","COM","2020","1760","27","1787","2023-01-02"
"17394","2022","COM","2020","902","18","920","2023-01-02"
"17395","2022","COM","2020","494","8","502","2023-01-02"
"17396","2022","COM","2020","1727","29","1756","2023-01-02"
"17397","2022","COM","2020","2452","101","2553","2023-01-02"
"17398","2022","COM","2020","167","7","174","2023-01-02"
"17400","2022","COM","2020","638","13","651","2023-01-02"
"17401","2022","COM","2020","94","3","97","2023-01-02"
"17402","2022","COM","2020","158","2","160","2023-01-02"
"17403","2022","COM","2020","763","13","776","2023-01-02"
"17404","2022","COM","2020","662","19","681","2023-01-02"
"17405","2022","COM","2020","198","2","200","2023-01-02"
"17406","2022","COM","2020","417","3","420","2023-01-02"
"17407","2022","COM","2020","4906","95","5001","2023-01-02"
"17408","2022","COM","2020","910","9","919","2023-01-02"
"17409","2022","COM","2020","3328","65","3393","2023-01-02"
"17410","2022","COM","2020","575","9","584","2023-01-02"
"17411","2022","COM","2020","1133","21","1154","2023-01-02"
"17412","2022","COM","2020","660","13","673","2023-01-02"
"17413","2022","COM","2020","1385","21","1406","2023-01-02"
"17414","2022","COM","2020","5231","168","5399","2023-01-02"
"17415","2022","COM","2020","25412","1402","26814","2023-01-02"
"17416","2022","COM","2020","58","2","60","2023-01-02"
"17417","2022","COM","2020","167","1","168","2023-01-02"
"17418","2022","COM","2020","606","17","623","2023-01-02"
"17420","2022","COM","2020","2324","63","2387","2023-01-02"
"17421","2022","COM","2020","7200","120","7320","2023-01-02"
"17422","2022","COM","2020","78","1","79","2023-01-02"
"17423","2022","COM","2020","75","1","76","2023-01-02"
"17424","2022","COM","2020","394","3","397","2023-01-02"
"17425","2022","COM","2020","2429","46","2475","2023-01-02"
"17426","2022","COM","2020","260","2","262","2023-01-02"
"17427","2022","COM","2020","217","5","222","2023-01-02"
"17428","2022","COM","2020","486","9","495","2023-01-02"
"17429","2022","COM","2020","3347","42","3389","2023-01-02"
"17430","2022","COM","2020","408","7","415","2023-01-02"
"17431","2022","COM","2020","721","6","727","2023-01-02"
"17432","2022","COM","2020","365","6","371","2023-01-02"
"17433","2022","COM","2020","208","7","215","2023-01-02"
"17434","2022","COM","2020","6801","169","6970","2023-01-02"
"17435","2022","COM","2020","174","1","175","2023-01-02"
"17436","2022","COM","2020","768","24","792","2023-01-02"
"17437","2022","COM","2020","96","1","97","2023-01-02"
"17438","2022","COM","2020","299","7","306","2023-01-02"
"17439","2022","COM","2020","779","14","793","2023-01-02"
"17440","2022","COM","2020","371","8","379","2023-01-02"
"17441","2022","COM","2020","1130","26","1156","2023-01-02"
"17442","2022","COM","2020","381","3","384","2023-01-02"
"17443","2022","COM","2020","1778","45","1823","2023-01-02"
"17444","2022","COM","2020","1696","258","1954","2023-01-02"
"17445","2022","COM","2020","334","8","342","2023-01-02"
"17446","2022","COM","2020","463","6","469","2023-01-02"
"17447","2022","COM","2020","2020","25","2045","2023-01-02"
"17448","2022","COM","2020","1180","14","1194","2023-01-02"
"17449","2022","COM","2020","8142","106","8248","2023-01-02"
"17450","2022","COM","2020","244","2","246","2023-01-02"
"17451","2022","COM","2020","548","10","558","2023-01-02"
"17452","2022","COM","2020","4326","65","4391","2023-01-02"
"17453","2022","COM","2020","1468","32","1500","2023-01-02"
"17454","2022","COM","2020","378","7","385","2023-01-02"
"17455","2022","COM","2020","665","11","676","2023-01-02"
"17457","2022","COM","2020","1193","17","1210","2023-01-02"
"17458","2022","COM","2020","181","0","181","2023-01-02"
"17459","2022","COM","2020","560","10","570","2023-01-02"
"17460","2022","COM","2020","841","18","859","2023-01-02"
"17461","2022","COM","2020","3990","80","4070","2023-01-02"
"17462","2022","COM","2020","766","15","781","2023-01-02"
"17463","2022","COM","2020","1282","21","1303","2023-01-02"
"17464","2022","COM","2020","158","6","164","2023-01-02"
"17465","2022","COM","2020","601","10","611","2023-01-02"
"17466","2022","COM","2020","2326","34","2360","2023-01-02"
"17467","2022","COM","2020","236","2","238","2023-01-02"
"17468","2022","COM","2020","153","3","156","2023-01-02"
"17469","2022","COM","2020","576","14","590","2023-01-02"
"17470","2022","COM","2020","228","9","237","2023-01-02"
"17471","2022","COM","2020","208","3","211","2023-01-02"
"17472","2022","COM","2020","2297","19","2316","2023-01-02"
"17473","2022","COM","2020","119","0","119","2023-01-02"
"17474","2022","COM","2020","742","13","755","2023-01-02"
"17476","2022","COM","2020","271","5","276","2023-01-02"
"17477","2022","COM","2020","109","1","110","2023-01-02"
"17478","2022","COM","2020","61","0","61","2023-01-02"
"17479","2022","COM","2020","300","3","303","2023-01-02"
"17480","2022","COM","2020","757","17","774","2023-01-02"
"17481","2022","COM","2020","168","3","171","2023-01-02"
"17482","2022","COM","2020","643","11","654","2023-01-02"
"17483","2022","COM","2020","1497","26","1523","2023-01-02"
"17484","2022","COM","2020","1764","13","1777","2023-01-02"
"17485","2022","COM","2020","1074","13","1087","2023-01-02"
"17486","2022","COM","2020","688","6","694","2023-01-02"
"18001","2022","COM","2020","364","7","371","2023-01-02"
"18002","2022","COM","2020","191","4","195","2023-01-02"
"18003","2022","COM","2020","1881","28","1909","2023-01-02"
"18004","2022","COM","2020","1097","18","1115","2023-01-02"
"18005","2022","COM","2020","1074","23","1097","2023-01-02"
"18006","2022","COM","2020","240","2","242","2023-01-02"
"18007","2022","COM","2020","69","1","70","2023-01-02"
"18008","2022","COM","2020","493","10","503","2023-01-02"
"18009","2022","COM","2020","278","11","289","2023-01-02"
"18010","2022","COM","2020","199","7","206","2023-01-02"
"18011","2022","COM","2020","2070","38","2108","2023-01-02"
"18012","2022","COM","2020","438","5","443","2023-01-02"
"18013","2022","COM","2020","301","5","306","2023-01-02"
"18014","2022","COM","2020","148","7","155","2023-01-02"
"18015","2022","COM","2020","5499","124","5623","2023-01-02"
"18016","2022","COM","2020","405","3","408","2023-01-02"
"18017","2022","COM","2020","286","3","289","2023-01-02"
"18018","2022","COM","2020","2804","37","2841","2023-01-02"
"18019","2022","COM","2020","448","7","455","2023-01-02"
"18020","2022","COM","2020","848","13","861","2023-01-02"
"18021","2022","COM","2020","272","4","276","2023-01-02"
"18022","2022","COM","2020","342","8","350","2023-01-02"
"18023","2022","COM","2020","1637","54","1691","2023-01-02"
"18024","2022","COM","2020","102","3","105","2023-01-02"
"18025","2022","COM","2020","610","12","622","2023-01-02"
"18026","2022","COM","2020","986","27","1013","2023-01-02"
"18027","2022","COM","2020","653","67","720","2023-01-02"
"18028","2022","COM","2020","1172","37","1209","2023-01-02"
"18029","2022","COM","2020","299","4","303","2023-01-02"
"18030","2022","COM","2020","1008","21","1029","2023-01-02"
"18031","2022","COM","2020","563","5","568","2023-01-02"
"18032","2022","COM","2020","1375","35","1410","2023-01-02"
"18033","2022","COM","2020","64362","2023","66385","2023-01-02"
"18034","2022","COM","2020","308","9","317","2023-01-02"
"18035","2022","COM","2020","1053","22","1075","2023-01-02"
"18036","2022","COM","2020","524","6","530","2023-01-02"
"18037","2022","COM","2020","971","16","987","2023-01-02"
"18038","2022","COM","2020","567","4","571","2023-01-02"
"18039","2022","COM","2020","322","8","330","2023-01-02"
"18040","2022","COM","2020","353","3","356","2023-01-02"
"18041","2022","COM","2020","196","2","198","2023-01-02"
"18042","2022","COM","2020","345","5","350","2023-01-02"
"18043","2022","COM","2020","194","0","194","2023-01-02"
"18044","2022","COM","2020","407","4","411","2023-01-02"
"18045","2022","COM","2020","404","8","412","2023-01-02"
"18046","2022","COM","2020","162","2","164","2023-01-02"
"18047","2022","COM","2020","612","8","620","2023-01-02"
"18048","2022","COM","2020","380","4","384","2023-01-02"
"18049","2022","COM","2020","467","9","476","2023-01-02"
"18050","2022","COM","2020","3674","79","3753","2023-01-02"
"18051","2022","COM","2020","134","3","137","2023-01-02"
"18052","2022","COM","2020","1017","22","1039","2023-01-02"
"18053","2022","COM","2020","290","8","298","2023-01-02"
"18054","2022","COM","2020","246","3","249","2023-01-02"
"18055","2022","COM","2020","922","22","944","2023-01-02"
"18056","2022","COM","2020","236","6","242","2023-01-02"
"18057","2022","COM","2020","1740","18","1758","2023-01-02"
"18058","2022","COM","2020","1425","13","1438","2023-01-02"
"18059","2022","COM","2020","936","11","947","2023-01-02"
"18060","2022","COM","2020","48","2","50","2023-01-02"
"18061","2022","COM","2020","88","0","88","2023-01-02"
"18062","2022","COM","2020","266","1","267","2023-01-02"
"18063","2022","COM","2020","156","3","159","2023-01-02"
"18064","2022","COM","2020","218","6","224","2023-01-02"
"18065","2022","COM","2020","802","12","814","2023-01-02"
"18066","2022","COM","2020","901","15","916","2023-01-02"
"18067","2022","COM","2020","708","10","718","2023-01-02"
"18068","2022","COM","2020","34","2","36","2023-01-02"
"18069","2022","COM","2020","412","16","428","2023-01-02"
"18070","2022","COM","2020","201","2","203","2023-01-02"
"18071","2022","COM","2020","33","0","33","2023-01-02"
"18072","2022","COM","2020","253","1","254","2023-01-02"
"18073","2022","COM","2020","200","6","206","2023-01-02"
"18074","2022","COM","2020","199","4","203","2023-01-02"
"18075","2022","COM","2020","1023","27","1050","2023-01-02"
"18076","2022","COM","2020","443","8","451","2023-01-02"
"18077","2022","COM","2020","366","9","375","2023-01-02"
"18078","2022","COM","2020","61","1","62","2023-01-02"
"18079","2022","COM","2020","438","6","444","2023-01-02"
"18080","2022","COM","2020","146","2","148","2023-01-02"
"18081","2022","COM","2020","405","3","408","2023-01-02"
"18082","2022","COM","2020","1026","29","1055","2023-01-02"
"18083","2022","COM","2020","767","7","774","2023-01-02"
"18084","2022","COM","2020","203","3","206","2023-01-02"
"18085","2022","COM","2020","240","5","245","2023-01-02"
"18086","2022","COM","2020","546","16","562","2023-01-02"
"18087","2022","COM","2020","3616","71","3687","2023-01-02"
"18088","2022","COM","2020","210","7","217","2023-01-02"
"18089","2022","COM","2020","436","10","446","2023-01-02"
"18090","2022","COM","2020","413","10","423","2023-01-02"
"18091","2022","COM","2020","253","6","259","2023-01-02"
"18092","2022","COM","2020","995","24","1019","2023-01-02"
"18093","2022","COM","2020","137","0","137","2023-01-02"
"18094","2022","COM","2020","334","8","342","2023-01-02"
"18095","2022","COM","2020","168","4","172","2023-01-02"
"18096","2022","COM","2020","2086","34","2120","2023-01-02"
"18097","2022","COM","2020","1952","32","1984","2023-01-02"
"18098","2022","COM","2020","127","3","130","2023-01-02"
"18099","2022","COM","2020","221","4","225","2023-01-02"
"18100","2022","COM","2020","676","17","693","2023-01-02"
"18101","2022","COM","2020","290","10","300","2023-01-02"
"18102","2022","COM","2020","303","3","306","2023-01-02"
"18103","2022","COM","2020","1369","14","1383","2023-01-02"
"18104","2022","COM","2020","134","2","136","2023-01-02"
"18105","2022","COM","2020","459","17","476","2023-01-02"
"18106","2022","COM","2020","263","3","266","2023-01-02"
"18107","2022","COM","2020","123","8","131","2023-01-02"
"18108","2022","COM","2020","3168","33","3201","2023-01-02"
"18109","2022","COM","2020","1720","20","1740","2023-01-02"
"18110","2022","COM","2020","965","18","983","2023-01-02"
"18111","2022","COM","2020","187","1","188","2023-01-02"
"18112","2022","COM","2020","282","1","283","2023-01-02"
"18113","2022","COM","2020","179","5","184","2023-01-02"
"18114","2022","COM","2020","223","4","227","2023-01-02"
"18115","2022","COM","2020","786","7","793","2023-01-02"
"18116","2022","COM","2020","273","2","275","2023-01-02"
"18117","2022","COM","2020","503","5","508","2023-01-02"
"18118","2022","COM","2020","1317","32","1349","2023-01-02"
"18119","2022","COM","2020","204","5","209","2023-01-02"
"18120","2022","COM","2020","588","13","601","2023-01-02"
"18121","2022","COM","2020","93","4","97","2023-01-02"
"18122","2022","COM","2020","220","2","222","2023-01-02"
"18124","2022","COM","2020","297","3","300","2023-01-02"
"18125","2022","COM","2020","1075","25","1100","2023-01-02"
"18126","2022","COM","2020","1373","44","1417","2023-01-02"
"18127","2022","COM","2020","1358","28","1386","2023-01-02"
"18128","2022","COM","2020","168","0","168","2023-01-02"
"18129","2022","COM","2020","228","5","233","2023-01-02"
"18130","2022","COM","2020","298","6","304","2023-01-02"
"18131","2022","COM","2020","34","0","34","2023-01-02"
"18132","2022","COM","2020","136","1","137","2023-01-02"
"18133","2022","COM","2020","1593","13","1606","2023-01-02"
"18134","2022","COM","2020","661","16","677","2023-01-02"
"18135","2022","COM","2020","236","6","242","2023-01-02"
"18136","2022","COM","2020","304","5","309","2023-01-02"
"18137","2022","COM","2020","495","9","504","2023-01-02"
"18138","2022","COM","2020","1916","53","1969","2023-01-02"
"18139","2022","COM","2020","652","12","664","2023-01-02"
"18140","2022","COM","2020","1353","24","1377","2023-01-02"
"18141","2022","COM","2020","6502","88","6590","2023-01-02"
"18142","2022","COM","2020","673","15","688","2023-01-02"
"18143","2022","COM","2020","386","7","393","2023-01-02"
"18144","2022","COM","2020","466","10","476","2023-01-02"
"18145","2022","COM","2020","1614","39","1653","2023-01-02"
"18146","2022","COM","2020","310","13","323","2023-01-02"
"18147","2022","COM","2020","201","3","204","2023-01-02"
"18148","2022","COM","2020","2620","63","2683","2023-01-02"
"18149","2022","COM","2020","562","8","570","2023-01-02"
"18150","2022","COM","2020","703","14","717","2023-01-02"
"18151","2022","COM","2020","335","12","347","2023-01-02"
"18152","2022","COM","2020","109","2","111","2023-01-02"
"18153","2022","COM","2020","312","5","317","2023-01-02"
"18154","2022","COM","2020","173","4","177","2023-01-02"
"18155","2022","COM","2020","426","3","429","2023-01-02"
"18156","2022","COM","2020","432","4","436","2023-01-02"
"18157","2022","COM","2020","765","23","788","2023-01-02"
"18158","2022","COM","2020","848","23","871","2023-01-02"
"18159","2022","COM","2020","813","28","841","2023-01-02"
"18160","2022","COM","2020","1448","19","1467","2023-01-02"
"18161","2022","COM","2020","216","2","218","2023-01-02"
"18162","2022","COM","2020","252","1","253","2023-01-02"
"18163","2022","COM","2020","269","5","274","2023-01-02"
"18164","2022","COM","2020","137","2","139","2023-01-02"
"18165","2022","COM","2020","1106","31","1137","2023-01-02"
"18166","2022","COM","2020","561","10","571","2023-01-02"
"18167","2022","COM","2020","297","2","299","2023-01-02"
"18168","2022","COM","2020","215","1","216","2023-01-02"
"18169","2022","COM","2020","220","3","223","2023-01-02"
"18170","2022","COM","2020","668","7","675","2023-01-02"
"18171","2022","COM","2020","249","7","256","2023-01-02"
"18172","2022","COM","2020","1745","35","1780","2023-01-02"
"18173","2022","COM","2020","242","2","244","2023-01-02"
"18174","2022","COM","2020","264","3","267","2023-01-02"
"18175","2022","COM","2020","611","9","620","2023-01-02"
"18176","2022","COM","2020","410","5","415","2023-01-02"
"18177","2022","COM","2020","54","0","54","2023-01-02"
"18178","2022","COM","2020","194","3","197","2023-01-02"
"18179","2022","COM","2020","994","16","1010","2023-01-02"
"18180","2022","COM","2020","2091","67","2158","2023-01-02"
"18181","2022","COM","2020","545","10","555","2023-01-02"
"18182","2022","COM","2020","216","4","220","2023-01-02"
"18183","2022","COM","2020","149","3","152","2023-01-02"
"18184","2022","COM","2020","349","1","350","2023-01-02"
"18185","2022","COM","2020","235","1","236","2023-01-02"
"18186","2022","COM","2020","439","6","445","2023-01-02"
"18187","2022","COM","2020","513","10","523","2023-01-02"
"18188","2022","COM","2020","222","3","225","2023-01-02"
"18189","2022","COM","2020","481","4","485","2023-01-02"
"18190","2022","COM","2020","828","21","849","2023-01-02"
"18191","2022","COM","2020","177","3","180","2023-01-02"
"18192","2022","COM","2020","233","3","236","2023-01-02"
"18193","2022","COM","2020","202","5","207","2023-01-02"
"18194","2022","COM","2020","973","18","991","2023-01-02"
"18195","2022","COM","2020","189","5","194","2023-01-02"
"18196","2022","COM","2020","79","2","81","2023-01-02"
"18197","2022","COM","2020","9490","295","9785","2023-01-02"
"18198","2022","COM","2020","374","16","390","2023-01-02"
"18199","2022","COM","2020","251","3","254","2023-01-02"
"18200","2022","COM","2020","293","7","300","2023-01-02"
"18201","2022","COM","2020","778","15","793","2023-01-02"
"18202","2022","COM","2020","13","0","13","2023-01-02"
"18203","2022","COM","2020","94","1","95","2023-01-02"
"18204","2022","COM","2020","286","8","294","2023-01-02"
"18205","2022","COM","2020","9664","226","9890","2023-01-02"
"18206","2022","COM","2020","1553","54","1607","2023-01-02"
"18207","2022","COM","2020","6432","95","6527","2023-01-02"
"18208","2022","COM","2020","408","7","415","2023-01-02"
"18209","2022","COM","2020","442","15","457","2023-01-02"
"18210","2022","COM","2020","603","12","615","2023-01-02"
"18211","2022","COM","2020","695","16","711","2023-01-02"
"18212","2022","COM","2020","637","14","651","2023-01-02"
"18213","2022","COM","2020","4995","111","5106","2023-01-02"
"18214","2022","COM","2020","593","3","596","2023-01-02"
"18215","2022","COM","2020","142","2","144","2023-01-02"
"18216","2022","COM","2020","484","13","497","2023-01-02"
"18217","2022","COM","2020","153","4","157","2023-01-02"
"18218","2022","COM","2020","653","13","666","2023-01-02"
"18219","2022","COM","2020","510","11","521","2023-01-02"
"18220","2022","COM","2020","346","4","350","2023-01-02"
"18221","2022","COM","2020","298","2","300","2023-01-02"
"18223","2022","COM","2020","2484","35","2519","2023-01-02"
"18224","2022","COM","2020","295","9","304","2023-01-02"
"18225","2022","COM","2020","268","8","276","2023-01-02"
"18226","2022","COM","2020","463","15","478","2023-01-02"
"18227","2022","COM","2020","168","4","172","2023-01-02"
"18228","2022","COM","2020","218","4","222","2023-01-02"
"18229","2022","COM","2020","615","19","634","2023-01-02"
"18230","2022","COM","2020","283","11","294","2023-01-02"
"18231","2022","COM","2020","742","19","761","2023-01-02"
"18232","2022","COM","2020","244","2","246","2023-01-02"
"18233","2022","COM","2020","1396","26","1422","2023-01-02"
"18234","2022","COM","2020","429","8","437","2023-01-02"
"18235","2022","COM","2020","1122","19","1141","2023-01-02"
"18236","2022","COM","2020","133","2","135","2023-01-02"
"18237","2022","COM","2020","476","10","486","2023-01-02"
"18238","2022","COM","2020","127","4","131","2023-01-02"
"18240","2022","COM","2020","641","8","649","2023-01-02"
"18241","2022","COM","2020","1340","30","1370","2023-01-02"
"18242","2022","COM","2020","2943","33","2976","2023-01-02"
"18243","2022","COM","2020","413","2","415","2023-01-02"
"18244","2022","COM","2020","79","0","79","2023-01-02"
"18245","2022","COM","2020","484","9","493","2023-01-02"
"18246","2022","COM","2020","1112","21","1133","2023-01-02"
"18247","2022","COM","2020","729","15","744","2023-01-02"
"18248","2022","COM","2020","468","6","474","2023-01-02"
"18249","2022","COM","2020","402","13","415","2023-01-02"
"18250","2022","COM","2020","68","2","70","2023-01-02"
"18251","2022","COM","2020","56","2","58","2023-01-02"
"18252","2022","COM","2020","295","7","302","2023-01-02"
"18253","2022","COM","2020","466","12","478","2023-01-02"
"18254","2022","COM","2020","595","15","610","2023-01-02"
"18255","2022","COM","2020","990","204","1194","2023-01-02"
"18256","2022","COM","2020","337","7","344","2023-01-02"
"18257","2022","COM","2020","662","14","676","2023-01-02"
"18258","2022","COM","2020","690","17","707","2023-01-02"
"18259","2022","COM","2020","279","3","282","2023-01-02"
"18260","2022","COM","2020","88","1","89","2023-01-02"
"18261","2022","COM","2020","403","6","409","2023-01-02"
"18262","2022","COM","2020","325","8","333","2023-01-02"
"18263","2022","COM","2020","662","3","665","2023-01-02"
"18264","2022","COM","2020","81","2","83","2023-01-02"
"18265","2022","COM","2020","792","12","804","2023-01-02"
"18266","2022","COM","2020","232","7","239","2023-01-02"
"18267","2022","COM","2020","3977","91","4068","2023-01-02"
"18268","2022","COM","2020","405","10","415","2023-01-02"
"18269","2022","COM","2020","651","14","665","2023-01-02"
"18270","2022","COM","2020","708","21","729","2023-01-02"
"18271","2022","COM","2020","1528","33","1561","2023-01-02"
"18272","2022","COM","2020","630","22","652","2023-01-02"
"18273","2022","COM","2020","809","17","826","2023-01-02"
"18274","2022","COM","2020","312","3","315","2023-01-02"
"18275","2022","COM","2020","141","7","148","2023-01-02"
"18276","2022","COM","2020","187","2","189","2023-01-02"
"18277","2022","COM","2020","35","0","35","2023-01-02"
"18278","2022","COM","2020","549","12","561","2023-01-02"
"18279","2022","COM","2020","25045","497","25542","2023-01-02"
"18280","2022","COM","2020","715","21","736","2023-01-02"
"18281","2022","COM","2020","2138","37","2175","2023-01-02"
"18282","2022","COM","2020","575","14","589","2023-01-02"
"18283","2022","COM","2020","82","0","82","2023-01-02"
"18284","2022","COM","2020","212","4","216","2023-01-02"
"18285","2022","COM","2020","411","5","416","2023-01-02"
"18286","2022","COM","2020","460","7","467","2023-01-02"
"18287","2022","COM","2020","294","7","301","2023-01-02"
"18288","2022","COM","2020","249","6","255","2023-01-02"
"18289","2022","COM","2020","590","16","606","2023-01-02"
"18290","2022","COM","2020","593","10","603","2023-01-02"
"19001","2022","COM","2020","357","14","371","2023-01-02"
"19002","2022","COM","2020","397","8","405","2023-01-02"
"19003","2022","COM","2020","231","9","240","2023-01-02"
"19004","2022","COM","2020","740","10","750","2023-01-02"
"19005","2022","COM","2020","3996","100","4096","2023-01-02"
"19006","2022","COM","2020","105","0","105","2023-01-02"
"19007","2022","COM","2020","829","21","850","2023-01-02"
"19008","2022","COM","2020","207","4","211","2023-01-02"
"19009","2022","COM","2020","123","2","125","2023-01-02"
"19010","2022","COM","2020","2887","113","3000","2023-01-02"
"19011","2022","COM","2020","1145","11","1156","2023-01-02"
"19012","2022","COM","2020","213","4","217","2023-01-02"
"19013","2022","COM","2020","873","21","894","2023-01-02"
"19014","2022","COM","2020","224","6","230","2023-01-02"
"19015","2022","COM","2020","703","7","710","2023-01-02"
"19016","2022","COM","2020","303","9","312","2023-01-02"
"19017","2022","COM","2020","85","1","86","2023-01-02"
"19018","2022","COM","2020","156","4","160","2023-01-02"
"19019","2022","COM","2020","1290","15","1305","2023-01-02"
"19020","2022","COM","2020","112","8","120","2023-01-02"
"19021","2022","COM","2020","94","2","96","2023-01-02"
"19022","2022","COM","2020","221","5","226","2023-01-02"
"19023","2022","COM","2020","1250","19","1269","2023-01-02"
"19024","2022","COM","2020","592","23","615","2023-01-02"
"19025","2022","COM","2020","357","4","361","2023-01-02"
"19026","2022","COM","2020","253","4","257","2023-01-02"
"19027","2022","COM","2020","115","0","115","2023-01-02"
"19028","2022","COM","2020","2595","101","2696","2023-01-02"
"19029","2022","COM","2020","278","6","284","2023-01-02"
"19030","2022","COM","2020","966","15","981","2023-01-02"
"19031","2022","COM","2020","45910","1265","47175","2023-01-02"
"19033","2022","COM","2020","785","12","797","2023-01-02"
"19034","2022","COM","2020","212","11","223","2023-01-02"
"19035","2022","COM","2020","540","20","560","2023-01-02"
"19036","2022","COM","2020","1399","15","1414","2023-01-02"
"19037","2022","COM","2020","1168","28","1196","2023-01-02"
"19038","2022","COM","2020","1515","53","1568","2023-01-02"
"19039","2022","COM","2020","226","8","234","2023-01-02"
"19040","2022","COM","2020","151","5","156","2023-01-02"
"19041","2022","COM","2020","433","18","451","2023-01-02"
"19042","2022","COM","2020","629","13","642","2023-01-02"
"19043","2022","COM","2020","442","9","451","2023-01-02"
"19044","2022","COM","2020","273","3","276","2023-01-02"
"19045","2022","COM","2020","197","5","202","2023-01-02"
"19046","2022","COM","2020","112","1","113","2023-01-02"
"19047","2022","COM","2020","361","7","368","2023-01-02"
"19048","2022","COM","2020","351","12","363","2023-01-02"
"19049","2022","COM","2020","751","21","772","2023-01-02"
"19050","2022","COM","2020","414","8","422","2023-01-02"
"19051","2022","COM","2020","164","4","168","2023-01-02"
"19052","2022","COM","2020","50","1","51","2023-01-02"
"19053","2022","COM","2020","271","5","276","2023-01-02"
"19054","2022","COM","2020","211","4","215","2023-01-02"
"19055","2022","COM","2020","287","8","295","2023-01-02"
"19056","2022","COM","2020","405","11","416","2023-01-02"
"19057","2022","COM","2020","483","20","503","2023-01-02"
"19058","2022","COM","2020","355","10","365","2023-01-02"
"19059","2022","COM","2020","389","9","398","2023-01-02"
"19060","2022","COM","2020","677","15","692","2023-01-02"
"19061","2022","COM","2020","1308","12","1320","2023-01-02"
"19062","2022","COM","2020","1151","38","1189","2023-01-02"
"19063","2022","COM","2020","3010","98","3108","2023-01-02"
"19064","2022","COM","2020","71","2","73","2023-01-02"
"19065","2022","COM","2020","69","1","70","2023-01-02"
"19066","2022","COM","2020","1727","37","1764","2023-01-02"
"19067","2022","COM","2020","208","9","217","2023-01-02"
"19068","2022","COM","2020","708","7","715","2023-01-02"
"19069","2022","COM","2020","141","3","144","2023-01-02"
"19070","2022","COM","2020","323","12","335","2023-01-02"
"19071","2022","COM","2020","211","4","215","2023-01-02"
"19072","2022","COM","2020","2691","71","2762","2023-01-02"
"19073","2022","COM","2020","4274","734","5008","2023-01-02"
"19074","2022","COM","2020","53","0","53","2023-01-02"
"19075","2022","COM","2020","383","14","397","2023-01-02"
"19076","2022","COM","2020","411","9","420","2023-01-02"
"19077","2022","COM","2020","132","7","139","2023-01-02"
"19078","2022","COM","2020","412","8","420","2023-01-02"
"19079","2022","COM","2020","491","10","501","2023-01-02"
"19080","2022","COM","2020","691","11","702","2023-01-02"
"19081","2022","COM","2020","506","15","521","2023-01-02"
"19082","2022","COM","2020","1114","22","1136","2023-01-02"
"19083","2022","COM","2020","127","1","128","2023-01-02"
"19084","2022","COM","2020","260","12","272","2023-01-02"
"19085","2022","COM","2020","782","16","798","2023-01-02"
"19086","2022","COM","2020","334","6","340","2023-01-02"
"19087","2022","COM","2020","87","2","89","2023-01-02"
"19088","2022","COM","2020","52","1","53","2023-01-02"
"19089","2022","COM","2020","190","4","194","2023-01-02"
"19090","2022","COM","2020","95","2","97","2023-01-02"
"19091","2022","COM","2020","316","12","328","2023-01-02"
"19093","2022","COM","2020","960","34","994","2023-01-02"
"19094","2022","COM","2020","1125","26","1151","2023-01-02"
"19095","2022","COM","2020","131","1","132","2023-01-02"
"19096","2022","COM","2020","408","11","419","2023-01-02"
"19097","2022","COM","2020","135","1","136","2023-01-02"
"19098","2022","COM","2020","958","23","981","2023-01-02"
"19099","2022","COM","2020","222","10","232","2023-01-02"
"19100","2022","COM","2020","1128","25","1153","2023-01-02"
"19101","2022","COM","2020","1541","47","1588","2023-01-02"
"19102","2022","COM","2020","291","6","297","2023-01-02"
"19103","2022","COM","2020","68","2","70","2023-01-02"
"19104","2022","COM","2020","118","2","120","2023-01-02"
"19105","2022","COM","2020","479","13","492","2023-01-02"
"19106","2022","COM","2020","373","2","375","2023-01-02"
"19107","2022","COM","2020","1629","40","1669","2023-01-02"
"19108","2022","COM","2020","66","1","67","2023-01-02"
"19109","2022","COM","2020","224","7","231","2023-01-02"
"19110","2022","COM","2020","126","1","127","2023-01-02"
"19111","2022","COM","2020","102","2","104","2023-01-02"
"19112","2022","COM","2020","110","0","110","2023-01-02"
"19113","2022","COM","2020","648","37","685","2023-01-02"
"19114","2022","COM","2020","164","10","174","2023-01-02"
"19115","2022","COM","2020","300","8","308","2023-01-02"
"19116","2022","COM","2020","256","4","260","2023-01-02"
"19117","2022","COM","2020","682","23","705","2023-01-02"
"19118","2022","COM","2020","813","10","823","2023-01-02"
"19119","2022","COM","2020","150","0","150","2023-01-02"
"19120","2022","COM","2020","241","6","247","2023-01-02"
"19121","2022","COM","2020","2246","42","2288","2023-01-02"
"19122","2022","COM","2020","184","7","191","2023-01-02"
"19123","2022","COM","2020","8050","166","8216","2023-01-02"
"19124","2022","COM","2020","1479","21","1500","2023-01-02"
"19125","2022","COM","2020","807","14","821","2023-01-02"
"19126","2022","COM","2020","172","0","172","2023-01-02"
"19128","2022","COM","2020","309","6","315","2023-01-02"
"19129","2022","COM","2020","660","8","668","2023-01-02"
"19130","2022","COM","2020","441","11","452","2023-01-02"
"19131","2022","COM","2020","537","23","560","2023-01-02"
"19132","2022","COM","2020","133","1","134","2023-01-02"
"19133","2022","COM","2020","241","1","242","2023-01-02"
"19134","2022","COM","2020","697","18","715","2023-01-02"
"19135","2022","COM","2020","345","6","351","2023-01-02"
"19136","2022","COM","2020","2291","203","2494","2023-01-02"
"19137","2022","COM","2020","63","0","63","2023-01-02"
"19138","2022","COM","2020","1261","53","1314","2023-01-02"
"19139","2022","COM","2020","73","1","74","2023-01-02"
"19140","2022","COM","2020","633","19","652","2023-01-02"
"19141","2022","COM","2020","282","6","288","2023-01-02"
"19142","2022","COM","2020","111","1","112","2023-01-02"
"19143","2022","COM","2020","655","12","667","2023-01-02"
"19144","2022","COM","2020","239","5","244","2023-01-02"
"19145","2022","COM","2020","442","77","519","2023-01-02"
"19146","2022","COM","2020","2339","213","2552","2023-01-02"
"19147","2022","COM","2020","637","12","649","2023-01-02"
"19148","2022","COM","2020","1664","252","1916","2023-01-02"
"19149","2022","COM","2020","205","4","209","2023-01-02"
"19150","2022","COM","2020","355","16","371","2023-01-02"
"19151","2022","COM","2020","936","19","955","2023-01-02"
"19152","2022","COM","2020","449","7","456","2023-01-02"
"19153","2022","COM","2020","3662","81","3743","2023-01-02"
"19154","2022","COM","2020","321","9","330","2023-01-02"
"19155","2022","COM","2020","262","5","267","2023-01-02"
"19156","2022","COM","2020","165","2","167","2023-01-02"
"19157","2022","COM","2020","221","2","223","2023-01-02"
"19158","2022","COM","2020","166","4","170","2023-01-02"
"19159","2022","COM","2020","87","1","88","2023-01-02"
"19160","2022","COM","2020","194","2","196","2023-01-02"
"19161","2022","COM","2020","453","8","461","2023-01-02"
"19162","2022","COM","2020","1223","17","1240","2023-01-02"
"19163","2022","COM","2020","313","3","316","2023-01-02"
"19164","2022","COM","2020","830","11","841","2023-01-02"
"19165","2022","COM","2020","119","3","122","2023-01-02"
"19166","2022","COM","2020","92","0","92","2023-01-02"
"19167","2022","COM","2020","42","0","42","2023-01-02"
"19168","2022","COM","2020","81","4","85","2023-01-02"
"19169","2022","COM","2020","291","2","293","2023-01-02"
"19170","2022","COM","2020","222","10","232","2023-01-02"
"19171","2022","COM","2020","187","3","190","2023-01-02"
"19172","2022","COM","2020","114","5","119","2023-01-02"
"19173","2022","COM","2020","307","10","317","2023-01-02"
"19174","2022","COM","2020","127","1","128","2023-01-02"
"19175","2022","COM","2020","97","0","97","2023-01-02"
"19176","2022","COM","2020","1095","34","1129","2023-01-02"
"19177","2022","COM","2020","175","4","179","2023-01-02"
"19178","2022","COM","2020","981","23","1004","2023-01-02"
"19179","2022","COM","2020","201","6","207","2023-01-02"
"19180","2022","COM","2020","702","18","720","2023-01-02"
"19181","2022","COM","2020","419","7","426","2023-01-02"
"19182","2022","COM","2020","760","24","784","2023-01-02"
"19184","2022","COM","2020","127","4","131","2023-01-02"
"19186","2022","COM","2020","213","4","217","2023-01-02"
"19187","2022","COM","2020","412","5","417","2023-01-02"
"19188","2022","COM","2020","419","6","425","2023-01-02"
"19189","2022","COM","2020","41","1","42","2023-01-02"
"19190","2022","COM","2020","189","5","194","2023-01-02"
"19191","2022","COM","2020","644","13","657","2023-01-02"
"19192","2022","COM","2020","503","6","509","2023-01-02"
"19193","2022","COM","2020","172","5","177","2023-01-02"
"19194","2022","COM","2020","1342","42","1384","2023-01-02"
"19195","2022","COM","2020","386","6","392","2023-01-02"
"19196","2022","COM","2020","469","21","490","2023-01-02"
"19198","2022","COM","2020","106","0","106","2023-01-02"
"19199","2022","COM","2020","245","4","249","2023-01-02"
"19200","2022","COM","2020","88","8","96","2023-01-02"
"19201","2022","COM","2020","593","12","605","2023-01-02"
"19202","2022","COM","2020","2019","45","2064","2023-01-02"
"19203","2022","COM","2020","1773","92","1865","2023-01-02"
"19204","2022","COM","2020","266","3","269","2023-01-02"
"19205","2022","COM","2020","89","2","91","2023-01-02"
"19206","2022","COM","2020","92","1","93","2023-01-02"
"19207","2022","COM","2020","1136","33","1169","2023-01-02"
"19208","2022","COM","2020","182","3","185","2023-01-02"
"19209","2022","COM","2020","166","2","168","2023-01-02"
"19210","2022","COM","2020","65","0","65","2023-01-02"
"19211","2022","COM","2020","1009","21","1030","2023-01-02"
"19212","2022","COM","2020","104","6","110","2023-01-02"
"19213","2022","COM","2020","616","13","629","2023-01-02"
"19214","2022","COM","2020","445","3","448","2023-01-02"
"19215","2022","COM","2020","119","2","121","2023-01-02"
"19216","2022","COM","2020","244","5","249","2023-01-02"
"19217","2022","COM","2020","151","5","156","2023-01-02"
"19219","2022","COM","2020","55","0","55","2023-01-02"
"19220","2022","COM","2020","478","10","488","2023-01-02"
"19221","2022","COM","2020","93","2","95","2023-01-02"
"19222","2022","COM","2020","338","12","350","2023-01-02"
"19223","2022","COM","2020","264","2","266","2023-01-02"
"19225","2022","COM","2020","168","3","171","2023-01-02"
"19226","2022","COM","2020","122","1","123","2023-01-02"
"19227","2022","COM","2020","1319","36","1355","2023-01-02"
"19228","2022","COM","2020","66","0","66","2023-01-02"
"19229","2022","COM","2020","4808","98","4906","2023-01-02"
"19230","2022","COM","2020","390","8","398","2023-01-02"
"19231","2022","COM","2020","176","2","178","2023-01-02"
"19232","2022","COM","2020","78","2","80","2023-01-02"
"19233","2022","COM","2020","294","13","307","2023-01-02"
"19234","2022","COM","2020","482","6","488","2023-01-02"
"19235","2022","COM","2020","235","6","241","2023-01-02"
"19236","2022","COM","2020","475","10","485","2023-01-02"
"19237","2022","COM","2020","1047","21","1068","2023-01-02"
"19238","2022","COM","2020","221","8","229","2023-01-02"
"19239","2022","COM","2020","294","8","302","2023-01-02"
"19240","2022","COM","2020","288","14","302","2023-01-02"
"19241","2022","COM","2020","282","4","286","2023-01-02"
"19242","2022","COM","2020","455","18","473","2023-01-02"
"19243","2022","COM","2020","848","17","865","2023-01-02"
"19244","2022","COM","2020","82","1","83","2023-01-02"
"19245","2022","COM","2020","133","5","138","2023-01-02"
"19246","2022","COM","2020","1883","43","1926","2023-01-02"
"19247","2022","COM","2020","194","8","202","2023-01-02"
"19248","2022","COM","2020","694","13","707","2023-01-02"
"19249","2022","COM","2020","338","4","342","2023-01-02"
"19250","2022","COM","2020","675","6","681","2023-01-02"
"19251","2022","COM","2020","274","8","282","2023-01-02"
"19252","2022","COM","2020","853","16","869","2023-01-02"
"19253","2022","COM","2020","222","2","224","2023-01-02"
"19254","2022","COM","2020","202","1","203","2023-01-02"
"19255","2022","COM","2020","1789","37","1826","2023-01-02"
"19256","2022","COM","2020","345","6","351","2023-01-02"
"19257","2022","COM","2020","272","4","276","2023-01-02"
"19258","2022","COM","2020","595","9","604","2023-01-02"
"19259","2022","COM","2020","232","4","236","2023-01-02"
"19260","2022","COM","2020","218","7","225","2023-01-02"
"19261","2022","COM","2020","755","8","763","2023-01-02"
"19262","2022","COM","2020","145","16","161","2023-01-02"
"19263","2022","COM","2020","293","11","304","2023-01-02"
"19264","2022","COM","2020","508","4","512","2023-01-02"
"19265","2022","COM","2020","348","8","356","2023-01-02"
"19266","2022","COM","2020","103","4","107","2023-01-02"
"19268","2022","COM","2020","37","0","37","2023-01-02"
"19269","2022","COM","2020","1268","84","1352","2023-01-02"
"19270","2022","COM","2020","545","6","551","2023-01-02"
"19271","2022","COM","2020","250","5","255","2023-01-02"
"19272","2022","COM","2020","14314","659","14973","2023-01-02"
"19273","2022","COM","2020","809","20","829","2023-01-02"
"19274","2022","COM","2020","4234","120","4354","2023-01-02"
"19275","2022","COM","2020","9162","368","9530","2023-01-02"
"19276","2022","COM","2020","2787","59","2846","2023-01-02"
"19277","2022","COM","2020","146","5","151","2023-01-02"
"19278","2022","COM","2020","2495","43","2538","2023-01-02"
"19279","2022","COM","2020","396","10","406","2023-01-02"
"19280","2022","COM","2020","179","4","183","2023-01-02"
"19281","2022","COM","2020","71","7","78","2023-01-02"
"19283","2022","COM","2020","77","1","78","2023-01-02"
"19284","2022","COM","2020","84","3","87","2023-01-02"
"19285","2022","COM","2020","1285","32","1317","2023-01-02"
"19286","2022","COM","2020","533","9","542","2023-01-02"
"19287","2022","COM","2020","272","6","278","2023-01-02"
"19288","2022","COM","2020","1235","169","1404","2023-01-02"
"19289","2022","COM","2020","678","21","699","2023-01-02"
"21001","2022","COM","2020","457","52","509","2023-01-02"
"21002","2022","COM","2020","264","3","267","2023-01-02"
"21003","2022","COM","2020","1591","29","1620","2023-01-02"
"21004","2022","COM","2020","266","6","272","2023-01-02"
"21005","2022","COM","2020","1467","16","1483","2023-01-02"
"21006","2022","COM","2020","172","1","173","2023-01-02"
"21007","2022","COM","2020","219","18","237","2023-01-02"
"21008","2022","COM","2020","572","7","579","2023-01-02"
"21009","2022","COM","2020","178","1","179","2023-01-02"
"21010","2022","COM","2020","134","6","140","2023-01-02"
"21011","2022","COM","2020","83","0","83","2023-01-02"
"21012","2022","COM","2020","343","13","356","2023-01-02"
"21013","2022","COM","2020","449","8","457","2023-01-02"
"21014","2022","COM","2020","62","0","62","2023-01-02"
"21015","2022","COM","2020","90","0","90","2023-01-02"
"21016","2022","COM","2020","987","17","1004","2023-01-02"
"21017","2022","COM","2020","505","18","523","2023-01-02"
"21018","2022","COM","2020","53","1","54","2023-01-02"
"21020","2022","COM","2020","222","8","230","2023-01-02"
"21021","2022","COM","2020","2608","48","2656","2023-01-02"
"21022","2022","COM","2020","538","11","549","2023-01-02"
"21023","2022","COM","2020","1377","30","1407","2023-01-02"
"21024","2022","COM","2020","113","0","113","2023-01-02"
"21025","2022","COM","2020","66","2","68","2023-01-02"
"21026","2022","COM","2020","190","8","198","2023-01-02"
"21027","2022","COM","2020","1315","23","1338","2023-01-02"
"21028","2022","COM","2020","782","10","792","2023-01-02"
"21029","2022","COM","2020","77","1","78","2023-01-02"
"21030","2022","COM","2020","88","1","89","2023-01-02"
"21031","2022","COM","2020","535","5","540","2023-01-02"
"21032","2022","COM","2020","167","5","172","2023-01-02"
"21033","2022","COM","2020","157","2","159","2023-01-02"
"21034","2022","COM","2020","133","1","134","2023-01-02"
"21035","2022","COM","2020","336","4","340","2023-01-02"
"21036","2022","COM","2020","79","3","82","2023-01-02"
"21037","2022","COM","2020","295","12","307","2023-01-02"
"21038","2022","COM","2020","7621","88","7709","2023-01-02"
"21039","2022","COM","2020","37","0","37","2023-01-02"
"21040","2022","COM","2020","98","2","100","2023-01-02"
"21041","2022","COM","2020","188","3","191","2023-01-02"
"21042","2022","COM","2020","159","4","163","2023-01-02"
"21043","2022","COM","2020","210","9","219","2023-01-02"
"21044","2022","COM","2020","100","1","101","2023-01-02"
"21045","2022","COM","2020","208","8","216","2023-01-02"
"21046","2022","COM","2020","71","1","72","2023-01-02"
"21047","2022","COM","2020","69","1","70","2023-01-02"
"21048","2022","COM","2020","655","10","665","2023-01-02"
"21049","2022","COM","2020","43","2","45","2023-01-02"
"21050","2022","COM","2020","209","6","215","2023-01-02"
"21051","2022","COM","2020","87","3","90","2023-01-02"
"21052","2022","COM","2020","24","4","28","2023-01-02"
"21053","2022","COM","2020","200","3","203","2023-01-02"
"21054","2022","COM","2020","20122","686","20808","2023-01-02"
"21055","2022","COM","2020","14","0","14","2023-01-02"
"21056","2022","COM","2020","886","13","899","2023-01-02"
"21057","2022","COM","2020","352","4","356","2023-01-02"
"21058","2022","COM","2020","245","5","250","2023-01-02"
"21059","2022","COM","2020","895","26","921","2023-01-02"
"21060","2022","COM","2020","1604","25","1629","2023-01-02"
"21061","2022","COM","2020","67","2","69","2023-01-02"
"21062","2022","COM","2020","215","9","224","2023-01-02"
"21063","2022","COM","2020","89","6","95","2023-01-02"
"21064","2022","COM","2020","107","3","110","2023-01-02"
"21065","2022","COM","2020","124","4","128","2023-01-02"
"21066","2022","COM","2020","51","1","52","2023-01-02"
"21067","2022","COM","2020","686","9","695","2023-01-02"
"21068","2022","COM","2020","101","5","106","2023-01-02"
"21069","2022","COM","2020","122","1","123","2023-01-02"
"21070","2022","COM","2020","136","4","140","2023-01-02"
"21071","2022","COM","2020","711","18","729","2023-01-02"
"21072","2022","COM","2020","188","4","192","2023-01-02"
"21074","2022","COM","2020","251","4","255","2023-01-02"
"21075","2022","COM","2020","69","1","70","2023-01-02"
"21076","2022","COM","2020","845","8","853","2023-01-02"
"21077","2022","COM","2020","130","2","132","2023-01-02"
"21078","2022","COM","2020","73","5","78","2023-01-02"
"21079","2022","COM","2020","128","2","130","2023-01-02"
"21080","2022","COM","2020","639","14","653","2023-01-02"
"21081","2022","COM","2020","127","1","128","2023-01-02"
"21082","2022","COM","2020","58","2","60","2023-01-02"
"21083","2022","COM","2020","123","1","124","2023-01-02"
"21084","2022","COM","2020","62","1","63","2023-01-02"
"21085","2022","COM","2020","141","6","147","2023-01-02"
"21086","2022","COM","2020","1243","28","1271","2023-01-02"
"21087","2022","COM","2020","815","11","826","2023-01-02"
"21088","2022","COM","2020","278","7","285","2023-01-02"
"21089","2022","COM","2020","435","7","442","2023-01-02"
"21090","2022","COM","2020","61","3","64","2023-01-02"
"21091","2022","COM","2020","47","0","47","2023-01-02"
"21092","2022","COM","2020","228","5","233","2023-01-02"
"21093","2022","COM","2020","150","4","154","2023-01-02"
"21094","2022","COM","2020","403","5","408","2023-01-02"
"21095","2022","COM","2020","47","2","49","2023-01-02"
"21096","2022","COM","2020","106","1","107","2023-01-02"
"21097","2022","COM","2020","39","2","41","2023-01-02"
"21098","2022","COM","2020","126","2","128","2023-01-02"
"21099","2022","COM","2020","305","6","311","2023-01-02"
"21100","2022","COM","2020","34","0","34","2023-01-02"
"21101","2022","COM","2020","165","4","169","2023-01-02"
"21102","2022","COM","2020","140","3","143","2023-01-02"
"21103","2022","COM","2020","2378","28","2406","2023-01-02"
"21104","2022","COM","2020","42","0","42","2023-01-02"
"21105","2022","COM","2020","1134","13","1147","2023-01-02"
"21106","2022","COM","2020","925","12","937","2023-01-02"
"21107","2022","COM","2020","905","24","929","2023-01-02"
"21108","2022","COM","2020","111","1","112","2023-01-02"
"21109","2022","COM","2020","216","7","223","2023-01-02"
"21110","2022","COM","2020","660","130","790","2023-01-02"
"21111","2022","COM","2020","319","3","322","2023-01-02"
"21112","2022","COM","2020","407","9","416","2023-01-02"
"21113","2022","COM","2020","194","1","195","2023-01-02"
"21114","2022","COM","2020","157","1","158","2023-01-02"
"21115","2022","COM","2020","365","6","371","2023-01-02"
"21116","2022","COM","2020","134","0","134","2023-01-02"
"21117","2022","COM","2020","48","2","50","2023-01-02"
"21118","2022","COM","2020","25","0","25","2023-01-02"
"21119","2022","COM","2020","44","0","44","2023-01-02"
"21120","2022","COM","2020","160","2","162","2023-01-02"
"21121","2022","COM","2020","77","1","78","2023-01-02"
"21122","2022","COM","2020","308","8","316","2023-01-02"
"21123","2022","COM","2020","33","5","38","2023-01-02"
"21124","2022","COM","2020","177","6","183","2023-01-02"
"21125","2022","COM","2020","218","8","226","2023-01-02"
"21126","2022","COM","2020","611","7","618","2023-01-02"
"21127","2022","COM","2020","517","7","524","2023-01-02"
"21128","2022","COM","2020","253","8","261","2023-01-02"
"21129","2022","COM","2020","21","0","21","2023-01-02"
"21130","2022","COM","2020","398","4","402","2023-01-02"
"21131","2022","COM","2020","467","63","530","2023-01-02"
"21132","2022","COM","2020","393","6","399","2023-01-02"
"21133","2022","COM","2020","285","2","287","2023-01-02"
"21134","2022","COM","2020","241","8","249","2023-01-02"
"21135","2022","COM","2020","309","9","318","2023-01-02"
"21136","2022","COM","2020","26","0","26","2023-01-02"
"21137","2022","COM","2020","102","1","103","2023-01-02"
"21138","2022","COM","2020","593","8","601","2023-01-02"
"21139","2022","COM","2020","222","5","227","2023-01-02"
"21140","2022","COM","2020","76","1","77","2023-01-02"
"21141","2022","COM","2020","36","1","37","2023-01-02"
"21142","2022","COM","2020","214","3","217","2023-01-02"
"21143","2022","COM","2020","61","3","64","2023-01-02"
"21144","2022","COM","2020","38","1","39","2023-01-02"
"21145","2022","COM","2020","37","1","38","2023-01-02"
"21146","2022","COM","2020","123","3","126","2023-01-02"
"21147","2022","COM","2020","35","1","36","2023-01-02"
"21148","2022","COM","2020","341","4","345","2023-01-02"
"21149","2022","COM","2020","137","3","140","2023-01-02"
"21150","2022","COM","2020","288","4","292","2023-01-02"
"21151","2022","COM","2020","92","5","97","2023-01-02"
"21152","2022","COM","2020","80","2","82","2023-01-02"
"21153","2022","COM","2020","155","6","161","2023-01-02"
"21154","2022","COM","2020","5352","338","5690","2023-01-02"
"21155","2022","COM","2020","39","5","44","2023-01-02"
"21156","2022","COM","2020","49","0","49","2023-01-02"
"21157","2022","COM","2020","18","1","19","2023-01-02"
"21158","2022","COM","2020","180","5","185","2023-01-02"
"21159","2022","COM","2020","98","3","101","2023-01-02"
"21160","2022","COM","2020","101","1","102","2023-01-02"
"21161","2022","COM","2020","78","5","83","2023-01-02"
"21162","2022","COM","2020","482","8","490","2023-01-02"
"21163","2022","COM","2020","189","5","194","2023-01-02"
"21164","2022","COM","2020","143","3","146","2023-01-02"
"21165","2022","COM","2020","70","1","71","2023-01-02"
"21166","2022","COM","2020","14323","168","14491","2023-01-02"
"21167","2022","COM","2020","124","4","128","2023-01-02"
"21168","2022","COM","2020","37","0","37","2023-01-02"
"21169","2022","COM","2020","166","5","171","2023-01-02"
"21170","2022","COM","2020","391","4","395","2023-01-02"
"21171","2022","COM","2020","11055","206","11261","2023-01-02"
"21172","2022","COM","2020","294","4","298","2023-01-02"
"21173","2022","COM","2020","625","23","648","2023-01-02"
"21175","2022","COM","2020","186","1","187","2023-01-02"
"21176","2022","COM","2020","124","2","126","2023-01-02"
"21177","2022","COM","2020","177","1","178","2023-01-02"
"21178","2022","COM","2020","313","10","323","2023-01-02"
"21179","2022","COM","2020","905","11","916","2023-01-02"
"21180","2022","COM","2020","155","4","159","2023-01-02"
"21181","2022","COM","2020","134","2","136","2023-01-02"
"21182","2022","COM","2020","95","1","96","2023-01-02"
"21183","2022","COM","2020","1064","13","1077","2023-01-02"
"21184","2022","COM","2020","68","1","69","2023-01-02"
"21185","2022","COM","2020","520","20","540","2023-01-02"
"21186","2022","COM","2020","607","17","624","2023-01-02"
"21187","2022","COM","2020","120","5","125","2023-01-02"
"21189","2022","COM","2020","433","9","442","2023-01-02"
"21190","2022","COM","2020","441","19","460","2023-01-02"
"21191","2022","COM","2020","811","26","837","2023-01-02"
"21192","2022","COM","2020","632","10","642","2023-01-02"
"21193","2022","COM","2020","365","16","381","2023-01-02"
"21194","2022","COM","2020","951","13","964","2023-01-02"
"21195","2022","COM","2020","216","4","220","2023-01-02"
"21196","2022","COM","2020","975","16","991","2023-01-02"
"21197","2022","COM","2020","34","0","34","2023-01-02"
"21198","2022","COM","2020","251","10","261","2023-01-02"
"21199","2022","COM","2020","150","1","151","2023-01-02"
"21200","2022","COM","2020","1104","25","1129","2023-01-02"
"21201","2022","COM","2020","240","5","245","2023-01-02"
"21202","2022","COM","2020","145","1","146","2023-01-02"
"21203","2022","COM","2020","130","1","131","2023-01-02"
"21204","2022","COM","2020","87","1","88","2023-01-02"
"21205","2022","COM","2020","240","6","246","2023-01-02"
"21207","2022","COM","2020","76","4","80","2023-01-02"
"21208","2022","COM","2020","162","4","166","2023-01-02"
"21209","2022","COM","2020","1920","41","1961","2023-01-02"
"21210","2022","COM","2020","528","15","543","2023-01-02"
"21211","2022","COM","2020","128","2","130","2023-01-02"
"21212","2022","COM","2020","320","5","325","2023-01-02"
"21214","2022","COM","2020","168","4","172","2023-01-02"
"21215","2022","COM","2020","182","5","187","2023-01-02"
"21216","2022","COM","2020","107","2","109","2023-01-02"
"21217","2022","COM","2020","132","4","136","2023-01-02"
"21218","2022","COM","2020","116","0","116","2023-01-02"
"21219","2022","COM","2020","141","0","141","2023-01-02"
"21220","2022","COM","2020","143","3","146","2023-01-02"
"21221","2022","COM","2020","39","2","41","2023-01-02"
"21222","2022","COM","2020","119","3","122","2023-01-02"
"21223","2022","COM","2020","1541","34","1575","2023-01-02"
"21224","2022","COM","2020","61","4","65","2023-01-02"
"21225","2022","COM","2020","130","2","132","2023-01-02"
"21226","2022","COM","2020","338","11","349","2023-01-02"
"21227","2022","COM","2020","500","8","508","2023-01-02"
"21228","2022","COM","2020","142","0","142","2023-01-02"
"21229","2022","COM","2020","95","2","97","2023-01-02"
"21230","2022","COM","2020","378","8","386","2023-01-02"
"21231","2022","COM","2020","159106","3348","162454","2023-01-02"
"21232","2022","COM","2020","201","5","206","2023-01-02"
"21233","2022","COM","2020","200","1","201","2023-01-02"
"21234","2022","COM","2020","63","0","63","2023-01-02"
"21235","2022","COM","2020","51","3","54","2023-01-02"
"21236","2022","COM","2020","252","6","258","2023-01-02"
"21237","2022","COM","2020","95","3","98","2023-01-02"
"21238","2022","COM","2020","141","2","143","2023-01-02"
"21239","2022","COM","2020","776","9","785","2023-01-02"
"21240","2022","COM","2020","322","2","324","2023-01-02"
"21241","2022","COM","2020","296","16","312","2023-01-02"
"21242","2022","COM","2020","300","7","307","2023-01-02"
"21243","2022","COM","2020","75","2","77","2023-01-02"
"21244","2022","COM","2020","69","0","69","2023-01-02"
"21245","2022","COM","2020","320","3","323","2023-01-02"
"21246","2022","COM","2020","174","4","178","2023-01-02"
"21247","2022","COM","2020","769","7","776","2023-01-02"
"21248","2022","COM","2020","59","1","60","2023-01-02"
"21249","2022","COM","2020","666","22","688","2023-01-02"
"21250","2022","COM","2020","83","2","85","2023-01-02"
"21251","2022","COM","2020","284","27","311","2023-01-02"
"21252","2022","COM","2020","76","4","80","2023-01-02"
"21253","2022","COM","2020","129","4","133","2023-01-02"
"21254","2022","COM","2020","205","10","215","2023-01-02"
"21255","2022","COM","2020","348","4","352","2023-01-02"
"21256","2022","COM","2020","314","7","321","2023-01-02"
"21257","2022","COM","2020","68","2","70","2023-01-02"
"21258","2022","COM","2020","219","4","223","2023-01-02"
"21259","2022","COM","2020","280","10","290","2023-01-02"
"21260","2022","COM","2020","150","4","154","2023-01-02"
"21261","2022","COM","2020","619","11","630","2023-01-02"
"21262","2022","COM","2020","30","0","30","2023-01-02"
"21263","2022","COM","2020","1673","40","1713","2023-01-02"
"21264","2022","COM","2020","41","0","41","2023-01-02"
"21265","2022","COM","2020","748","21","769","2023-01-02"
"21266","2022","COM","2020","198","2","200","2023-01-02"
"21267","2022","COM","2020","501","13","514","2023-01-02"
"21268","2022","COM","2020","191","3","194","2023-01-02"
"21269","2022","COM","2020","450","9","459","2023-01-02"
"21270","2022","COM","2020","215","4","219","2023-01-02"
"21271","2022","COM","2020","274","3","277","2023-01-02"
"21272","2022","COM","2020","267","5","272","2023-01-02"
"21273","2022","COM","2020","1442","18","1460","2023-01-02"
"21274","2022","COM","2020","164","3","167","2023-01-02"
"21275","2022","COM","2020","132","3","135","2023-01-02"
"21276","2022","COM","2020","117","4","121","2023-01-02"
"21277","2022","COM","2020","883","19","902","2023-01-02"
"21278","2022","COM","2020","8756","201","8957","2023-01-02"
"21279","2022","COM","2020","25","0","25","2023-01-02"
"21280","2022","COM","2020","142","2","144","2023-01-02"
"21281","2022","COM","2020","170","1","171","2023-01-02"
"21282","2022","COM","2020","105","2","107","2023-01-02"
"21283","2022","COM","2020","66","1","67","2023-01-02"
"21284","2022","COM","2020","280","8","288","2023-01-02"
"21285","2022","COM","2020","501","6","507","2023-01-02"
"21286","2022","COM","2020","88","1","89","2023-01-02"
"21287","2022","COM","2020","155","7","162","2023-01-02"
"21288","2022","COM","2020","162","1","163","2023-01-02"
"21289","2022","COM","2020","116","8","124","2023-01-02"
"21290","2022","COM","2020","923","15","938","2023-01-02"
"21291","2022","COM","2020","367","10","377","2023-01-02"
"21292","2022","COM","2020","5190","44","5234","2023-01-02"
"21293","2022","COM","2020","119","0","119","2023-01-02"
"21294","2022","COM","2020","435","9","444","2023-01-02"
"21295","2022","COM","2020","3115","44","3159","2023-01-02"
"21296","2022","COM","2020","176","0","176","2023-01-02"
"21297","2022","COM","2020","729","5","734","2023-01-02"
"21298","2022","COM","2020","105","3","108","2023-01-02"
"21299","2022","COM","2020","88","1","89","2023-01-02"
"21300","2022","COM","2020","354","9","363","2023-01-02"
"21301","2022","COM","2020","270","3","273","2023-01-02"
"21302","2022","COM","2020","122","2","124","2023-01-02"
"21303","2022","COM","2020","12","0","12","2023-01-02"
"21304","2022","COM","2020","257","9","266","2023-01-02"
"21305","2022","COM","2020","193","1","194","2023-01-02"
"21306","2022","COM","2020","212","4","216","2023-01-02"
"21307","2022","COM","2020","144","4","148","2023-01-02"
"21308","2022","COM","2020","200","12","212","2023-01-02"
"21309","2022","COM","2020","86","4","90","2023-01-02"
"21310","2022","COM","2020","113","2","115","2023-01-02"
"21311","2022","COM","2020","71","2","73","2023-01-02"
"21312","2022","COM","2020","26","3","29","2023-01-02"
"21313","2022","COM","2020","46","0","46","2023-01-02"
"21314","2022","COM","2020","79","2","81","2023-01-02"
"21315","2022","COM","2020","1228","17","1245","2023-01-02"
"21316","2022","COM","2020","325","4","329","2023-01-02"
"21317","2022","COM","2020","4360","76","4436","2023-01-02"
"21319","2022","COM","2020","905","14","919","2023-01-02"
"21320","2022","COM","2020","790","13","803","2023-01-02"
"21321","2022","COM","2020","75","2","77","2023-01-02"
"21322","2022","COM","2020","308","13","321","2023-01-02"
"21323","2022","COM","2020","143","2","145","2023-01-02"
"21324","2022","COM","2020","52","1","53","2023-01-02"
"21325","2022","COM","2020","184","2","186","2023-01-02"
"21326","2022","COM","2020","72","4","76","2023-01-02"
"21327","2022","COM","2020","252","4","256","2023-01-02"
"21328","2022","COM","2020","49","0","49","2023-01-02"
"21329","2022","COM","2020","39","2","41","2023-01-02"
"21330","2022","COM","2020","376","3","379","2023-01-02"
"21331","2022","COM","2020","333","4","337","2023-01-02"
"21332","2022","COM","2020","1002","12","1014","2023-01-02"
"21333","2022","COM","2020","225","5","230","2023-01-02"
"21334","2022","COM","2020","488","12","500","2023-01-02"
"21335","2022","COM","2020","112","3","115","2023-01-02"
"21336","2022","COM","2020","664","11","675","2023-01-02"
"21337","2022","COM","2020","1359","17","1376","2023-01-02"
"21338","2022","COM","2020","157","8","165","2023-01-02"
"21339","2022","COM","2020","511","19","530","2023-01-02"
"21340","2022","COM","2020","251","5","256","2023-01-02"
"21341","2022","COM","2020","103","4","107","2023-01-02"
"21342","2022","COM","2020","433","8","441","2023-01-02"
"21343","2022","COM","2020","95","2","97","2023-01-02"
"21344","2022","COM","2020","222","5","227","2023-01-02"
"21345","2022","COM","2020","193","1","194","2023-01-02"
"21346","2022","COM","2020","298","3","301","2023-01-02"
"21347","2022","COM","2020","342","17","359","2023-01-02"
"21348","2022","COM","2020","103","1","104","2023-01-02"
"21349","2022","COM","2020","480","5","485","2023-01-02"
"21350","2022","COM","2020","55","1","56","2023-01-02"
"21351","2022","COM","2020","1163","121","1284","2023-01-02"
"21352","2022","COM","2020","1143","23","1166","2023-01-02"
"21353","2022","COM","2020","1220","24","1244","2023-01-02"
"21354","2022","COM","2020","55","0","55","2023-01-02"
"21355","2022","COM","2020","8631","131","8762","2023-01-02"
"21356","2022","COM","2020","1635","18","1653","2023-01-02"
"21357","2022","COM","2020","116","2","118","2023-01-02"
"21358","2022","COM","2020","187","4","191","2023-01-02"
"21359","2022","COM","2020","57","3","60","2023-01-02"
"21360","2022","COM","2020","119","3","122","2023-01-02"
"21361","2022","COM","2020","512","11","523","2023-01-02"
"21362","2022","COM","2020","132","3","135","2023-01-02"
"21363","2022","COM","2020","318","4","322","2023-01-02"
"21364","2022","COM","2020","81","3","84","2023-01-02"
"21365","2022","COM","2020","78","0","78","2023-01-02"
"21366","2022","COM","2020","218","6","224","2023-01-02"
"21367","2022","COM","2020","260","5","265","2023-01-02"
"21368","2022","COM","2020","242","12","254","2023-01-02"
"21369","2022","COM","2020","315","4","319","2023-01-02"
"21370","2022","COM","2020","894","19","913","2023-01-02"
"21371","2022","COM","2020","804","20","824","2023-01-02"
"21372","2022","COM","2020","82","5","87","2023-01-02"
"21373","2022","COM","2020","784","15","799","2023-01-02"
"21374","2022","COM","2020","180","6","186","2023-01-02"
"21375","2022","COM","2020","195","5","200","2023-01-02"
"21376","2022","COM","2020","102","1","103","2023-01-02"
"21377","2022","COM","2020","46","0","46","2023-01-02"
"21378","2022","COM","2020","90","2","92","2023-01-02"
"21379","2022","COM","2020","155","1","156","2023-01-02"
"21380","2022","COM","2020","55","2","57","2023-01-02"
"21381","2022","COM","2020","90","4","94","2023-01-02"
"21382","2022","COM","2020","188","3","191","2023-01-02"
"21383","2022","COM","2020","1713","19","1732","2023-01-02"
"21384","2022","COM","2020","65","1","66","2023-01-02"
"21385","2022","COM","2020","326","7","333","2023-01-02"
"21386","2022","COM","2020","326","12","338","2023-01-02"
"21387","2022","COM","2020","218","5","223","2023-01-02"
"21388","2022","COM","2020","597","11","608","2023-01-02"
"21389","2022","COM","2020","203","1","204","2023-01-02"
"21390","2022","COM","2020","5311","74","5385","2023-01-02"
"21391","2022","COM","2020","841","10","851","2023-01-02"
"21392","2022","COM","2020","60","2","62","2023-01-02"
"21393","2022","COM","2020","159","4","163","2023-01-02"
"21394","2022","COM","2020","156","5","161","2023-01-02"
"21395","2022","COM","2020","92","1","93","2023-01-02"
"21396","2022","COM","2020","68","2","70","2023-01-02"
"21397","2022","COM","2020","177","3","180","2023-01-02"
"21398","2022","COM","2020","362","8","370","2023-01-02"
"21399","2022","COM","2020","220","2","222","2023-01-02"
"21400","2022","COM","2020","46","0","46","2023-01-02"
"21401","2022","COM","2020","320","10","330","2023-01-02"
"21402","2022","COM","2020","12","0","12","2023-01-02"
"21403","2022","COM","2020","86","1","87","2023-01-02"
"21404","2022","COM","2020","409","9","418","2023-01-02"
"21405","2022","COM","2020","804","22","826","2023-01-02"
"21406","2022","COM","2020","254","2","256","2023-01-02"
"21407","2022","COM","2020","240","9","249","2023-01-02"
"21408","2022","COM","2020","1705","29","1734","2023-01-02"
"21409","2022","COM","2020","448","7","455","2023-01-02"
"21410","2022","COM","2020","29","2","31","2023-01-02"
"21411","2022","COM","2020","570","18","588","2023-01-02"
"21412","2022","COM","2020","1404","45","1449","2023-01-02"
"21413","2022","COM","2020","405","15","420","2023-01-02"
"21414","2022","COM","2020","319","9","328","2023-01-02"
"21415","2022","COM","2020","181","7","188","2023-01-02"
"21416","2022","COM","2020","1972","36","2008","2023-01-02"
"21417","2022","COM","2020","107","0","107","2023-01-02"
"21418","2022","COM","2020","58","4","62","2023-01-02"
"21419","2022","COM","2020","264","5","269","2023-01-02"
"21420","2022","COM","2020","160","4","164","2023-01-02"
"21421","2022","COM","2020","237","3","240","2023-01-02"
"21422","2022","COM","2020","130","4","134","2023-01-02"
"21423","2022","COM","2020","756","19","775","2023-01-02"
"21424","2022","COM","2020","112","2","114","2023-01-02"
"21425","2022","COM","2020","4831","134","4965","2023-01-02"
"21426","2022","COM","2020","208","4","212","2023-01-02"
"21427","2022","COM","2020","192","5","197","2023-01-02"
"21428","2022","COM","2020","159","2","161","2023-01-02"
"21429","2022","COM","2020","295","6","301","2023-01-02"
"21430","2022","COM","2020","85","5","90","2023-01-02"
"21431","2022","COM","2020","150","4","154","2023-01-02"
"21432","2022","COM","2020","250","4","254","2023-01-02"
"21433","2022","COM","2020","383","7","390","2023-01-02"
"21434","2022","COM","2020","193","2","195","2023-01-02"
"21435","2022","COM","2020","298","6","304","2023-01-02"
"21436","2022","COM","2020","150","1","151","2023-01-02"
"21437","2022","COM","2020","244","5","249","2023-01-02"
"21438","2022","COM","2020","73","2","75","2023-01-02"
"21439","2022","COM","2020","91","0","91","2023-01-02"
"21440","2022","COM","2020","198","5","203","2023-01-02"
"21441","2022","COM","2020","236","7","243","2023-01-02"
"21442","2022","COM","2020","669","10","679","2023-01-02"
"21444","2022","COM","2020","68","0","68","2023-01-02"
"21445","2022","COM","2020","147","2","149","2023-01-02"
"21446","2022","COM","2020","260","5","265","2023-01-02"
"21447","2022","COM","2020","84","0","84","2023-01-02"
"21448","2022","COM","2020","90","2","92","2023-01-02"
"21449","2022","COM","2020","178","6","184","2023-01-02"
"21450","2022","COM","2020","166","4","170","2023-01-02"
"21451","2022","COM","2020","77","1","78","2023-01-02"
"21452","2022","COM","2020","3104","37","3141","2023-01-02"
"21454","2022","COM","2020","109","0","109","2023-01-02"
"21455","2022","COM","2020","202","3","205","2023-01-02"
"21456","2022","COM","2020","153","8","161","2023-01-02"
"21457","2022","COM","2020","73","5","78","2023-01-02"
"21458","2022","COM","2020","1150","28","1178","2023-01-02"
"21459","2022","COM","2020","231","5","236","2023-01-02"
"21460","2022","COM","2020","63","1","64","2023-01-02"
"21461","2022","COM","2020","1426","22","1448","2023-01-02"
"21462","2022","COM","2020","948","18","966","2023-01-02"
"21463","2022","COM","2020","58","1","59","2023-01-02"
"21464","2022","COM","2020","5332","89","5421","2023-01-02"
"21465","2022","COM","2020","78","1","79","2023-01-02"
"21466","2022","COM","2020","42","4","46","2023-01-02"
"21467","2022","COM","2020","126","4","130","2023-01-02"
"21468","2022","COM","2020","86","1","87","2023-01-02"
"21469","2022","COM","2020","455","13","468","2023-01-02"
"21470","2022","COM","2020","52","4","56","2023-01-02"
"21471","2022","COM","2020","14","0","14","2023-01-02"
"21472","2022","COM","2020","172","1","173","2023-01-02"
"21473","2022","COM","2020","1616","11","1627","2023-01-02"
"21474","2022","COM","2020","414","11","425","2023-01-02"
"21475","2022","COM","2020","500","10","510","2023-01-02"
"21476","2022","COM","2020","164","5","169","2023-01-02"
"21477","2022","COM","2020","82","2","84","2023-01-02"
"21478","2022","COM","2020","282","5","287","2023-01-02"
"21479","2022","COM","2020","83","1","84","2023-01-02"
"21480","2022","COM","2020","237","9","246","2023-01-02"
"21481","2022","COM","2020","2178","23","2201","2023-01-02"
"21482","2022","COM","2020","626","15","641","2023-01-02"
"21483","2022","COM","2020","299","5","304","2023-01-02"
"21484","2022","COM","2020","64","5","69","2023-01-02"
"21485","2022","COM","2020","2535","46","2581","2023-01-02"
"21487","2022","COM","2020","418","6","424","2023-01-02"
"21488","2022","COM","2020","192","2","194","2023-01-02"
"21489","2022","COM","2020","53","4","57","2023-01-02"
"21490","2022","COM","2020","156","6","162","2023-01-02"
"21491","2022","COM","2020","70","1","71","2023-01-02"
"21492","2022","COM","2020","449","12","461","2023-01-02"
"21493","2022","COM","2020","568","8","576","2023-01-02"
"21494","2022","COM","2020","84","0","84","2023-01-02"
"21495","2022","COM","2020","159","1","160","2023-01-02"
"21496","2022","COM","2020","1297","16","1313","2023-01-02"
"21497","2022","COM","2020","172","15","187","2023-01-02"
"21498","2022","COM","2020","49","2","51","2023-01-02"
"21499","2022","COM","2020","201","5","206","2023-01-02"
"21500","2022","COM","2020","558","9","567","2023-01-02"
"21501","2022","COM","2020","1537","119","1656","2023-01-02"
"21502","2022","COM","2020","607","7","614","2023-01-02"
"21503","2022","COM","2020","135","4","139","2023-01-02"
"21504","2022","COM","2020","90","3","93","2023-01-02"
"21505","2022","COM","2020","709","10","719","2023-01-02"
"21506","2022","COM","2020","362","5","367","2023-01-02"
"21508","2022","COM","2020","462","9","471","2023-01-02"
"21510","2022","COM","2020","153","1","154","2023-01-02"
"21511","2022","COM","2020","131","4","135","2023-01-02"
"21512","2022","COM","2020","378","10","388","2023-01-02"
"21514","2022","COM","2020","102","3","105","2023-01-02"
"21515","2022","COM","2020","8936","351","9287","2023-01-02"
"21516","2022","COM","2020","79","4","83","2023-01-02"
"21517","2022","COM","2020","505","14","519","2023-01-02"
"21518","2022","COM","2020","200","2","202","2023-01-02"
"21519","2022","COM","2020","345","5","350","2023-01-02"
"21520","2022","COM","2020","152","0","152","2023-01-02"
"21521","2022","COM","2020","899","11","910","2023-01-02"
"21522","2022","COM","2020","459","9","468","2023-01-02"
"21523","2022","COM","2020","158","2","160","2023-01-02"
"21524","2022","COM","2020","91","0","91","2023-01-02"
"21525","2022","COM","2020","899","13","912","2023-01-02"
"21526","2022","COM","2020","42","0","42","2023-01-02"
"21527","2022","COM","2020","281","9","290","2023-01-02"
"21528","2022","COM","2020","138","2","140","2023-01-02"
"21529","2022","COM","2020","50","1","51","2023-01-02"
"21530","2022","COM","2020","145","1","146","2023-01-02"
"21531","2022","COM","2020","490","4","494","2023-01-02"
"21532","2022","COM","2020","1155","12","1167","2023-01-02"
"21533","2022","COM","2020","87","3","90","2023-01-02"
"21534","2022","COM","2020","739","43","782","2023-01-02"
"21535","2022","COM","2020","1340","11","1351","2023-01-02"
"21536","2022","COM","2020","289","10","299","2023-01-02"
"21537","2022","COM","2020","117","2","119","2023-01-02"
"21538","2022","COM","2020","117","3","120","2023-01-02"
"21539","2022","COM","2020","55","1","56","2023-01-02"
"21540","2022","COM","2020","7518","99","7617","2023-01-02"
"21541","2022","COM","2020","213","9","222","2023-01-02"
"21542","2022","COM","2020","453","6","459","2023-01-02"
"21543","2022","COM","2020","192","8","200","2023-01-02"
"21544","2022","COM","2020","56","1","57","2023-01-02"
"21545","2022","COM","2020","923","16","939","2023-01-02"
"21546","2022","COM","2020","205","7","212","2023-01-02"
"21547","2022","COM","2020","209","3","212","2023-01-02"
"21548","2022","COM","2020","179","3","182","2023-01-02"
"21549","2022","COM","2020","82","4","86","2023-01-02"
"21550","2022","COM","2020","125","4","129","2023-01-02"
"21552","2022","COM","2020","36","1","37","2023-01-02"
"21553","2022","COM","2020","107","4","111","2023-01-02"
"21554","2022","COM","2020","1039","10","1049","2023-01-02"
"21555","2022","COM","2020","1513","20","1533","2023-01-02"
"21556","2022","COM","2020","245","3","248","2023-01-02"
"21557","2022","COM","2020","109","3","112","2023-01-02"
"21558","2022","COM","2020","897","31","928","2023-01-02"
"21559","2022","COM","2020","695","14","709","2023-01-02"
"21560","2022","COM","2020","303","2","305","2023-01-02"
"21561","2022","COM","2020","462","1","463","2023-01-02"
"21562","2022","COM","2020","199","6","205","2023-01-02"
"21563","2022","COM","2020","117","2","119","2023-01-02"
"21564","2022","COM","2020","398","9","407","2023-01-02"
"21565","2022","COM","2020","519","8","527","2023-01-02"
"21566","2022","COM","2020","139","3","142","2023-01-02"
"21567","2022","COM","2020","209","5","214","2023-01-02"
"21568","2022","COM","2020","688","11","699","2023-01-02"
"21569","2022","COM","2020","212","11","223","2023-01-02"
"21570","2022","COM","2020","172","16","188","2023-01-02"
"21571","2022","COM","2020","231","2","233","2023-01-02"
"21572","2022","COM","2020","395","5","400","2023-01-02"
"21573","2022","COM","2020","368","5","373","2023-01-02"
"21574","2022","COM","2020","383","9","392","2023-01-02"
"21575","2022","COM","2020","334","4","338","2023-01-02"
"21576","2022","COM","2020","159","4","163","2023-01-02"
"21577","2022","COM","2020","1332","30","1362","2023-01-02"
"21578","2022","COM","2020","328","4","332","2023-01-02"
"21579","2022","COM","2020","207","6","213","2023-01-02"
"21580","2022","COM","2020","133","2","135","2023-01-02"
"21581","2022","COM","2020","141","4","145","2023-01-02"
"21582","2022","COM","2020","913","11","924","2023-01-02"
"21583","2022","COM","2020","57","2","59","2023-01-02"
"21584","2022","COM","2020","2346","108","2454","2023-01-02"
"21585","2022","COM","2020","988","22","1010","2023-01-02"
"21586","2022","COM","2020","713","10","723","2023-01-02"
"21587","2022","COM","2020","250","4","254","2023-01-02"
"21588","2022","COM","2020","67","1","68","2023-01-02"
"21589","2022","COM","2020","101","1","102","2023-01-02"
"21590","2022","COM","2020","1288","41","1329","2023-01-02"
"21591","2022","COM","2020","862","14","876","2023-01-02"
"21592","2022","COM","2020","231","11","242","2023-01-02"
"21593","2022","COM","2020","79","0","79","2023-01-02"
"21594","2022","COM","2020","194","3","197","2023-01-02"
"21595","2022","COM","2020","157","2","159","2023-01-02"
"21596","2022","COM","2020","382","6","388","2023-01-02"
"21597","2022","COM","2020","54","1","55","2023-01-02"
"21598","2022","COM","2020","167","1","168","2023-01-02"
"21599","2022","COM","2020","2392","33","2425","2023-01-02"
"21600","2022","COM","2020","125","4","129","2023-01-02"
"21601","2022","COM","2020","94","4","98","2023-01-02"
"21602","2022","COM","2020","28","0","28","2023-01-02"
"21603","2022","COM","2020","4114","352","4466","2023-01-02"
"21604","2022","COM","2020","137","3","140","2023-01-02"
"21605","2022","COM","2020","2068","54","2122","2023-01-02"
"21606","2022","COM","2020","1796","47","1843","2023-01-02"
"21607","2022","COM","2020","2313","22","2335","2023-01-02"
"21608","2022","COM","2020","99","1","100","2023-01-02"
"21609","2022","COM","2020","502","7","509","2023-01-02"
"21610","2022","COM","2020","361","8","369","2023-01-02"
"21611","2022","COM","2020","915","13","928","2023-01-02"
"21612","2022","COM","2020","85","1","86","2023-01-02"
"21613","2022","COM","2020","158","8","166","2023-01-02"
"21614","2022","COM","2020","401","4","405","2023-01-02"
"21615","2022","COM","2020","239","8","247","2023-01-02"
"21616","2022","COM","2020","196","7","203","2023-01-02"
"21617","2022","COM","2020","11788","216","12004","2023-01-02"
"21618","2022","COM","2020","564","10","574","2023-01-02"
"21619","2022","COM","2020","216","6","222","2023-01-02"
"21620","2022","COM","2020","157","5","162","2023-01-02"
"21622","2022","COM","2020","251","5","256","2023-01-02"
"21623","2022","COM","2020","1563","31","1594","2023-01-02"
"21624","2022","COM","2020","141","1","142","2023-01-02"
"21625","2022","COM","2020","84","3","87","2023-01-02"
"21626","2022","COM","2020","62","2","64","2023-01-02"
"21627","2022","COM","2020","92","9","101","2023-01-02"
"21628","2022","COM","2020","65","0","65","2023-01-02"
"21629","2022","COM","2020","307","5","312","2023-01-02"
"21630","2022","COM","2020","216","8","224","2023-01-02"
"21631","2022","COM","2020","55","0","55","2023-01-02"
"21632","2022","COM","2020","1050","31","1081","2023-01-02"
"21633","2022","COM","2020","191","1","192","2023-01-02"
"21634","2022","COM","2020","137","0","137","2023-01-02"
"21635","2022","COM","2020","102","6","108","2023-01-02"
"21636","2022","COM","2020","254","8","262","2023-01-02"
"21637","2022","COM","2020","214","5","219","2023-01-02"
"21638","2022","COM","2020","1144","8","1152","2023-01-02"
"21639","2022","COM","2020","738","15","753","2023-01-02"
"21640","2022","COM","2020","217","5","222","2023-01-02"
"21641","2022","COM","2020","461","6","467","2023-01-02"
"21642","2022","COM","2020","413","8","421","2023-01-02"
"21643","2022","COM","2020","433","8","441","2023-01-02"
"21644","2022","COM","2020","169","4","173","2023-01-02"
"21645","2022","COM","2020","594","13","607","2023-01-02"
"21646","2022","COM","2020","126","3","129","2023-01-02"
"21647","2022","COM","2020","119","2","121","2023-01-02"
"21648","2022","COM","2020","175","1","176","2023-01-02"
"21649","2022","COM","2020","53","0","53","2023-01-02"
"21650","2022","COM","2020","147","4","151","2023-01-02"
"21651","2022","COM","2020","199","4","203","2023-01-02"
"21652","2022","COM","2020","295","7","302","2023-01-02"
"21653","2022","COM","2020","50","1","51","2023-01-02"
"21655","2022","COM","2020","231","9","240","2023-01-02"
"21656","2022","COM","2020","691","13","704","2023-01-02"
"21657","2022","COM","2020","1990","34","2024","2023-01-02"
"21659","2022","COM","2020","167","12","179","2023-01-02"
"21660","2022","COM","2020","53","1","54","2023-01-02"
"21661","2022","COM","2020","1777","29","1806","2023-01-02"
"21662","2022","COM","2020","32","0","32","2023-01-02"
"21663","2022","COM","2020","2811","42","2853","2023-01-02"
"21664","2022","COM","2020","82","4","86","2023-01-02"
"21665","2022","COM","2020","165","2","167","2023-01-02"
"21666","2022","COM","2020","94","3","97","2023-01-02"
"21667","2022","COM","2020","396","7","403","2023-01-02"
"21669","2022","COM","2020","84","0","84","2023-01-02"
"21670","2022","COM","2020","288","5","293","2023-01-02"
"21671","2022","COM","2020","50","1","51","2023-01-02"
"21672","2022","COM","2020","28","1","29","2023-01-02"
"21673","2022","COM","2020","214","3","217","2023-01-02"
"21674","2022","COM","2020","199","2","201","2023-01-02"
"21675","2022","COM","2020","38","1","39","2023-01-02"
"21676","2022","COM","2020","211","5","216","2023-01-02"
"21677","2022","COM","2020","115","1","116","2023-01-02"
"21678","2022","COM","2020","184","3","187","2023-01-02"
"21679","2022","COM","2020","134","2","136","2023-01-02"
"21680","2022","COM","2020","504","7","511","2023-01-02"
"21681","2022","COM","2020","86","1","87","2023-01-02"
"21682","2022","COM","2020","271","1","272","2023-01-02"
"21683","2022","COM","2020","357","3","360","2023-01-02"
"21684","2022","COM","2020","938","48","986","2023-01-02"
"21685","2022","COM","2020","253","6","259","2023-01-02"
"21686","2022","COM","2020","146","2","148","2023-01-02"
"21687","2022","COM","2020","137","5","142","2023-01-02"
"21688","2022","COM","2020","114","4","118","2023-01-02"
"21689","2022","COM","2020","167","7","174","2023-01-02"
"21690","2022","COM","2020","91","2","93","2023-01-02"
"21691","2022","COM","2020","398","7","405","2023-01-02"
"21692","2022","COM","2020","248","4","252","2023-01-02"
"21693","2022","COM","2020","69","1","70","2023-01-02"
"21694","2022","COM","2020","24","0","24","2023-01-02"
"21695","2022","COM","2020","62","1","63","2023-01-02"
"21696","2022","COM","2020","96","2","98","2023-01-02"
"21698","2022","COM","2020","389","9","398","2023-01-02"
"21699","2022","COM","2020","1177","13","1190","2023-01-02"
"21700","2022","COM","2020","82","3","85","2023-01-02"
"21701","2022","COM","2020","125","5","130","2023-01-02"
"21702","2022","COM","2020","263","7","270","2023-01-02"
"21703","2022","COM","2020","49","0","49","2023-01-02"
"21704","2022","COM","2020","103","0","103","2023-01-02"
"21705","2022","COM","2020","74","0","74","2023-01-02"
"21706","2022","COM","2020","114","2","116","2023-01-02"
"21707","2022","COM","2020","216","4","220","2023-01-02"
"21708","2022","COM","2020","326","12","338","2023-01-02"
"21709","2022","COM","2020","179","4","183","2023-01-02"
"21710","2022","COM","2020","1059","18","1077","2023-01-02"
"21711","2022","COM","2020","100","3","103","2023-01-02"
"21712","2022","COM","2020","229","15","244","2023-01-02"
"21713","2022","COM","2020","348","4","352","2023-01-02"
"21714","2022","COM","2020","338","9","347","2023-01-02"
"21715","2022","COM","2020","192","1","193","2023-01-02"
"21716","2022","COM","2020","162","5","167","2023-01-02"
"21717","2022","COM","2020","270","11","281","2023-01-02"
"22001","2022","COM","2020","596","20","616","2023-01-02"
"22002","2022","COM","2020","1148","36","1184","2023-01-02"
"22003","2022","COM","2020","920","77","997","2023-01-02"
"22004","2022","COM","2020","4810","91","4901","2023-01-02"
"22005","2022","COM","2020","1029","19","1048","2023-01-02"
"22006","2022","COM","2020","273","9","282","2023-01-02"
"22008","2022","COM","2020","1137","41","1178","2023-01-02"
"22009","2022","COM","2020","162","1","163","2023-01-02"
"22011","2022","COM","2020","1054","26","1080","2023-01-02"
"22012","2022","COM","2020","886","18","904","2023-01-02"
"22013","2022","COM","2020","2125","44","2169","2023-01-02"
"22014","2022","COM","2020","1182","30","1212","2023-01-02"
"22015","2022","COM","2020","1696","29","1725","2023-01-02"
"22016","2022","COM","2020","377","9","386","2023-01-02"
"22018","2022","COM","2020","291","5","296","2023-01-02"
"22019","2022","COM","2020","495","11","506","2023-01-02"
"22020","2022","COM","2020","2910","67","2977","2023-01-02"
"22021","2022","COM","2020","1166","25","1191","2023-01-02"
"22023","2022","COM","2020","415","1","416","2023-01-02"
"22024","2022","COM","2020","227","1","228","2023-01-02"
"22025","2022","COM","2020","2233","30","2263","2023-01-02"
"22026","2022","COM","2020","737","14","751","2023-01-02"
"22027","2022","COM","2020","414","11","425","2023-01-02"
"22028","2022","COM","2020","842","26","868","2023-01-02"
"22029","2022","COM","2020","345","13","358","2023-01-02"
"22030","2022","COM","2020","899","22","921","2023-01-02"
"22031","2022","COM","2020","653","6","659","2023-01-02"
"22032","2022","COM","2020","2503","134","2637","2023-01-02"
"22033","2022","COM","2020","361","9","370","2023-01-02"
"22034","2022","COM","2020","1516","57","1573","2023-01-02"
"22035","2022","COM","2020","1042","23","1065","2023-01-02"
"22036","2022","COM","2020","210","7","217","2023-01-02"
"22037","2022","COM","2020","384","4","388","2023-01-02"
"22039","2022","COM","2020","561","9","570","2023-01-02"
"22040","2022","COM","2020","567","14","581","2023-01-02"
"22041","2022","COM","2020","261","3","264","2023-01-02"
"22042","2022","COM","2020","500","14","514","2023-01-02"
"22043","2022","COM","2020","209","6","215","2023-01-02"
"22044","2022","COM","2020","1792","50","1842","2023-01-02"
"22045","2022","COM","2020","363","4","367","2023-01-02"
"22046","2022","COM","2020","6412","115","6527","2023-01-02"
"22047","2022","COM","2020","922","16","938","2023-01-02"
"22048","2022","COM","2020","2223","47","2270","2023-01-02"
"22049","2022","COM","2020","1643","35","1678","2023-01-02"
"22050","2022","COM","2020","14682","574","15256","2023-01-02"
"22052","2022","COM","2020","376","6","382","2023-01-02"
"22053","2022","COM","2020","682","12","694","2023-01-02"
"22054","2022","COM","2020","3916","91","4007","2023-01-02"
"22055","2022","COM","2020","6862","213","7075","2023-01-02"
"22056","2022","COM","2020","1783","26","1809","2023-01-02"
"22057","2022","COM","2020","400","12","412","2023-01-02"
"22059","2022","COM","2020","1403","40","1443","2023-01-02"
"22060","2022","COM","2020","619","9","628","2023-01-02"
"22061","2022","COM","2020","1350","40","1390","2023-01-02"
"22062","2022","COM","2020","543","11","554","2023-01-02"
"22063","2022","COM","2020","554","9","563","2023-01-02"
"22064","2022","COM","2020","952","31","983","2023-01-02"
"22065","2022","COM","2020","1725","37","1762","2023-01-02"
"22067","2022","COM","2020","2548","59","2607","2023-01-02"
"22068","2022","COM","2020","430","8","438","2023-01-02"
"22069","2022","COM","2020","216","5","221","2023-01-02"
"22070","2022","COM","2020","7115","567","7682","2023-01-02"
"22071","2022","COM","2020","718","8","726","2023-01-02"
"22072","2022","COM","2020","405","8","413","2023-01-02"
"22073","2022","COM","2020","373","17","390","2023-01-02"
"22074","2022","COM","2020","645","17","662","2023-01-02"
"22075","2022","COM","2020","724","7","731","2023-01-02"
"22076","2022","COM","2020","1328","37","1365","2023-01-02"
"22077","2022","COM","2020","1201","15","1216","2023-01-02"
"22079","2022","COM","2020","2298","36","2334","2023-01-02"
"22081","2022","COM","2020","4246","99","4345","2023-01-02"
"22082","2022","COM","2020","907","32","939","2023-01-02"
"22083","2022","COM","2020","674","12","686","2023-01-02"
"22084","2022","COM","2020","2533","50","2583","2023-01-02"
"22085","2022","COM","2020","288","8","296","2023-01-02"
"22086","2022","COM","2020","655","12","667","2023-01-02"
"22087","2022","COM","2020","654","26","680","2023-01-02"
"22088","2022","COM","2020","250","3","253","2023-01-02"
"22090","2022","COM","2020","1074","21","1095","2023-01-02"
"22091","2022","COM","2020","436","9","445","2023-01-02"
"22092","2022","COM","2020","269","3","272","2023-01-02"
"22093","2022","COM","2020","16689","480","17169","2023-01-02"
"22094","2022","COM","2020","1582","63","1645","2023-01-02"
"22095","2022","COM","2020","175","10","185","2023-01-02"
"22096","2022","COM","2020","454","2","456","2023-01-02"
"22097","2022","COM","2020","726","18","744","2023-01-02"
"22098","2022","COM","2020","1424","34","1458","2023-01-02"
"22099","2022","COM","2020","1099","18","1117","2023-01-02"
"22101","2022","COM","2020","1139","25","1164","2023-01-02"
"22103","2022","COM","2020","974","40","1014","2023-01-02"
"22104","2022","COM","2020","540","28","568","2023-01-02"
"22105","2022","COM","2020","1149","23","1172","2023-01-02"
"22106","2022","COM","2020","7824","250","8074","2023-01-02"
"22107","2022","COM","2020","1249","36","1285","2023-01-02"
"22108","2022","COM","2020","122","2","124","2023-01-02"
"22109","2022","COM","2020","224","6","230","2023-01-02"
"22110","2022","COM","2020","592","14","606","2023-01-02"
"22111","2022","COM","2020","402","6","408","2023-01-02"
"22112","2022","COM","2020","439","4","443","2023-01-02"
"22113","2022","COM","2020","20451","905","21356","2023-01-02"
"22114","2022","COM","2020","852","17","869","2023-01-02"
"22115","2022","COM","2020","449","12","461","2023-01-02"
"22116","2022","COM","2020","1364","23","1387","2023-01-02"
"22117","2022","COM","2020","1744","33","1777","2023-01-02"
"22118","2022","COM","2020","4209","101","4310","2023-01-02"
"22119","2022","COM","2020","595","10","605","2023-01-02"
"22121","2022","COM","2020","1781","28","1809","2023-01-02"
"22122","2022","COM","2020","737","13","750","2023-01-02"
"22124","2022","COM","2020","215","8","223","2023-01-02"
"22126","2022","COM","2020","157","3","160","2023-01-02"
"22127","2022","COM","2020","1532","34","1566","2023-01-02"
"22128","2022","COM","2020","410","13","423","2023-01-02"
"22129","2022","COM","2020","69","2","71","2023-01-02"
"22131","2022","COM","2020","802","13","815","2023-01-02"
"22132","2022","COM","2020","247","3","250","2023-01-02"
"22133","2022","COM","2020","628","15","643","2023-01-02"
"22134","2022","COM","2020","3086","117","3203","2023-01-02"
"22135","2022","COM","2020","2328","39","2367","2023-01-02"
"22136","2022","COM","2020","9652","379","10031","2023-01-02"
"22137","2022","COM","2020","1466","30","1496","2023-01-02"
"22138","2022","COM","2020","354","5","359","2023-01-02"
"22139","2022","COM","2020","84","2","86","2023-01-02"
"22140","2022","COM","2020","611","16","627","2023-01-02"
"22141","2022","COM","2020","236","6","242","2023-01-02"
"22143","2022","COM","2020","1704","22","1726","2023-01-02"
"22144","2022","COM","2020","1331","35","1366","2023-01-02"
"22145","2022","COM","2020","827","21","848","2023-01-02"
"22146","2022","COM","2020","395","17","412","2023-01-02"
"22147","2022","COM","2020","2954","232","3186","2023-01-02"
"22148","2022","COM","2020","234","4","238","2023-01-02"
"22149","2022","COM","2020","428","16","444","2023-01-02"
"22150","2022","COM","2020","946","27","973","2023-01-02"
"22152","2022","COM","2020","1254","41","1295","2023-01-02"
"22153","2022","COM","2020","752","16","768","2023-01-02"
"22155","2022","COM","2020","2146","33","2179","2023-01-02"
"22156","2022","COM","2020","644","15","659","2023-01-02"
"22157","2022","COM","2020","667","24","691","2023-01-02"
"22158","2022","COM","2020","2467","63","2530","2023-01-02"
"22160","2022","COM","2020","956","19","975","2023-01-02"
"22161","2022","COM","2020","2753","108","2861","2023-01-02"
"22162","2022","COM","2020","7142","329","7471","2023-01-02"
"22163","2022","COM","2020","682","21","703","2023-01-02"
"22164","2022","COM","2020","1856","42","1898","2023-01-02"
"22165","2022","COM","2020","606","19","625","2023-01-02"
"22166","2022","COM","2020","2473","64","2537","2023-01-02"
"22168","2022","COM","2020","7149","193","7342","2023-01-02"
"22169","2022","COM","2020","172","4","176","2023-01-02"
"22170","2022","COM","2020","1647","34","1681","2023-01-02"
"22171","2022","COM","2020","4501","91","4592","2023-01-02"
"22172","2022","COM","2020","3018","53","3071","2023-01-02"
"22174","2022","COM","2020","819","12","831","2023-01-02"
"22175","2022","COM","2020","1478","16","1494","2023-01-02"
"22176","2022","COM","2020","6920","110","7030","2023-01-02"
"22177","2022","COM","2020","1383","31","1414","2023-01-02"
"22178","2022","COM","2020","1335","35","1370","2023-01-02"
"22179","2022","COM","2020","1602","26","1628","2023-01-02"
"22180","2022","COM","2020","1917","30","1947","2023-01-02"
"22181","2022","COM","2020","628","28","656","2023-01-02"
"22182","2022","COM","2020","3239","77","3316","2023-01-02"
"22183","2022","COM","2020","3728","90","3818","2023-01-02"
"22184","2022","COM","2020","1591","31","1622","2023-01-02"
"22185","2022","COM","2020","2434","73","2507","2023-01-02"
"22186","2022","COM","2020","4069","128","4197","2023-01-02"
"22187","2022","COM","2020","14459","457","14916","2023-01-02"
"22188","2022","COM","2020","1112","11","1123","2023-01-02"
"22189","2022","COM","2020","562","10","572","2023-01-02"
"22190","2022","COM","2020","3867","80","3947","2023-01-02"
"22193","2022","COM","2020","1635","25","1660","2023-01-02"
"22194","2022","COM","2020","3635","99","3734","2023-01-02"
"22195","2022","COM","2020","2283","41","2324","2023-01-02"
"22196","2022","COM","2020","934","17","951","2023-01-02"
"22197","2022","COM","2020","3009","83","3092","2023-01-02"
"22198","2022","COM","2020","3837","163","4000","2023-01-02"
"22199","2022","COM","2020","1189","18","1207","2023-01-02"
"22200","2022","COM","2020","599","10","609","2023-01-02"
"22201","2022","COM","2020","756","13","769","2023-01-02"
"22202","2022","COM","2020","750","11","761","2023-01-02"
"22203","2022","COM","2020","4108","70","4178","2023-01-02"
"22204","2022","COM","2020","1222","21","1243","2023-01-02"
"22205","2022","COM","2020","420","3","423","2023-01-02"
"22206","2022","COM","2020","3955","55","4010","2023-01-02"
"22207","2022","COM","2020","2195","44","2239","2023-01-02"
"22208","2022","COM","2020","1721","34","1755","2023-01-02"
"22209","2022","COM","2020","3956","63","4019","2023-01-02"
"22210","2022","COM","2020","3040","124","3164","2023-01-02"
"22211","2022","COM","2020","3736","118","3854","2023-01-02"
"22212","2022","COM","2020","1143","33","1176","2023-01-02"
"22213","2022","COM","2020","3515","106","3621","2023-01-02"
"22214","2022","COM","2020","3126","57","3183","2023-01-02"
"22215","2022","COM","2020","11487","350","11837","2023-01-02"
"22216","2022","COM","2020","743","16","759","2023-01-02"
"22217","2022","COM","2020","415","9","424","2023-01-02"
"22218","2022","COM","2020","1160","34","1194","2023-01-02"
"22219","2022","COM","2020","2429","57","2486","2023-01-02"
"22220","2022","COM","2020","1610","50","1660","2023-01-02"
"22221","2022","COM","2020","1744","37","1781","2023-01-02"
"22222","2022","COM","2020","4560","86","4646","2023-01-02"
"22223","2022","COM","2020","2002","275","2277","2023-01-02"
"22224","2022","COM","2020","1581","57","1638","2023-01-02"
"22225","2022","COM","2020","5405","109","5514","2023-01-02"
"22226","2022","COM","2020","2452","56","2508","2023-01-02"
"22227","2022","COM","2020","787","12","799","2023-01-02"
"22228","2022","COM","2020","1463","26","1489","2023-01-02"
"22229","2022","COM","2020","1065","27","1092","2023-01-02"
"22231","2022","COM","2020","328","4","332","2023-01-02"
"22232","2022","COM","2020","2040","33","2073","2023-01-02"
"22233","2022","COM","2020","2262","55","2317","2023-01-02"
"22234","2022","COM","2020","1158","11","1169","2023-01-02"
"22235","2022","COM","2020","225","5","230","2023-01-02"
"22236","2022","COM","2020","723","9","732","2023-01-02"
"22237","2022","COM","2020","2216","65","2281","2023-01-02"
"22238","2022","COM","2020","533","12","545","2023-01-02"
"22239","2022","COM","2020","1367","38","1405","2023-01-02"
"22240","2022","COM","2020","1103","16","1119","2023-01-02"
"22241","2022","COM","2020","1028","30","1058","2023-01-02"
"22242","2022","COM","2020","1543","29","1572","2023-01-02"
"22243","2022","COM","2020","546","16","562","2023-01-02"
"22244","2022","COM","2020","480","19","499","2023-01-02"
"22245","2022","COM","2020","959","14","973","2023-01-02"
"22246","2022","COM","2020","2124","34","2158","2023-01-02"
"22248","2022","COM","2020","1830","38","1868","2023-01-02"
"22249","2022","COM","2020","615","10","625","2023-01-02"
"22250","2022","COM","2020","1000","25","1025","2023-01-02"
"22251","2022","COM","2020","7315","208","7523","2023-01-02"
"22254","2022","COM","2020","1117","22","1139","2023-01-02"
"22255","2022","COM","2020","876","18","894","2023-01-02"
"22256","2022","COM","2020","1061","26","1087","2023-01-02"
"22257","2022","COM","2020","393","9","402","2023-01-02"
"22258","2022","COM","2020","3868","224","4092","2023-01-02"
"22259","2022","COM","2020","3970","87","4057","2023-01-02"
"22260","2022","COM","2020","567","10","577","2023-01-02"
"22261","2022","COM","2020","360","11","371","2023-01-02"
"22262","2022","COM","2020","2822","207","3029","2023-01-02"
"22263","2022","COM","2020","347","3","350","2023-01-02"
"22264","2022","COM","2020","2671","611","3282","2023-01-02"
"22265","2022","COM","2020","1778","56","1834","2023-01-02"
"22266","2022","COM","2020","3132","296","3428","2023-01-02"
"22267","2022","COM","2020","389","3","392","2023-01-02"
"22268","2022","COM","2020","596","10","606","2023-01-02"
"22269","2022","COM","2020","253","6","259","2023-01-02"
"22271","2022","COM","2020","350","6","356","2023-01-02"
"22272","2022","COM","2020","2286","53","2339","2023-01-02"
"22273","2022","COM","2020","2241","39","2280","2023-01-02"
"22274","2022","COM","2020","387","6","393","2023-01-02"
"22275","2022","COM","2020","1225","25","1250","2023-01-02"
"22276","2022","COM","2020","266","7","273","2023-01-02"
"22277","2022","COM","2020","2298","49","2347","2023-01-02"
"22278","2022","COM","2020","44166","1436","45602","2023-01-02"
"22279","2022","COM","2020","1119","39","1158","2023-01-02"
"22280","2022","COM","2020","1077","37","1114","2023-01-02"
"22281","2022","COM","2020","1522","24","1546","2023-01-02"
"22282","2022","COM","2020","3313","75","3388","2023-01-02"
"22283","2022","COM","2020","870","26","896","2023-01-02"
"22284","2022","COM","2020","293","8","301","2023-01-02"
"22285","2022","COM","2020","260","8","268","2023-01-02"
"22286","2022","COM","2020","479","14","493","2023-01-02"
"22287","2022","COM","2020","1447","36","1483","2023-01-02"
"22288","2022","COM","2020","358","5","363","2023-01-02"
"22289","2022","COM","2020","214","1","215","2023-01-02"
"22291","2022","COM","2020","247","8","255","2023-01-02"
"22293","2022","COM","2020","396","13","409","2023-01-02"
"22294","2022","COM","2020","304","6","310","2023-01-02"
"22295","2022","COM","2020","342","15","357","2023-01-02"
"22296","2022","COM","2020","654","10","664","2023-01-02"
"22299","2022","COM","2020","1528","44","1572","2023-01-02"
"22300","2022","COM","2020","388","9","397","2023-01-02"
"22302","2022","COM","2020","910","18","928","2023-01-02"
"22304","2022","COM","2020","668","9","677","2023-01-02"
"22305","2022","COM","2020","482","9","491","2023-01-02"
"22306","2022","COM","2020","565","10","575","2023-01-02"
"22307","2022","COM","2020","2046","50","2096","2023-01-02"
"22308","2022","COM","2020","648","18","666","2023-01-02"
"22309","2022","COM","2020","192","4","196","2023-01-02"
"22310","2022","COM","2020","491","7","498","2023-01-02"
"22311","2022","COM","2020","881","36","917","2023-01-02"
"22312","2022","COM","2020","223","9","232","2023-01-02"
"22313","2022","COM","2020","311","8","319","2023-01-02"
"22314","2022","COM","2020","398","7","405","2023-01-02"
"22315","2022","COM","2020","283","11","294","2023-01-02"
"22316","2022","COM","2020","466","7","473","2023-01-02"
"22317","2022","COM","2020","267","5","272","2023-01-02"
"22318","2022","COM","2020","308","8","316","2023-01-02"
"22319","2022","COM","2020","453","13","466","2023-01-02"
"22320","2022","COM","2020","180","5","185","2023-01-02"
"22321","2022","COM","2020","1555","44","1599","2023-01-02"
"22322","2022","COM","2020","383","8","391","2023-01-02"
"22323","2022","COM","2020","821","14","835","2023-01-02"
"22324","2022","COM","2020","1289","55","1344","2023-01-02"
"22325","2022","COM","2020","3159","223","3382","2023-01-02"
"22326","2022","COM","2020","544","5","549","2023-01-02"
"22327","2022","COM","2020","1639","27","1666","2023-01-02"
"22328","2022","COM","2020","410","5","415","2023-01-02"
"22330","2022","COM","2020","383","11","394","2023-01-02"
"22331","2022","COM","2020","184","2","186","2023-01-02"
"22332","2022","COM","2020","510","9","519","2023-01-02"
"22333","2022","COM","2020","762","29","791","2023-01-02"
"22334","2022","COM","2020","123","8","131","2023-01-02"
"22335","2022","COM","2020","237","0","237","2023-01-02"
"22337","2022","COM","2020","1116","25","1141","2023-01-02"
"22338","2022","COM","2020","762","25","787","2023-01-02"
"22339","2022","COM","2020","2521","75","2596","2023-01-02"
"22340","2022","COM","2020","1201","27","1228","2023-01-02"
"22341","2022","COM","2020","695","15","710","2023-01-02"
"22342","2022","COM","2020","430","7","437","2023-01-02"
"22343","2022","COM","2020","3701","122","3823","2023-01-02"
"22344","2022","COM","2020","756","17","773","2023-01-02"
"22345","2022","COM","2020","779","15","794","2023-01-02"
"22346","2022","COM","2020","897","23","920","2023-01-02"
"22347","2022","COM","2020","1054","18","1072","2023-01-02"
"22348","2022","COM","2020","499","9","508","2023-01-02"
"22349","2022","COM","2020","1457","39","1496","2023-01-02"
"22350","2022","COM","2020","193","4","197","2023-01-02"
"22351","2022","COM","2020","540","14","554","2023-01-02"
"22352","2022","COM","2020","274","2","276","2023-01-02"
"22353","2022","COM","2020","2549","73","2622","2023-01-02"
"22354","2022","COM","2020","1094","22","1116","2023-01-02"
"22356","2022","COM","2020","945","24","969","2023-01-02"
"22358","2022","COM","2020","559","7","566","2023-01-02"
"22359","2022","COM","2020","412","5","417","2023-01-02"
"22360","2022","COM","2020","8470","169","8639","2023-01-02"
"22361","2022","COM","2020","633","12","645","2023-01-02"
"22362","2022","COM","2020","2411","267","2678","2023-01-02"
"22363","2022","COM","2020","1242","26","1268","2023-01-02"
"22364","2022","COM","2020","2899","80","2979","2023-01-02"
"22365","2022","COM","2020","181","12","193","2023-01-02"
"22366","2022","COM","2020","403","5","408","2023-01-02"
"22368","2022","COM","2020","724","29","753","2023-01-02"
"22369","2022","COM","2020","787","12","799","2023-01-02"
"22370","2022","COM","2020","351","8","359","2023-01-02"
"22371","2022","COM","2020","1147","20","1167","2023-01-02"
"22372","2022","COM","2020","2187","37","2224","2023-01-02"
"22373","2022","COM","2020","104","3","107","2023-01-02"
"22375","2022","COM","2020","706","11","717","2023-01-02"
"22376","2022","COM","2020","1688","42","1730","2023-01-02"
"22377","2022","COM","2020","798","21","819","2023-01-02"
"22378","2022","COM","2020","215","7","222","2023-01-02"
"22379","2022","COM","2020","1522","41","1563","2023-01-02"
"22380","2022","COM","2020","685","14","699","2023-01-02"
"22381","2022","COM","2020","353","10","363","2023-01-02"
"22383","2022","COM","2020","217","5","222","2023-01-02"
"22384","2022","COM","2020","1080","27","1107","2023-01-02"
"22385","2022","COM","2020","1113","25","1138","2023-01-02"
"22386","2022","COM","2020","777","20","797","2023-01-02"
"22387","2022","COM","2020","1280","30","1310","2023-01-02"
"22388","2022","COM","2020","1257","28","1285","2023-01-02"
"22389","2022","COM","2020","4977","103","5080","2023-01-02"
"22390","2022","COM","2020","779","16","795","2023-01-02"
"22391","2022","COM","2020","1123","16","1139","2023-01-02"
"23001","2022","COM","2020","1421","230","1651","2023-01-02"
"23002","2022","COM","2020","1043","12","1055","2023-01-02"
"23003","2022","COM","2020","138","0","138","2023-01-02"
"23004","2022","COM","2020","543","9","552","2023-01-02"
"23005","2022","COM","2020","199","4","203","2023-01-02"
"23006","2022","COM","2020","210","4","214","2023-01-02"
"23007","2022","COM","2020","234","10","244","2023-01-02"
"23008","2022","COM","2020","3181","154","3335","2023-01-02"
"23009","2022","COM","2020","91","0","91","2023-01-02"
"23010","2022","COM","2020","119","2","121","2023-01-02"
"23011","2022","COM","2020","163","4","167","2023-01-02"
"23012","2022","COM","2020","109","2","111","2023-01-02"
"23013","2022","COM","2020","1201","25","1226","2023-01-02"
"23014","2022","COM","2020","122","3","125","2023-01-02"
"23015","2022","COM","2020","811","15","826","2023-01-02"
"23016","2022","COM","2020","181","3","184","2023-01-02"
"23017","2022","COM","2020","167","2","169","2023-01-02"
"23018","2022","COM","2020","244","11","255","2023-01-02"
"23019","2022","COM","2020","27","0","27","2023-01-02"
"23020","2022","COM","2020","392","3","395","2023-01-02"
"23021","2022","COM","2020","761","9","770","2023-01-02"
"23022","2022","COM","2020","378","6","384","2023-01-02"
"23023","2022","COM","2020","106","1","107","2023-01-02"
"23024","2022","COM","2020","539","15","554","2023-01-02"
"23025","2022","COM","2020","1348","24","1372","2023-01-02"
"23026","2022","COM","2020","358","4","362","2023-01-02"
"23027","2022","COM","2020","232","7","239","2023-01-02"
"23028","2022","COM","2020","110","3","113","2023-01-02"
"23029","2022","COM","2020","222","2","224","2023-01-02"
"23030","2022","COM","2020","2462","212","2674","2023-01-02"
"23031","2022","COM","2020","1246","17","1263","2023-01-02"
"23032","2022","COM","2020","692","11","703","2023-01-02"
"23033","2022","COM","2020","451","8","459","2023-01-02"
"23034","2022","COM","2020","29","1","30","2023-01-02"
"23035","2022","COM","2020","702","10","712","2023-01-02"
"23036","2022","COM","2020","1035","15","1050","2023-01-02"
"23037","2022","COM","2020","78","3","81","2023-01-02"
"23038","2022","COM","2020","252","3","255","2023-01-02"
"23039","2022","COM","2020","537","24","561","2023-01-02"
"23040","2022","COM","2020","155","1","156","2023-01-02"
"23041","2022","COM","2020","239","5","244","2023-01-02"
"23042","2022","COM","2020","126","1","127","2023-01-02"
"23043","2022","COM","2020","96","0","96","2023-01-02"
"23044","2022","COM","2020","82","1","83","2023-01-02"
"23045","2022","COM","2020","863","12","875","2023-01-02"
"23046","2022","COM","2020","80","4","84","2023-01-02"
"23047","2022","COM","2020","242","3","245","2023-01-02"
"23048","2022","COM","2020","474","10","484","2023-01-02"
"23049","2022","COM","2020","251","8","259","2023-01-02"
"23050","2022","COM","2020","125","1","126","2023-01-02"
"23051","2022","COM","2020","77","1","78","2023-01-02"
"23052","2022","COM","2020","435","10","445","2023-01-02"
"23053","2022","COM","2020","202","2","204","2023-01-02"
"23054","2022","COM","2020","218","2","220","2023-01-02"
"23055","2022","COM","2020","30","0","30","2023-01-02"
"23056","2022","COM","2020","289","5","294","2023-01-02"
"23057","2022","COM","2020","546","11","557","2023-01-02"
"23058","2022","COM","2020","101","1","102","2023-01-02"
"23059","2022","COM","2020","99","6","105","2023-01-02"
"23060","2022","COM","2020","141","5","146","2023-01-02"
"23061","2022","COM","2020","752","14","766","2023-01-02"
"23062","2022","COM","2020","557","9","566","2023-01-02"
"23063","2022","COM","2020","154","1","155","2023-01-02"
"23064","2022","COM","2020","653","3","656","2023-01-02"
"23065","2022","COM","2020","277","9","286","2023-01-02"
"23066","2022","COM","2020","194","12","206","2023-01-02"
"23067","2022","COM","2020","798","8","806","2023-01-02"
"23068","2022","COM","2020","516","7","523","2023-01-02"
"23069","2022","COM","2020","404","3","407","2023-01-02"
"23070","2022","COM","2020","437","14","451","2023-01-02"
"23071","2022","COM","2020","190","6","196","2023-01-02"
"23072","2022","COM","2020","234","2","236","2023-01-02"
"23073","2022","COM","2020","418","10","428","2023-01-02"
"23074","2022","COM","2020","186","3","189","2023-01-02"
"23075","2022","COM","2020","1090","24","1114","2023-01-02"
"23076","2022","COM","2020","1297","25","1322","2023-01-02"
"23077","2022","COM","2020","446","10","456","2023-01-02"
"23078","2022","COM","2020","189","4","193","2023-01-02"
"23079","2022","COM","2020","1547","183","1730","2023-01-02"
"23080","2022","COM","2020","99","2","101","2023-01-02"
"23081","2022","COM","2020","300","6","306","2023-01-02"
"23082","2022","COM","2020","313","6","319","2023-01-02"
"23083","2022","COM","2020","245","2","247","2023-01-02"
"23084","2022","COM","2020","145","2","147","2023-01-02"
"23086","2022","COM","2020","243","3","246","2023-01-02"
"23087","2022","COM","2020","484","10","494","2023-01-02"
"23088","2022","COM","2020","119","1","120","2023-01-02"
"23089","2022","COM","2020","727","10","737","2023-01-02"
"23090","2022","COM","2020","376","6","382","2023-01-02"
"23091","2022","COM","2020","161","3","164","2023-01-02"
"23092","2022","COM","2020","685","13","698","2023-01-02"
"23093","2022","COM","2020","1568","22","1590","2023-01-02"
"23095","2022","COM","2020","1208","42","1250","2023-01-02"
"23096","2022","COM","2020","12698","629","13327","2023-01-02"
"23097","2022","COM","2020","295","3","298","2023-01-02"
"23098","2022","COM","2020","91","3","94","2023-01-02"
"23099","2022","COM","2020","317","5","322","2023-01-02"
"23100","2022","COM","2020","435","10","445","2023-01-02"
"23101","2022","COM","2020","383","13","396","2023-01-02"
"23102","2022","COM","2020","347","3","350","2023-01-02"
"23103","2022","COM","2020","322","14","336","2023-01-02"
"23104","2022","COM","2020","239","1","240","2023-01-02"
"23105","2022","COM","2020","638","3","641","2023-01-02"
"23106","2022","COM","2020","366","4","370","2023-01-02"
"23107","2022","COM","2020","128","5","133","2023-01-02"
"23108","2022","COM","2020","143","1","144","2023-01-02"
"23109","2022","COM","2020","209","4","213","2023-01-02"
"23110","2022","COM","2020","62","1","63","2023-01-02"
"23111","2022","COM","2020","240","1","241","2023-01-02"
"23112","2022","COM","2020","733","13","746","2023-01-02"
"23113","2022","COM","2020","298","6","304","2023-01-02"
"23114","2022","COM","2020","404","8","412","2023-01-02"
"23115","2022","COM","2020","249","2","251","2023-01-02"
"23116","2022","COM","2020","539","9","548","2023-01-02"
"23117","2022","COM","2020","296","9","305","2023-01-02"
"23118","2022","COM","2020","177","6","183","2023-01-02"
"23119","2022","COM","2020","42","0","42","2023-01-02"
"23120","2022","COM","2020","182","3","185","2023-01-02"
"23122","2022","COM","2020","67","4","71","2023-01-02"
"23123","2022","COM","2020","183","2","185","2023-01-02"
"23124","2022","COM","2020","640","17","657","2023-01-02"
"23125","2022","COM","2020","98","1","99","2023-01-02"
"23127","2022","COM","2020","197","6","203","2023-01-02"
"23128","2022","COM","2020","125","5","130","2023-01-02"
"23129","2022","COM","2020","64","1","65","2023-01-02"
"23130","2022","COM","2020","527","6","533","2023-01-02"
"23131","2022","COM","2020","682","14","696","2023-01-02"
"23132","2022","COM","2020","398","6","404","2023-01-02"
"23133","2022","COM","2020","354","10","364","2023-01-02"
"23134","2022","COM","2020","213","24","237","2023-01-02"
"23136","2022","COM","2020","273","10","283","2023-01-02"
"23137","2022","COM","2020","518","12","530","2023-01-02"
"23138","2022","COM","2020","161","1","162","2023-01-02"
"23139","2022","COM","2020","541","5","546","2023-01-02"
"23140","2022","COM","2020","424","8","432","2023-01-02"
"23141","2022","COM","2020","628","16","644","2023-01-02"
"23142","2022","COM","2020","284","8","292","2023-01-02"
"23143","2022","COM","2020","489","13","502","2023-01-02"
"23144","2022","COM","2020","235","3","238","2023-01-02"
"23145","2022","COM","2020","277","8","285","2023-01-02"
"23146","2022","COM","2020","237","7","244","2023-01-02"
"23147","2022","COM","2020","96","2","98","2023-01-02"
"23148","2022","COM","2020","246","2","248","2023-01-02"
"23149","2022","COM","2020","712","14","726","2023-01-02"
"23150","2022","COM","2020","155","3","158","2023-01-02"
"23151","2022","COM","2020","427","9","436","2023-01-02"
"23152","2022","COM","2020","70","0","70","2023-01-02"
"23154","2022","COM","2020","730","11","741","2023-01-02"
"23155","2022","COM","2020","364","6","370","2023-01-02"
"23156","2022","COM","2020","83","0","83","2023-01-02"
"23157","2022","COM","2020","96","0","96","2023-01-02"
"23158","2022","COM","2020","156","2","158","2023-01-02"
"23159","2022","COM","2020","149","3","152","2023-01-02"
"23160","2022","COM","2020","269","1","270","2023-01-02"
"23162","2022","COM","2020","372","3","375","2023-01-02"
"23164","2022","COM","2020","479","10","489","2023-01-02"
"23165","2022","COM","2020","578","7","585","2023-01-02"
"23166","2022","COM","2020","192","7","199","2023-01-02"
"23167","2022","COM","2020","339","2","341","2023-01-02"
"23168","2022","COM","2020","760","18","778","2023-01-02"
"23169","2022","COM","2020","645","13","658","2023-01-02"
"23170","2022","COM","2020","212","11","223","2023-01-02"
"23171","2022","COM","2020","108","1","109","2023-01-02"
"23172","2022","COM","2020","122","1","123","2023-01-02"
"23173","2022","COM","2020","139","3","142","2023-01-02"
"23174","2022","COM","2020","578","7","585","2023-01-02"
"23175","2022","COM","2020","114","0","114","2023-01-02"
"23176","2022","COM","2020","4953","229","5182","2023-01-02"
"23177","2022","COM","2020","1085","30","1115","2023-01-02"
"23178","2022","COM","2020","171","0","171","2023-01-02"
"23179","2022","COM","2020","282","4","286","2023-01-02"
"23180","2022","COM","2020","475","9","484","2023-01-02"
"23181","2022","COM","2020","156","2","158","2023-01-02"
"23182","2022","COM","2020","169","2","171","2023-01-02"
"23183","2022","COM","2020","77","2","79","2023-01-02"
"23184","2022","COM","2020","97","3","100","2023-01-02"
"23185","2022","COM","2020","295","2","297","2023-01-02"
"23186","2022","COM","2020","154","6","160","2023-01-02"
"23187","2022","COM","2020","186","2","188","2023-01-02"
"23188","2022","COM","2020","196","2","198","2023-01-02"
"23189","2022","COM","2020","1131","25","1156","2023-01-02"
"23190","2022","COM","2020","163","1","164","2023-01-02"
"23191","2022","COM","2020","180","7","187","2023-01-02"
"23192","2022","COM","2020","1445","22","1467","2023-01-02"
"23193","2022","COM","2020","2493","59","2552","2023-01-02"
"23194","2022","COM","2020","122","3","125","2023-01-02"
"23195","2022","COM","2020","1049","26","1075","2023-01-02"
"23196","2022","COM","2020","255","5","260","2023-01-02"
"23197","2022","COM","2020","370","3","373","2023-01-02"
"23198","2022","COM","2020","143","2","145","2023-01-02"
"23199","2022","COM","2020","361","8","369","2023-01-02"
"23200","2022","COM","2020","166","8","174","2023-01-02"
"23201","2022","COM","2020","213","5","218","2023-01-02"
"23202","2022","COM","2020","226","8","234","2023-01-02"
"23203","2022","COM","2020","219","7","226","2023-01-02"
"23204","2022","COM","2020","141","3","144","2023-01-02"
"23205","2022","COM","2020","143","3","146","2023-01-02"
"23206","2022","COM","2020","693","15","708","2023-01-02"
"23207","2022","COM","2020","185","6","191","2023-01-02"
"23208","2022","COM","2020","409","9","418","2023-01-02"
"23209","2022","COM","2020","183","1","184","2023-01-02"
"23210","2022","COM","2020","256","3","259","2023-01-02"
"23211","2022","COM","2020","426","9","435","2023-01-02"
"23212","2022","COM","2020","125","1","126","2023-01-02"
"23213","2022","COM","2020","187","3","190","2023-01-02"
"23214","2022","COM","2020","269","3","272","2023-01-02"
"23215","2022","COM","2020","143","6","149","2023-01-02"
"23216","2022","COM","2020","147","5","152","2023-01-02"
"23217","2022","COM","2020","338","4","342","2023-01-02"
"23218","2022","COM","2020","97","2","99","2023-01-02"
"23219","2022","COM","2020","1190","19","1209","2023-01-02"
"23220","2022","COM","2020","559","12","571","2023-01-02"
"23221","2022","COM","2020","192","5","197","2023-01-02"
"23222","2022","COM","2020","163","4","167","2023-01-02"
"23223","2022","COM","2020","215","1","216","2023-01-02"
"23224","2022","COM","2020","72","0","72","2023-01-02"
"23225","2022","COM","2020","107","1","108","2023-01-02"
"23226","2022","COM","2020","167","6","173","2023-01-02"
"23227","2022","COM","2020","205","5","210","2023-01-02"
"23228","2022","COM","2020","201","9","210","2023-01-02"
"23229","2022","COM","2020","285","2","287","2023-01-02"
"23230","2022","COM","2020","165","5","170","2023-01-02"
"23232","2022","COM","2020","208","1","209","2023-01-02"
"23233","2022","COM","2020","124","1","125","2023-01-02"
"23234","2022","COM","2020","150","2","152","2023-01-02"
"23235","2022","COM","2020","757","15","772","2023-01-02"
"23236","2022","COM","2020","255","8","263","2023-01-02"
"23237","2022","COM","2020","55","0","55","2023-01-02"
"23238","2022","COM","2020","376","7","383","2023-01-02"
"23239","2022","COM","2020","633","11","644","2023-01-02"
"23240","2022","COM","2020","409","5","414","2023-01-02"
"23241","2022","COM","2020","217","3","220","2023-01-02"
"23242","2022","COM","2020","215","4","219","2023-01-02"
"23243","2022","COM","2020","148","2","150","2023-01-02"
"23244","2022","COM","2020","577","14","591","2023-01-02"
"23245","2022","COM","2020","1926","57","1983","2023-01-02"
"23246","2022","COM","2020","348","8","356","2023-01-02"
"23247","2022","COM","2020","1735","122","1857","2023-01-02"
"23248","2022","COM","2020","355","8","363","2023-01-02"
"23249","2022","COM","2020","221","3","224","2023-01-02"
"23250","2022","COM","2020","291","4","295","2023-01-02"
"23251","2022","COM","2020","120","2","122","2023-01-02"
"23252","2022","COM","2020","153","3","156","2023-01-02"
"23253","2022","COM","2020","177","6","183","2023-01-02"
"23254","2022","COM","2020","250","2","252","2023-01-02"
"23255","2022","COM","2020","123","0","123","2023-01-02"
"23257","2022","COM","2020","715","13","728","2023-01-02"
"23258","2022","COM","2020","305","9","314","2023-01-02"
"23259","2022","COM","2020","120","1","121","2023-01-02"
"23260","2022","COM","2020","191","1","192","2023-01-02"
"23261","2022","COM","2020","280","4","284","2023-01-02"
"23262","2022","COM","2020","164","2","166","2023-01-02"
"23263","2022","COM","2020","378","5","383","2023-01-02"
"23264","2022","COM","2020","48","1","49","2023-01-02"
"23265","2022","COM","2020","49","0","49","2023-01-02"
"23266","2022","COM","2020","171","0","171","2023-01-02"
"24001","2022","COM","2020","627","9","636","2023-01-02"
"24002","2022","COM","2020","1791","24","1815","2023-01-02"
"24004","2022","COM","2020","285","3","288","2023-01-02"
"24005","2022","COM","2020","392","9","401","2023-01-02"
"24006","2022","COM","2020","194","8","202","2023-01-02"
"24007","2022","COM","2020","514","8","522","2023-01-02"
"24008","2022","COM","2020","588","11","599","2023-01-02"
"24009","2022","COM","2020","265","9","274","2023-01-02"
"24010","2022","COM","2020","1412","50","1462","2023-01-02"
"24011","2022","COM","2020","1293","19","1312","2023-01-02"
"24012","2022","COM","2020","390","10","400","2023-01-02"
"24014","2022","COM","2020","617","20","637","2023-01-02"
"24015","2022","COM","2020","263","4","267","2023-01-02"
"24016","2022","COM","2020","824","19","843","2023-01-02"
"24018","2022","COM","2020","401","10","411","2023-01-02"
"24019","2022","COM","2020","440","7","447","2023-01-02"
"24020","2022","COM","2020","894","21","915","2023-01-02"
"24021","2022","COM","2020","386","8","394","2023-01-02"
"24022","2022","COM","2020","208","5","213","2023-01-02"
"24023","2022","COM","2020","324","13","337","2023-01-02"
"24024","2022","COM","2020","46","0","46","2023-01-02"
"24025","2022","COM","2020","237","7","244","2023-01-02"
"24026","2022","COM","2020","4364","83","4447","2023-01-02"
"24027","2022","COM","2020","358","1","359","2023-01-02"
"24028","2022","COM","2020","1803","35","1838","2023-01-02"
"24029","2022","COM","2020","533","6","539","2023-01-02"
"24030","2022","COM","2020","681","16","697","2023-01-02"
"24031","2022","COM","2020","273","5","278","2023-01-02"
"24032","2022","COM","2020","371","10","381","2023-01-02"
"24034","2022","COM","2020","272","8","280","2023-01-02"
"24035","2022","COM","2020","1337","36","1373","2023-01-02"
"24036","2022","COM","2020","177","3","180","2023-01-02"
"24037","2022","COM","2020","26360","741","27101","2023-01-02"
"24038","2022","COM","2020","430","13","443","2023-01-02"
"24039","2022","COM","2020","163","4","167","2023-01-02"
"24040","2022","COM","2020","546","9","555","2023-01-02"
"24042","2022","COM","2020","681","7","688","2023-01-02"
"24043","2022","COM","2020","142","10","152","2023-01-02"
"24045","2022","COM","2020","246","4","250","2023-01-02"
"24046","2022","COM","2020","117","3","120","2023-01-02"
"24048","2022","COM","2020","315","11","326","2023-01-02"
"24050","2022","COM","2020","345","4","349","2023-01-02"
"24051","2022","COM","2020","219","1","220","2023-01-02"
"24052","2022","COM","2020","128","0","128","2023-01-02"
"24053","2022","COM","2020","10738","352","11090","2023-01-02"
"24054","2022","COM","2020","609","20","629","2023-01-02"
"24055","2022","COM","2020","771","16","787","2023-01-02"
"24056","2022","COM","2020","228","4","232","2023-01-02"
"24057","2022","COM","2020","69","2","71","2023-01-02"
"24058","2022","COM","2020","216","5","221","2023-01-02"
"24059","2022","COM","2020","349","4","353","2023-01-02"
"24060","2022","COM","2020","71","1","72","2023-01-02"
"24061","2022","COM","2020","124","6","130","2023-01-02"
"24062","2022","COM","2020","177","3","180","2023-01-02"
"24063","2022","COM","2020","150","3","153","2023-01-02"
"24064","2022","COM","2020","3694","68","3762","2023-01-02"
"24066","2022","COM","2020","211","5","216","2023-01-02"
"24067","2022","COM","2020","2595","40","2635","2023-01-02"
"24068","2022","COM","2020","1936","49","1985","2023-01-02"
"24069","2022","COM","2020","398","2","400","2023-01-02"
"24070","2022","COM","2020","505","8","513","2023-01-02"
"24071","2022","COM","2020","373","2","375","2023-01-02"
"24073","2022","COM","2020","377","12","389","2023-01-02"
"24074","2022","COM","2020","520","14","534","2023-01-02"
"24075","2022","COM","2020","321","8","329","2023-01-02"
"24076","2022","COM","2020","416","14","430","2023-01-02"
"24077","2022","COM","2020","390","7","397","2023-01-02"
"24080","2022","COM","2020","463","12","475","2023-01-02"
"24081","2022","COM","2020","640","10","650","2023-01-02"
"24082","2022","COM","2020","1530","28","1558","2023-01-02"
"24083","2022","COM","2020","184","4","188","2023-01-02"
"24084","2022","COM","2020","104","4","108","2023-01-02"
"24085","2022","COM","2020","155","1","156","2023-01-02"
"24086","2022","COM","2020","447","7","454","2023-01-02"
"24087","2022","COM","2020","812","17","829","2023-01-02"
"24088","2022","COM","2020","346","7","353","2023-01-02"
"24090","2022","COM","2020","594","11","605","2023-01-02"
"24091","2022","COM","2020","1199","31","1230","2023-01-02"
"24094","2022","COM","2020","441","9","450","2023-01-02"
"24095","2022","COM","2020","403","9","412","2023-01-02"
"24096","2022","COM","2020","786","14","800","2023-01-02"
"24097","2022","COM","2020","350","14","364","2023-01-02"
"24098","2022","COM","2020","2980","91","3071","2023-01-02"
"24100","2022","COM","2020","452","4","456","2023-01-02"
"24101","2022","COM","2020","279","7","286","2023-01-02"
"24102","2022","COM","2020","4419","83","4502","2023-01-02"
"24104","2022","COM","2020","619","7","626","2023-01-02"
"24105","2022","COM","2020","137","1","138","2023-01-02"
"24106","2022","COM","2020","533","23","556","2023-01-02"
"24107","2022","COM","2020","395","8","403","2023-01-02"
"24108","2022","COM","2020","1076","15","1091","2023-01-02"
"24109","2022","COM","2020","102","3","105","2023-01-02"
"24110","2022","COM","2020","60","4","64","2023-01-02"
"24111","2022","COM","2020","74","1","75","2023-01-02"
"24113","2022","COM","2020","89","3","92","2023-01-02"
"24114","2022","COM","2020","68","2","70","2023-01-02"
"24115","2022","COM","2020","2138","33","2171","2023-01-02"
"24116","2022","COM","2020","184","1","185","2023-01-02"
"24117","2022","COM","2020","563","18","581","2023-01-02"
"24119","2022","COM","2020","237","4","241","2023-01-02"
"24120","2022","COM","2020","554","6","560","2023-01-02"
"24121","2022","COM","2020","62","1","63","2023-01-02"
"24122","2022","COM","2020","103","4","107","2023-01-02"
"24123","2022","COM","2020","120","1","121","2023-01-02"
"24124","2022","COM","2020","234","6","240","2023-01-02"
"24126","2022","COM","2020","268","12","280","2023-01-02"
"24128","2022","COM","2020","164","3","167","2023-01-02"
"24129","2022","COM","2020","476","8","484","2023-01-02"
"24130","2022","COM","2020","882","16","898","2023-01-02"
"24131","2022","COM","2020","70","1","71","2023-01-02"
"24132","2022","COM","2020","268","4","272","2023-01-02"
"24133","2022","COM","2020","1269","17","1286","2023-01-02"
"24134","2022","COM","2020","846","14","860","2023-01-02"
"24135","2022","COM","2020","687","12","699","2023-01-02"
"24136","2022","COM","2020","113","6","119","2023-01-02"
"24137","2022","COM","2020","725","77","802","2023-01-02"
"24138","2022","COM","2020","7316","297","7613","2023-01-02"
"24139","2022","COM","2020","2242","49","2291","2023-01-02"
"24140","2022","COM","2020","1558","39","1597","2023-01-02"
"24141","2022","COM","2020","188","3","191","2023-01-02"
"24142","2022","COM","2020","1218","42","1260","2023-01-02"
"24143","2022","COM","2020","729","9","738","2023-01-02"
"24144","2022","COM","2020","98","0","98","2023-01-02"
"24145","2022","COM","2020","1751","34","1785","2023-01-02"
"24146","2022","COM","2020","252","9","261","2023-01-02"
"24147","2022","COM","2020","1100","12","1112","2023-01-02"
"24148","2022","COM","2020","295","3","298","2023-01-02"
"24150","2022","COM","2020","527","19","546","2023-01-02"
"24151","2022","COM","2020","102","2","104","2023-01-02"
"24152","2022","COM","2020","907","23","930","2023-01-02"
"24153","2022","COM","2020","398","12","410","2023-01-02"
"24154","2022","COM","2020","350","10","360","2023-01-02"
"24155","2022","COM","2020","462","6","468","2023-01-02"
"24156","2022","COM","2020","1162","17","1179","2023-01-02"
"24157","2022","COM","2020","810","14","824","2023-01-02"
"24158","2022","COM","2020","408","4","412","2023-01-02"
"24159","2022","COM","2020","392","8","400","2023-01-02"
"24160","2022","COM","2020","571","2","573","2023-01-02"
"24161","2022","COM","2020","123","1","124","2023-01-02"
"24162","2022","COM","2020","400","9","409","2023-01-02"
"24163","2022","COM","2020","161","2","163","2023-01-02"
"24164","2022","COM","2020","1176","28","1204","2023-01-02"
"24165","2022","COM","2020","413","6","419","2023-01-02"
"24167","2022","COM","2020","2547","41","2588","2023-01-02"
"24168","2022","COM","2020","423","13","436","2023-01-02"
"24171","2022","COM","2020","556","8","564","2023-01-02"
"24172","2022","COM","2020","1109","20","1129","2023-01-02"
"24174","2022","COM","2020","143","1","144","2023-01-02"
"24175","2022","COM","2020","310","17","327","2023-01-02"
"24176","2022","COM","2020","36","0","36","2023-01-02"
"24177","2022","COM","2020","652","8","660","2023-01-02"
"24179","2022","COM","2020","789","29","818","2023-01-02"
"24180","2022","COM","2020","312","6","318","2023-01-02"
"24182","2022","COM","2020","1492","52","1544","2023-01-02"
"24183","2022","COM","2020","300","3","303","2023-01-02"
"24184","2022","COM","2020","149","2","151","2023-01-02"
"24186","2022","COM","2020","332","2","334","2023-01-02"
"24188","2022","COM","2020","542","10","552","2023-01-02"
"24189","2022","COM","2020","447","16","463","2023-01-02"
"24190","2022","COM","2020","268","8","276","2023-01-02"
"24191","2022","COM","2020","172","1","173","2023-01-02"
"24192","2022","COM","2020","93","3","96","2023-01-02"
"24193","2022","COM","2020","478","8","486","2023-01-02"
"24194","2022","COM","2020","1588","28","1616","2023-01-02"
"24195","2022","COM","2020","108","1","109","2023-01-02"
"24196","2022","COM","2020","494","4","498","2023-01-02"
"24197","2022","COM","2020","733","16","749","2023-01-02"
"24199","2022","COM","2020","367","8","375","2023-01-02"
"24200","2022","COM","2020","545","11","556","2023-01-02"
"24202","2022","COM","2020","143","4","147","2023-01-02"
"24205","2022","COM","2020","669","5","674","2023-01-02"
"24206","2022","COM","2020","107","4","111","2023-01-02"
"24207","2022","COM","2020","654","16","670","2023-01-02"
"24208","2022","COM","2020","243","4","247","2023-01-02"
"24209","2022","COM","2020","139","1","140","2023-01-02"
"24210","2022","COM","2020","823","19","842","2023-01-02"
"24211","2022","COM","2020","430","3","433","2023-01-02"
"24212","2022","COM","2020","746","9","755","2023-01-02"
"24213","2022","COM","2020","174","2","176","2023-01-02"
"24214","2022","COM","2020","829","10","839","2023-01-02"
"24215","2022","COM","2020","181","6","187","2023-01-02"
"24216","2022","COM","2020","152","4","156","2023-01-02"
"24217","2022","COM","2020","455","8","463","2023-01-02"
"24218","2022","COM","2020","1144","43","1187","2023-01-02"
"24220","2022","COM","2020","686","10","696","2023-01-02"
"24221","2022","COM","2020","157","4","161","2023-01-02"
"24222","2022","COM","2020","2641","89","2730","2023-01-02"
"24223","2022","COM","2020","2827","46","2873","2023-01-02"
"24224","2022","COM","2020","690","12","702","2023-01-02"
"24225","2022","COM","2020","2738","43","2781","2023-01-02"
"24226","2022","COM","2020","1390","21","1411","2023-01-02"
"24227","2022","COM","2020","963","24","987","2023-01-02"
"24228","2022","COM","2020","498","11","509","2023-01-02"
"24229","2022","COM","2020","1672","38","1710","2023-01-02"
"24230","2022","COM","2020","148","1","149","2023-01-02"
"24231","2022","COM","2020","100","1","101","2023-01-02"
"24232","2022","COM","2020","72","2","74","2023-01-02"
"24234","2022","COM","2020","379","2","381","2023-01-02"
"24236","2022","COM","2020","987","16","1003","2023-01-02"
"24237","2022","COM","2020","1241","25","1266","2023-01-02"
"24238","2022","COM","2020","136","5","141","2023-01-02"
"24240","2022","COM","2020","334","8","342","2023-01-02"
"24241","2022","COM","2020","438","7","445","2023-01-02"
"24242","2022","COM","2020","256","1","257","2023-01-02"
"24243","2022","COM","2020","825","12","837","2023-01-02"
"24244","2022","COM","2020","191","2","193","2023-01-02"
"24245","2022","COM","2020","259","4","263","2023-01-02"
"24246","2022","COM","2020","426","4","430","2023-01-02"
"24247","2022","COM","2020","161","4","165","2023-01-02"
"24248","2022","COM","2020","286","6","292","2023-01-02"
"24251","2022","COM","2020","554","9","563","2023-01-02"
"24252","2022","COM","2020","818","20","838","2023-01-02"
"24253","2022","COM","2020","2290","41","2331","2023-01-02"
"24254","2022","COM","2020","183","1","184","2023-01-02"
"24255","2022","COM","2020","582","9","591","2023-01-02"
"24256","2022","COM","2020","3147","75","3222","2023-01-02"
"24257","2022","COM","2020","229","5","234","2023-01-02"
"24259","2022","COM","2020","1587","28","1615","2023-01-02"
"24260","2022","COM","2020","870","10","880","2023-01-02"
"24261","2022","COM","2020","284","10","294","2023-01-02"
"24262","2022","COM","2020","338","9","347","2023-01-02"
"24263","2022","COM","2020","302","13","315","2023-01-02"
"24264","2022","COM","2020","1863","21","1884","2023-01-02"
"24266","2022","COM","2020","1520","27","1547","2023-01-02"
"24267","2022","COM","2020","179","1","180","2023-01-02"
"24268","2022","COM","2020","677","15","692","2023-01-02"
"24269","2022","COM","2020","635","5","640","2023-01-02"
"24271","2022","COM","2020","492","14","506","2023-01-02"
"24272","2022","COM","2020","477","5","482","2023-01-02"
"24273","2022","COM","2020","337","10","347","2023-01-02"
"24274","2022","COM","2020","800","88","888","2023-01-02"
"24276","2022","COM","2020","406","4","410","2023-01-02"
"24277","2022","COM","2020","288","4","292","2023-01-02"
"24278","2022","COM","2020","82","1","83","2023-01-02"
"24279","2022","COM","2020","62","1","63","2023-01-02"
"24280","2022","COM","2020","452","5","457","2023-01-02"
"24281","2022","COM","2020","188","2","190","2023-01-02"
"24282","2022","COM","2020","141","7","148","2023-01-02"
"24284","2022","COM","2020","135","5","140","2023-01-02"
"24285","2022","COM","2020","418","15","433","2023-01-02"
"24286","2022","COM","2020","503","11","514","2023-01-02"
"24287","2022","COM","2020","127","2","129","2023-01-02"
"24288","2022","COM","2020","283","4","287","2023-01-02"
"24289","2022","COM","2020","1453","19","1472","2023-01-02"
"24290","2022","COM","2020","155","4","159","2023-01-02"
"24291","2022","COM","2020","2757","54","2811","2023-01-02"
"24292","2022","COM","2020","472","13","485","2023-01-02"
"24293","2022","COM","2020","289","9","298","2023-01-02"
"24294","2022","COM","2020","5807","71","5878","2023-01-02"
"24295","2022","COM","2020","1197","21","1218","2023-01-02"
"24296","2022","COM","2020","1144","11","1155","2023-01-02"
"24297","2022","COM","2020","947","12","959","2023-01-02"
"24299","2022","COM","2020","2788","48","2836","2023-01-02"
"24300","2022","COM","2020","368","9","377","2023-01-02"
"24301","2022","COM","2020","386","4","390","2023-01-02"
"24302","2022","COM","2020","296","2","298","2023-01-02"
"24303","2022","COM","2020","231","2","233","2023-01-02"
"24304","2022","COM","2020","974","23","997","2023-01-02"
"24305","2022","COM","2020","238","2","240","2023-01-02"
"24306","2022","COM","2020","127","4","131","2023-01-02"
"24307","2022","COM","2020","255","4","259","2023-01-02"
"24308","2022","COM","2020","792","10","802","2023-01-02"
"24309","2022","COM","2020","3618","63","3681","2023-01-02"
"24311","2022","COM","2020","3040","111","3151","2023-01-02"
"24312","2022","COM","2020","4665","104","4769","2023-01-02"
"24313","2022","COM","2020","49","0","49","2023-01-02"
"24316","2022","COM","2020","796","16","812","2023-01-02"
"24317","2022","COM","2020","251","8","259","2023-01-02"
"24318","2022","COM","2020","314","8","322","2023-01-02"
"24319","2022","COM","2020","478","10","488","2023-01-02"
"24320","2022","COM","2020","971","18","989","2023-01-02"
"24321","2022","COM","2020","850","15","865","2023-01-02"
"24322","2022","COM","2020","29255","1568","30823","2023-01-02"
"24323","2022","COM","2020","184","5","189","2023-01-02"
"24324","2022","COM","2020","574","9","583","2023-01-02"
"24325","2022","COM","2020","760","26","786","2023-01-02"
"24326","2022","COM","2020","194","2","196","2023-01-02"
"24327","2022","COM","2020","128","3","131","2023-01-02"
"24328","2022","COM","2020","1187","19","1206","2023-01-02"
"24329","2022","COM","2020","1351","21","1372","2023-01-02"
"24330","2022","COM","2020","696","12","708","2023-01-02"
"24331","2022","COM","2020","726","20","746","2023-01-02"
"24334","2022","COM","2020","195","5","200","2023-01-02"
"24335","2022","COM","2020","2487","43","2530","2023-01-02"
"24336","2022","COM","2020","529","19","548","2023-01-02"
"24337","2022","COM","2020","146","2","148","2023-01-02"
"24338","2022","COM","2020","435","7","442","2023-01-02"
"24339","2022","COM","2020","145","0","145","2023-01-02"
"24340","2022","COM","2020","4223","76","4299","2023-01-02"
"24341","2022","COM","2020","1055","21","1076","2023-01-02"
"24345","2022","COM","2020","488","12","500","2023-01-02"
"24346","2022","COM","2020","385","9","394","2023-01-02"
"24347","2022","COM","2020","142","0","142","2023-01-02"
"24348","2022","COM","2020","313","1","314","2023-01-02"
"24349","2022","COM","2020","342","9","351","2023-01-02"
"24350","2022","COM","2020","2371","48","2419","2023-01-02"
"24351","2022","COM","2020","313","6","319","2023-01-02"
"24352","2022","COM","2020","3837","152","3989","2023-01-02"
"24353","2022","COM","2020","332","9","341","2023-01-02"
"24354","2022","COM","2020","3009","51","3060","2023-01-02"
"24355","2022","COM","2020","429","3","432","2023-01-02"
"24356","2022","COM","2020","1630","35","1665","2023-01-02"
"24357","2022","COM","2020","298","7","305","2023-01-02"
"24359","2022","COM","2020","116","2","118","2023-01-02"
"24360","2022","COM","2020","317","5","322","2023-01-02"
"24361","2022","COM","2020","450","7","457","2023-01-02"
"24362","2022","COM","2020","1588","21","1609","2023-01-02"
"24364","2022","COM","2020","588","16","604","2023-01-02"
"24365","2022","COM","2020","245","8","253","2023-01-02"
"24366","2022","COM","2020","863","20","883","2023-01-02"
"24367","2022","COM","2020","181","1","182","2023-01-02"
"24370","2022","COM","2020","1849","41","1890","2023-01-02"
"24371","2022","COM","2020","465","2","467","2023-01-02"
"24372","2022","COM","2020","5340","89","5429","2023-01-02"
"24373","2022","COM","2020","343","8","351","2023-01-02"
"24374","2022","COM","2020","357","4","361","2023-01-02"
"24375","2022","COM","2020","150","3","153","2023-01-02"
"24376","2022","COM","2020","1422","19","1441","2023-01-02"
"24377","2022","COM","2020","155","3","158","2023-01-02"
"24378","2022","COM","2020","83","1","84","2023-01-02"
"24379","2022","COM","2020","412","4","416","2023-01-02"
"24380","2022","COM","2020","495","2","497","2023-01-02"
"24381","2022","COM","2020","212","8","220","2023-01-02"
"24382","2022","COM","2020","526","9","535","2023-01-02"
"24383","2022","COM","2020","165","2","167","2023-01-02"
"24384","2022","COM","2020","35","2","37","2023-01-02"
"24385","2022","COM","2020","224","2","226","2023-01-02"
"24386","2022","COM","2020","205","10","215","2023-01-02"
"24388","2022","COM","2020","489","15","504","2023-01-02"
"24390","2022","COM","2020","335","9","344","2023-01-02"
"24392","2022","COM","2020","523","8","531","2023-01-02"
"24393","2022","COM","2020","88","0","88","2023-01-02"
"24394","2022","COM","2020","151","7","158","2023-01-02"
"24395","2022","COM","2020","366","6","372","2023-01-02"
"24396","2022","COM","2020","1538","34","1572","2023-01-02"
"24397","2022","COM","2020","258","8","266","2023-01-02"
"24398","2022","COM","2020","592","8","600","2023-01-02"
"24399","2022","COM","2020","106","4","110","2023-01-02"
"24401","2022","COM","2020","297","4","301","2023-01-02"
"24403","2022","COM","2020","66","0","66","2023-01-02"
"24404","2022","COM","2020","177","1","178","2023-01-02"
"24405","2022","COM","2020","328","9","337","2023-01-02"
"24406","2022","COM","2020","140","2","142","2023-01-02"
"24407","2022","COM","2020","241","7","248","2023-01-02"
"24408","2022","COM","2020","256","3","259","2023-01-02"
"24409","2022","COM","2020","1178","27","1205","2023-01-02"
"24410","2022","COM","2020","498","8","506","2023-01-02"
"24411","2022","COM","2020","162","3","165","2023-01-02"
"24412","2022","COM","2020","906","26","932","2023-01-02"
"24413","2022","COM","2020","279","0","279","2023-01-02"
"24414","2022","COM","2020","280","5","285","2023-01-02"
"24415","2022","COM","2020","237","6","243","2023-01-02"
"24416","2022","COM","2020","169","9","178","2023-01-02"
"24417","2022","COM","2020","466","8","474","2023-01-02"
"24418","2022","COM","2020","933","18","951","2023-01-02"
"24419","2022","COM","2020","874","19","893","2023-01-02"
"24420","2022","COM","2020","248","2","250","2023-01-02"
"24421","2022","COM","2020","195","5","200","2023-01-02"
"24422","2022","COM","2020","118","2","120","2023-01-02"
"24423","2022","COM","2020","310","2","312","2023-01-02"
"24424","2022","COM","2020","133","3","136","2023-01-02"
"24425","2022","COM","2020","369","6","375","2023-01-02"
"24426","2022","COM","2020","161","6","167","2023-01-02"
"24428","2022","COM","2020","581","38","619","2023-01-02"
"24429","2022","COM","2020","238","8","246","2023-01-02"
"24432","2022","COM","2020","643","15","658","2023-01-02"
"24434","2022","COM","2020","146","3","149","2023-01-02"
"24436","2022","COM","2020","1027","19","1046","2023-01-02"
"24437","2022","COM","2020","974","14","988","2023-01-02"
"24438","2022","COM","2020","236","9","245","2023-01-02"
"24441","2022","COM","2020","143","3","146","2023-01-02"
"24442","2022","COM","2020","2029","30","2059","2023-01-02"
"24443","2022","COM","2020","421","13","434","2023-01-02"
"24444","2022","COM","2020","304","7","311","2023-01-02"
"24445","2022","COM","2020","144","5","149","2023-01-02"
"24446","2022","COM","2020","49","3","52","2023-01-02"
"24448","2022","COM","2020","479","10","489","2023-01-02"
"24449","2022","COM","2020","942","15","957","2023-01-02"
"24450","2022","COM","2020","571","4","575","2023-01-02"
"24451","2022","COM","2020","800","19","819","2023-01-02"
"24452","2022","COM","2020","186","2","188","2023-01-02"
"24453","2022","COM","2020","363","6","369","2023-01-02"
"24454","2022","COM","2020","652","7","659","2023-01-02"
"24455","2022","COM","2020","739","10","749","2023-01-02"
"24456","2022","COM","2020","196","3","199","2023-01-02"
"24457","2022","COM","2020","138","2","140","2023-01-02"
"24458","2022","COM","2020","262","7","269","2023-01-02"
"24459","2022","COM","2020","285","10","295","2023-01-02"
"24460","2022","COM","2020","498","6","504","2023-01-02"
"24461","2022","COM","2020","815","11","826","2023-01-02"
"24462","2022","COM","2020","1677","33","1710","2023-01-02"
"24463","2022","COM","2020","542","15","557","2023-01-02"
"24464","2022","COM","2020","326","6","332","2023-01-02"
"24465","2022","COM","2020","233","5","238","2023-01-02"
"24466","2022","COM","2020","325","5","330","2023-01-02"
"24468","2022","COM","2020","300","6","306","2023-01-02"
"24470","2022","COM","2020","272","6","278","2023-01-02"
"24471","2022","COM","2020","629","12","641","2023-01-02"
"24472","2022","COM","2020","992","17","1009","2023-01-02"
"24473","2022","COM","2020","351","6","357","2023-01-02"
"24474","2022","COM","2020","158","1","159","2023-01-02"
"24476","2022","COM","2020","158","3","161","2023-01-02"
"24477","2022","COM","2020","192","2","194","2023-01-02"
"24478","2022","COM","2020","192","0","192","2023-01-02"
"24479","2022","COM","2020","1169","20","1189","2023-01-02"
"24480","2022","COM","2020","313","3","316","2023-01-02"
"24481","2022","COM","2020","514","0","514","2023-01-02"
"24482","2022","COM","2020","277","2","279","2023-01-02"
"24483","2022","COM","2020","142","7","149","2023-01-02"
"24484","2022","COM","2020","889","16","905","2023-01-02"
"24485","2022","COM","2020","415","3","418","2023-01-02"
"24486","2022","COM","2020","406","3","409","2023-01-02"
"24487","2022","COM","2020","1814","15","1829","2023-01-02"
"24488","2022","COM","2020","343","5","348","2023-01-02"
"24489","2022","COM","2020","375","7","382","2023-01-02"
"24490","2022","COM","2020","1116","15","1131","2023-01-02"
"24491","2022","COM","2020","579","11","590","2023-01-02"
"24492","2022","COM","2020","66","2","68","2023-01-02"
"24493","2022","COM","2020","93","2","95","2023-01-02"
"24494","2022","COM","2020","504","4","508","2023-01-02"
"24495","2022","COM","2020","116","3","119","2023-01-02"
"24496","2022","COM","2020","328","4","332","2023-01-02"
"24498","2022","COM","2020","825","20","845","2023-01-02"
"24499","2022","COM","2020","862","21","883","2023-01-02"
"24500","2022","COM","2020","146","7","153","2023-01-02"
"24501","2022","COM","2020","483","5","488","2023-01-02"
"24502","2022","COM","2020","89","0","89","2023-01-02"
"24504","2022","COM","2020","282","1","283","2023-01-02"
"24505","2022","COM","2020","351","3","354","2023-01-02"
"24507","2022","COM","2020","110","2","112","2023-01-02"
"24508","2022","COM","2020","213","5","218","2023-01-02"
"24509","2022","COM","2020","667","12","679","2023-01-02"
"24510","2022","COM","2020","369","10","379","2023-01-02"
"24511","2022","COM","2020","256","3","259","2023-01-02"
"24512","2022","COM","2020","293","11","304","2023-01-02"
"24513","2022","COM","2020","313","3","316","2023-01-02"
"24514","2022","COM","2020","242","2","244","2023-01-02"
"24515","2022","COM","2020","724","5","729","2023-01-02"
"24516","2022","COM","2020","1189","54","1243","2023-01-02"
"24517","2022","COM","2020","73","2","75","2023-01-02"
"24518","2022","COM","2020","286","4","290","2023-01-02"
"24519","2022","COM","2020","431","5","436","2023-01-02"
"24520","2022","COM","2020","8788","404","9192","2023-01-02"
"24521","2022","COM","2020","1031","19","1050","2023-01-02"
"24522","2022","COM","2020","361","11","372","2023-01-02"
"24523","2022","COM","2020","423","12","435","2023-01-02"
"24524","2022","COM","2020","178","2","180","2023-01-02"
"24525","2022","COM","2020","197","2","199","2023-01-02"
"24526","2022","COM","2020","714","9","723","2023-01-02"
"24527","2022","COM","2020","938","16","954","2023-01-02"
"24528","2022","COM","2020","127","2","129","2023-01-02"
"24529","2022","COM","2020","200","2","202","2023-01-02"
"24531","2022","COM","2020","212","3","215","2023-01-02"
"24532","2022","COM","2020","250","3","253","2023-01-02"
"24533","2022","COM","2020","79","4","83","2023-01-02"
"24534","2022","COM","2020","1192","238","1430","2023-01-02"
"24535","2022","COM","2020","252","3","255","2023-01-02"
"24536","2022","COM","2020","311","5","316","2023-01-02"
"24537","2022","COM","2020","250","4","254","2023-01-02"
"24538","2022","COM","2020","1062","11","1073","2023-01-02"
"24540","2022","COM","2020","1601","29","1630","2023-01-02"
"24541","2022","COM","2020","93","1","94","2023-01-02"
"24542","2022","COM","2020","74","3","77","2023-01-02"
"24543","2022","COM","2020","1111","17","1128","2023-01-02"
"24544","2022","COM","2020","392","9","401","2023-01-02"
"24545","2022","COM","2020","98","1","99","2023-01-02"
"24546","2022","COM","2020","36","0","36","2023-01-02"
"24547","2022","COM","2020","6264","106","6370","2023-01-02"
"24548","2022","COM","2020","275","4","279","2023-01-02"
"24549","2022","COM","2020","480","5","485","2023-01-02"
"24550","2022","COM","2020","1254","16","1270","2023-01-02"
"24551","2022","COM","2020","2870","190","3060","2023-01-02"
"24552","2022","COM","2020","256","6","262","2023-01-02"
"24553","2022","COM","2020","1738","36","1774","2023-01-02"
"24554","2022","COM","2020","563","14","577","2023-01-02"
"24555","2022","COM","2020","639","10","649","2023-01-02"
"24557","2022","COM","2020","7191","199","7390","2023-01-02"
"24558","2022","COM","2020","630","5","635","2023-01-02"
"24559","2022","COM","2020","332","10","342","2023-01-02"
"24560","2022","COM","2020","114","7","121","2023-01-02"
"24562","2022","COM","2020","267","12","279","2023-01-02"
"24563","2022","COM","2020","281","7","288","2023-01-02"
"24564","2022","COM","2020","690","106","796","2023-01-02"
"24565","2022","COM","2020","368","8","376","2023-01-02"
"24566","2022","COM","2020","463","10","473","2023-01-02"
"24567","2022","COM","2020","248","3","251","2023-01-02"
"24568","2022","COM","2020","1053","12","1065","2023-01-02"
"24569","2022","COM","2020","129","1","130","2023-01-02"
"24570","2022","COM","2020","39","1","40","2023-01-02"
"24571","2022","COM","2020","1712","14","1726","2023-01-02"
"24572","2022","COM","2020","190","5","195","2023-01-02"
"24573","2022","COM","2020","547","12","559","2023-01-02"
"24574","2022","COM","2020","337","11","348","2023-01-02"
"24575","2022","COM","2020","232","22","254","2023-01-02"
"24576","2022","COM","2020","245","10","255","2023-01-02"
"24577","2022","COM","2020","516","10","526","2023-01-02"
"24580","2022","COM","2020","264","1","265","2023-01-02"
"24581","2022","COM","2020","908","19","927","2023-01-02"
"24582","2022","COM","2020","456","10","466","2023-01-02"
"24584","2022","COM","2020","963","19","982","2023-01-02"
"24585","2022","COM","2020","671","12","683","2023-01-02"
"24586","2022","COM","2020","912","19","931","2023-01-02"
"24587","2022","COM","2020","826","20","846","2023-01-02"
"25001","2022","COM","2020","247","6","253","2023-01-02"
"25002","2022","COM","2020","298","5","303","2023-01-02"
"25003","2022","COM","2020","321","6","327","2023-01-02"
"25004","2022","COM","2020","1068","20","1088","2023-01-02"
"25005","2022","COM","2020","89","1","90","2023-01-02"
"25006","2022","COM","2020","88","5","93","2023-01-02"
"25007","2022","COM","2020","108","3","111","2023-01-02"
"25008","2022","COM","2020","465","4","469","2023-01-02"
"25009","2022","COM","2020","163","3","166","2023-01-02"
"25011","2022","COM","2020","741","16","757","2023-01-02"
"25012","2022","COM","2020","170","5","175","2023-01-02"
"25013","2022","COM","2020","253","7","260","2023-01-02"
"25014","2022","COM","2020","936","11","947","2023-01-02"
"25015","2022","COM","2020","706","20","726","2023-01-02"
"25016","2022","COM","2020","167","3","170","2023-01-02"
"25017","2022","COM","2020","90","3","93","2023-01-02"
"25018","2022","COM","2020","613","21","634","2023-01-02"
"25019","2022","COM","2020","384","11","395","2023-01-02"
"25020","2022","COM","2020","902","9","911","2023-01-02"
"25021","2022","COM","2020","1614","29","1643","2023-01-02"
"25022","2022","COM","2020","1481","39","1520","2023-01-02"
"25024","2022","COM","2020","930","31","961","2023-01-02"
"25025","2022","COM","2020","717","13","730","2023-01-02"
"25026","2022","COM","2020","224","5","229","2023-01-02"
"25029","2022","COM","2020","248","3","251","2023-01-02"
"25030","2022","COM","2020","427","10","437","2023-01-02"
"25031","2022","COM","2020","13542","221","13763","2023-01-02"
"25032","2022","COM","2020","427","10","437","2023-01-02"
"25033","2022","COM","2020","516","10","526","2023-01-02"
"25035","2022","COM","2020","2512","46","2558","2023-01-02"
"25036","2022","COM","2020","2232","29","2261","2023-01-02"
"25038","2022","COM","2020","160","4","164","2023-01-02"
"25039","2022","COM","2020","927","19","946","2023-01-02"
"25040","2022","COM","2020","807","14","821","2023-01-02"
"25041","2022","COM","2020","370","9","379","2023-01-02"
"25042","2022","COM","2020","226","8","234","2023-01-02"
"25043","2022","COM","2020","2006","53","2059","2023-01-02"
"25044","2022","COM","2020","59","0","59","2023-01-02"
"25045","2022","COM","2020","47","1","48","2023-01-02"
"25046","2022","COM","2020","75","4","79","2023-01-02"
"25047","2022","COM","2020","4984","160","5144","2023-01-02"
"25048","2022","COM","2020","3604","74","3678","2023-01-02"
"25049","2022","COM","2020","136","5","141","2023-01-02"
"25050","2022","COM","2020","504","12","516","2023-01-02"
"25051","2022","COM","2020","622","13","635","2023-01-02"
"25052","2022","COM","2020","66","0","66","2023-01-02"
"25053","2022","COM","2020","93","7","100","2023-01-02"
"25054","2022","COM","2020","540","13","553","2023-01-02"
"25055","2022","COM","2020","356","7","363","2023-01-02"
"25056","2022","COM","2020","118258","3261","121519","2023-01-02"
"25057","2022","COM","2020","5336","68","5404","2023-01-02"
"25058","2022","COM","2020","1361","13","1374","2023-01-02"
"25059","2022","COM","2020","268","5","273","2023-01-02"
"25060","2022","COM","2020","699","24","723","2023-01-02"
"25061","2022","COM","2020","116","1","117","2023-01-02"
"25062","2022","COM","2020","297","11","308","2023-01-02"
"25063","2022","COM","2020","1210","26","1236","2023-01-02"
"25065","2022","COM","2020","54","4","58","2023-01-02"
"25066","2022","COM","2020","85","1","86","2023-01-02"
"25067","2022","COM","2020","190","3","193","2023-01-02"
"25070","2022","COM","2020","377","15","392","2023-01-02"
"25071","2022","COM","2020","477","4","481","2023-01-02"
"25072","2022","COM","2020","20","1","21","2023-01-02"
"25073","2022","COM","2020","830","6","836","2023-01-02"
"25074","2022","COM","2020","984","21","1005","2023-01-02"
"25075","2022","COM","2020","405","10","415","2023-01-02"
"25077","2022","COM","2020","75","0","75","2023-01-02"
"25078","2022","COM","2020","1064","25","1089","2023-01-02"
"25079","2022","COM","2020","445","7","452","2023-01-02"
"25082","2022","COM","2020","888","23","911","2023-01-02"
"25083","2022","COM","2020","190","2","192","2023-01-02"
"25084","2022","COM","2020","1169","19","1188","2023-01-02"
"25085","2022","COM","2020","400","8","408","2023-01-02"
"25086","2022","COM","2020","208","2","210","2023-01-02"
"25087","2022","COM","2020","179","3","182","2023-01-02"
"25088","2022","COM","2020","87","6","93","2023-01-02"
"25089","2022","COM","2020","98","2","100","2023-01-02"
"25090","2022","COM","2020","69","0","69","2023-01-02"
"25091","2022","COM","2020","476","8","484","2023-01-02"
"25092","2022","COM","2020","70","2","72","2023-01-02"
"25093","2022","COM","2020","76","0","76","2023-01-02"
"25094","2022","COM","2020","119","0","119","2023-01-02"
"25095","2022","COM","2020","284","3","287","2023-01-02"
"25096","2022","COM","2020","163","2","165","2023-01-02"
"25097","2022","COM","2020","478","12","490","2023-01-02"
"25098","2022","COM","2020","188","3","191","2023-01-02"
"25099","2022","COM","2020","241","7","248","2023-01-02"
"25100","2022","COM","2020","477","9","486","2023-01-02"
"25101","2022","COM","2020","574","13","587","2023-01-02"
"25102","2022","COM","2020","49","2","51","2023-01-02"
"25103","2022","COM","2020","649","4","653","2023-01-02"
"25104","2022","COM","2020","84","1","85","2023-01-02"
"25105","2022","COM","2020","608","6","614","2023-01-02"
"25106","2022","COM","2020","68","0","68","2023-01-02"
"25107","2022","COM","2020","195","1","196","2023-01-02"
"25108","2022","COM","2020","312","8","320","2023-01-02"
"25109","2022","COM","2020","325","10","335","2023-01-02"
"25110","2022","COM","2020","1031","19","1050","2023-01-02"
"25111","2022","COM","2020","364","13","377","2023-01-02"
"25112","2022","COM","2020","1323","26","1349","2023-01-02"
"25113","2022","COM","2020","141","5","146","2023-01-02"
"25114","2022","COM","2020","390","6","396","2023-01-02"
"25115","2022","COM","2020","277","4","281","2023-01-02"
"25116","2022","COM","2020","245","7","252","2023-01-02"
"25117","2022","COM","2020","89","0","89","2023-01-02"
"25119","2022","COM","2020","321","10","331","2023-01-02"
"25120","2022","COM","2020","394","10","404","2023-01-02"
"25121","2022","COM","2020","256","15","271","2023-01-02"
"25122","2022","COM","2020","528","12","540","2023-01-02"
"25124","2022","COM","2020","278","7","285","2023-01-02"
"25125","2022","COM","2020","323","5","328","2023-01-02"
"25126","2022","COM","2020","478","8","486","2023-01-02"
"25127","2022","COM","2020","2791","49","2840","2023-01-02"
"25129","2022","COM","2020","111","3","114","2023-01-02"
"25130","2022","COM","2020","10","0","10","2023-01-02"
"25131","2022","COM","2020","110","5","115","2023-01-02"
"25132","2022","COM","2020","142","4","146","2023-01-02"
"25133","2022","COM","2020","2007","55","2062","2023-01-02"
"25136","2022","COM","2020","499","13","512","2023-01-02"
"25138","2022","COM","2020","125","5","130","2023-01-02"
"25139","2022","COM","2020","606","10","616","2023-01-02"
"25141","2022","COM","2020","122","6","128","2023-01-02"
"25142","2022","COM","2020","329","3","332","2023-01-02"
"25143","2022","COM","2020","204","10","214","2023-01-02"
"25145","2022","COM","2020","118","1","119","2023-01-02"
"25147","2022","COM","2020","2067","40","2107","2023-01-02"
"25148","2022","COM","2020","497","5","502","2023-01-02"
"25149","2022","COM","2020","505","11","516","2023-01-02"
"25150","2022","COM","2020","290","3","293","2023-01-02"
"25151","2022","COM","2020","135","4","139","2023-01-02"
"25152","2022","COM","2020","160","0","160","2023-01-02"
"25153","2022","COM","2020","133","1","134","2023-01-02"
"25154","2022","COM","2020","265","10","275","2023-01-02"
"25155","2022","COM","2020","296","13","309","2023-01-02"
"25156","2022","COM","2020","1139","21","1160","2023-01-02"
"25157","2022","COM","2020","1331","29","1360","2023-01-02"
"25159","2022","COM","2020","1205","23","1228","2023-01-02"
"25160","2022","COM","2020","752","26","778","2023-01-02"
"25161","2022","COM","2020","28","4","32","2023-01-02"
"25162","2022","COM","2020","212","6","218","2023-01-02"
"25163","2022","COM","2020","105","1","106","2023-01-02"
"25164","2022","COM","2020","145","0","145","2023-01-02"
"25166","2022","COM","2020","84","6","90","2023-01-02"
"25170","2022","COM","2020","1388","42","1430","2023-01-02"
"25171","2022","COM","2020","105","2","107","2023-01-02"
"25172","2022","COM","2020","233","3","236","2023-01-02"
"25173","2022","COM","2020","148","4","152","2023-01-02"
"25174","2022","COM","2020","243","3","246","2023-01-02"
"25175","2022","COM","2020","91","1","92","2023-01-02"
"25176","2022","COM","2020","319","5","324","2023-01-02"
"25177","2022","COM","2020","148","5","153","2023-01-02"
"25178","2022","COM","2020","123","3","126","2023-01-02"
"25179","2022","COM","2020","61","2","63","2023-01-02"
"25180","2022","COM","2020","116","6","122","2023-01-02"
"25181","2022","COM","2020","151","6","157","2023-01-02"
"25182","2022","COM","2020","96","1","97","2023-01-02"
"25183","2022","COM","2020","76","2","78","2023-01-02"
"25184","2022","COM","2020","287","12","299","2023-01-02"
"25185","2022","COM","2020","68","3","71","2023-01-02"
"25186","2022","COM","2020","1044","24","1068","2023-01-02"
"25187","2022","COM","2020","502","6","508","2023-01-02"
"25188","2022","COM","2020","748","25","773","2023-01-02"
"25189","2022","COM","2020","184","6","190","2023-01-02"
"25190","2022","COM","2020","1584","25","1609","2023-01-02"
"25191","2022","COM","2020","450","10","460","2023-01-02"
"25192","2022","COM","2020","169","4","173","2023-01-02"
"25193","2022","COM","2020","1832","45","1877","2023-01-02"
"25194","2022","COM","2020","114","0","114","2023-01-02"
"25195","2022","COM","2020","1543","290","1833","2023-01-02"
"25196","2022","COM","2020","1380","26","1406","2023-01-02"
"25197","2022","COM","2020","620","10","630","2023-01-02"
"25198","2022","COM","2020","723","21","744","2023-01-02"
"25199","2022","COM","2020","342","7","349","2023-01-02"
"25200","2022","COM","2020","1343","36","1379","2023-01-02"
"25201","2022","COM","2020","766","15","781","2023-01-02"
"25202","2022","COM","2020","307","7","314","2023-01-02"
"25203","2022","COM","2020","184","2","186","2023-01-02"
"25204","2022","COM","2020","3235","74","3309","2023-01-02"
"25207","2022","COM","2020","620","17","637","2023-01-02"
"25208","2022","COM","2020","184","9","193","2023-01-02"
"25209","2022","COM","2020","125","4","129","2023-01-02"
"25210","2022","COM","2020","161","4","165","2023-01-02"
"25211","2022","COM","2020","87","1","88","2023-01-02"
"25212","2022","COM","2020","2703","51","2754","2023-01-02"
"25213","2022","COM","2020","745","23","768","2023-01-02"
"25214","2022","COM","2020","489","10","499","2023-01-02"
"25215","2022","COM","2020","88","0","88","2023-01-02"
"25216","2022","COM","2020","263","10","273","2023-01-02"
"25217","2022","COM","2020","603","10","613","2023-01-02"
"25218","2022","COM","2020","165","7","172","2023-01-02"
"25219","2022","COM","2020","637","14","651","2023-01-02"
"25220","2022","COM","2020","593","15","608","2023-01-02"
"25221","2022","COM","2020","64","0","64","2023-01-02"
"25222","2022","COM","2020","1607","37","1644","2023-01-02"
"25223","2022","COM","2020","322","9","331","2023-01-02"
"25224","2022","COM","2020","831","13","844","2023-01-02"
"25225","2022","COM","2020","187","1","188","2023-01-02"
"25226","2022","COM","2020","213","5","218","2023-01-02"
"25227","2022","COM","2020","285","0","285","2023-01-02"
"25228","2022","COM","2020","3721","63","3784","2023-01-02"
"25229","2022","COM","2020","392","4","396","2023-01-02"
"25230","2022","COM","2020","3245","54","3299","2023-01-02"
"25231","2022","COM","2020","120","2","122","2023-01-02"
"25232","2022","COM","2020","99","2","101","2023-01-02"
"25233","2022","COM","2020","286","10","296","2023-01-02"
"25234","2022","COM","2020","174","7","181","2023-01-02"
"25235","2022","COM","2020","320","7","327","2023-01-02"
"25236","2022","COM","2020","304","3","307","2023-01-02"
"25237","2022","COM","2020","2163","34","2197","2023-01-02"
"25238","2022","COM","2020","157","2","159","2023-01-02"
"25239","2022","COM","2020","181","2","183","2023-01-02"
"25240","2022","COM","2020","3157","125","3282","2023-01-02"
"25241","2022","COM","2020","140","6","146","2023-01-02"
"25242","2022","COM","2020","122","0","122","2023-01-02"
"25243","2022","COM","2020","807","19","826","2023-01-02"
"25244","2022","COM","2020","84","3","87","2023-01-02"
"25245","2022","COM","2020","1226","22","1248","2023-01-02"
"25246","2022","COM","2020","270","10","280","2023-01-02"
"25247","2022","COM","2020","84","3","87","2023-01-02"
"25248","2022","COM","2020","527","112","639","2023-01-02"
"25249","2022","COM","2020","62","2","64","2023-01-02"
"25251","2022","COM","2020","174","8","182","2023-01-02"
"25252","2022","COM","2020","117","0","117","2023-01-02"
"25253","2022","COM","2020","386","2","388","2023-01-02"
"25254","2022","COM","2020","1400","32","1432","2023-01-02"
"25255","2022","COM","2020","349","13","362","2023-01-02"
"25256","2022","COM","2020","900","14","914","2023-01-02"
"25257","2022","COM","2020","268","5","273","2023-01-02"
"25258","2022","COM","2020","2272","39","2311","2023-01-02"
"25259","2022","COM","2020","1933","37","1970","2023-01-02"
"25261","2022","COM","2020","80","0","80","2023-01-02"
"25262","2022","COM","2020","467","24","491","2023-01-02"
"25263","2022","COM","2020","254","2","256","2023-01-02"
"25264","2022","COM","2020","83","2","85","2023-01-02"
"25265","2022","COM","2020","1299","29","1328","2023-01-02"
"25266","2022","COM","2020","119","4","123","2023-01-02"
"25267","2022","COM","2020","682","19","701","2023-01-02"
"25268","2022","COM","2020","114","2","116","2023-01-02"
"25269","2022","COM","2020","62","1","63","2023-01-02"
"25270","2022","COM","2020","131","0","131","2023-01-02"
"25271","2022","COM","2020","1730","38","1768","2023-01-02"
"25273","2022","COM","2020","202","4","206","2023-01-02"
"25274","2022","COM","2020","340","2","342","2023-01-02"
"25275","2022","COM","2020","189","4","193","2023-01-02"
"25276","2022","COM","2020","168","2","170","2023-01-02"
"25277","2022","COM","2020","76","2","78","2023-01-02"
"25278","2022","COM","2020","566","13","579","2023-01-02"
"25279","2022","COM","2020","119","1","120","2023-01-02"
"25280","2022","COM","2020","154","4","158","2023-01-02"
"25281","2022","COM","2020","278","4","282","2023-01-02"
"25282","2022","COM","2020","781","13","794","2023-01-02"
"25283","2022","COM","2020","62","1","63","2023-01-02"
"25284","2022","COM","2020","5849","73","5922","2023-01-02"
"25285","2022","COM","2020","1499","26","1525","2023-01-02"
"25286","2022","COM","2020","123","5","128","2023-01-02"
"25287","2022","COM","2020","1784","42","1826","2023-01-02"
"25288","2022","COM","2020","734","19","753","2023-01-02"
"25289","2022","COM","2020","74","3","77","2023-01-02"
"25290","2022","COM","2020","96","2","98","2023-01-02"
"25293","2022","COM","2020","1288","51","1339","2023-01-02"
"25295","2022","COM","2020","308","5","313","2023-01-02"
"25296","2022","COM","2020","789","28","817","2023-01-02"
"25297","2022","COM","2020","160","3","163","2023-01-02"
"25298","2022","COM","2020","244","8","252","2023-01-02"
"25299","2022","COM","2020","111","1","112","2023-01-02"
"25300","2022","COM","2020","304","6","310","2023-01-02"
"25301","2022","COM","2020","867","26","893","2023-01-02"
"25303","2022","COM","2020","223","6","229","2023-01-02"
"25304","2022","COM","2020","3619","53","3672","2023-01-02"
"25305","2022","COM","2020","590","16","606","2023-01-02"
"25306","2022","COM","2020","123","2","125","2023-01-02"
"25307","2022","COM","2020","907","11","918","2023-01-02"
"25308","2022","COM","2020","464","6","470","2023-01-02"
"25309","2022","COM","2020","1159","37","1196","2023-01-02"
"25310","2022","COM","2020","100","1","101","2023-01-02"
"25311","2022","COM","2020","210","4","214","2023-01-02"
"25312","2022","COM","2020","66","1","67","2023-01-02"
"25313","2022","COM","2020","197","3","200","2023-01-02"
"25314","2022","COM","2020","272","2","274","2023-01-02"
"25315","2022","COM","2020","2849","71","2920","2023-01-02"
"25316","2022","COM","2020","237","5","242","2023-01-02"
"25317","2022","COM","2020","267","4","271","2023-01-02"
"25318","2022","COM","2020","1850","32","1882","2023-01-02"
"25320","2022","COM","2020","1218","35","1253","2023-01-02"
"25321","2022","COM","2020","5207","100","5307","2023-01-02"
"25322","2022","COM","2020","409","10","419","2023-01-02"
"25323","2022","COM","2020","448","6","454","2023-01-02"
"25324","2022","COM","2020","159","8","167","2023-01-02"
"25325","2022","COM","2020","232","8","240","2023-01-02"
"25326","2022","COM","2020","534","14","548","2023-01-02"
"25327","2022","COM","2020","70","0","70","2023-01-02"
"25328","2022","COM","2020","796","11","807","2023-01-02"
"25329","2022","COM","2020","35","1","36","2023-01-02"
"25330","2022","COM","2020","179","4","183","2023-01-02"
"25331","2022","COM","2020","251","5","256","2023-01-02"
"25332","2022","COM","2020","569","10","579","2023-01-02"
"25333","2022","COM","2020","347","15","362","2023-01-02"
"25334","2022","COM","2020","2269","242","2511","2023-01-02"
"25335","2022","COM","2020","150","5","155","2023-01-02"
"25336","2022","COM","2020","548","5","553","2023-01-02"
"25338","2022","COM","2020","99","1","100","2023-01-02"
"25339","2022","COM","2020","224","2","226","2023-01-02"
"25340","2022","COM","2020","191","5","196","2023-01-02"
"25341","2022","COM","2020","173","6","179","2023-01-02"
"25342","2022","COM","2020","78","3","81","2023-01-02"
"25343","2022","COM","2020","164","6","170","2023-01-02"
"25344","2022","COM","2020","45","0","45","2023-01-02"
"25345","2022","COM","2020","665","14","679","2023-01-02"
"25346","2022","COM","2020","183","2","185","2023-01-02"
"25347","2022","COM","2020","829","15","844","2023-01-02"
"25348","2022","COM","2020","611","9","620","2023-01-02"
"25349","2022","COM","2020","584","15","599","2023-01-02"
"25350","2022","COM","2020","730","22","752","2023-01-02"
"25351","2022","COM","2020","239","1","240","2023-01-02"
"25354","2022","COM","2020","158","2","160","2023-01-02"
"25355","2022","COM","2020","63","0","63","2023-01-02"
"25356","2022","COM","2020","4259","103","4362","2023-01-02"
"25357","2022","COM","2020","853","8","861","2023-01-02"
"25359","2022","COM","2020","158","5","163","2023-01-02"
"25360","2022","COM","2020","174","4","178","2023-01-02"
"25361","2022","COM","2020","851","26","877","2023-01-02"
"25362","2022","COM","2020","286","12","298","2023-01-02"
"25364","2022","COM","2020","1806","19","1825","2023-01-02"
"25365","2022","COM","2020","310","6","316","2023-01-02"
"25366","2022","COM","2020","191","6","197","2023-01-02"
"25367","2022","COM","2020","4795","150","4945","2023-01-02"
"25368","2022","COM","2020","1462","20","1482","2023-01-02"
"25369","2022","COM","2020","158","2","160","2023-01-02"
"25370","2022","COM","2020","2152","37","2189","2023-01-02"
"25371","2022","COM","2020","216","7","223","2023-01-02"
"25372","2022","COM","2020","277","6","283","2023-01-02"
"25373","2022","COM","2020","46","1","47","2023-01-02"
"25374","2022","COM","2020","553","17","570","2023-01-02"
"25375","2022","COM","2020","661","13","674","2023-01-02"
"25376","2022","COM","2020","158","5","163","2023-01-02"
"25377","2022","COM","2020","232","6","238","2023-01-02"
"25378","2022","COM","2020","342","8","350","2023-01-02"
"25379","2022","COM","2020","71","5","76","2023-01-02"
"25380","2022","COM","2020","1411","38","1449","2023-01-02"
"25381","2022","COM","2020","2658","37","2695","2023-01-02"
"25382","2022","COM","2020","612","5","617","2023-01-02"
"25383","2022","COM","2020","272","7","279","2023-01-02"
"25384","2022","COM","2020","91","5","96","2023-01-02"
"25385","2022","COM","2020","126","3","129","2023-01-02"
"25386","2022","COM","2020","122","4","126","2023-01-02"
"25387","2022","COM","2020","375","9","384","2023-01-02"
"25388","2022","COM","2020","25726","543","26269","2023-01-02"
"25389","2022","COM","2020","113","4","117","2023-01-02"
"25390","2022","COM","2020","398","12","410","2023-01-02"
"25391","2022","COM","2020","185","6","191","2023-01-02"
"25392","2022","COM","2020","198","5","203","2023-01-02"
"25393","2022","COM","2020","546","7","553","2023-01-02"
"25394","2022","COM","2020","1459","43","1502","2023-01-02"
"25395","2022","COM","2020","1576","50","1626","2023-01-02"
"25397","2022","COM","2020","2190","44","2234","2023-01-02"
"25398","2022","COM","2020","118","4","122","2023-01-02"
"25400","2022","COM","2020","479","6","485","2023-01-02"
"25401","2022","COM","2020","27","0","27","2023-01-02"
"25402","2022","COM","2020","24","1","25","2023-01-02"
"25403","2022","COM","2020","2190","73","2263","2023-01-02"
"25404","2022","COM","2020","91","4","95","2023-01-02"
"25405","2022","COM","2020","929","41","970","2023-01-02"
"25406","2022","COM","2020","568","14","582","2023-01-02"
"25408","2022","COM","2020","55","1","56","2023-01-02"
"25410","2022","COM","2020","1327","62","1389","2023-01-02"
"25411","2022","COM","2020","6851","336","7187","2023-01-02"
"25413","2022","COM","2020","1022","35","1057","2023-01-02"
"25414","2022","COM","2020","126","2","128","2023-01-02"
"25415","2022","COM","2020","344","5","349","2023-01-02"
"25416","2022","COM","2020","182","4","186","2023-01-02"
"25417","2022","COM","2020","806","21","827","2023-01-02"
"25418","2022","COM","2020","1272","32","1304","2023-01-02"
"25419","2022","COM","2020","93","4","97","2023-01-02"
"25420","2022","COM","2020","167","4","171","2023-01-02"
"25421","2022","COM","2020","81","0","81","2023-01-02"
"25422","2022","COM","2020","170","4","174","2023-01-02"
"25424","2022","COM","2020","1548","30","1578","2023-01-02"
"25425","2022","COM","2020","458","17","475","2023-01-02"
"25426","2022","COM","2020","331","6","337","2023-01-02"
"25427","2022","COM","2020","397","5","402","2023-01-02"
"25428","2022","COM","2020","1611","38","1649","2023-01-02"
"25429","2022","COM","2020","1446","33","1479","2023-01-02"
"25430","2022","COM","2020","38","0","38","2023-01-02"
"25431","2022","COM","2020","348","7","355","2023-01-02"
"25432","2022","COM","2020","2161","57","2218","2023-01-02"
"25433","2022","COM","2020","39","1","40","2023-01-02"
"25434","2022","COM","2020","4422","106","4528","2023-01-02"
"25435","2022","COM","2020","168","3","171","2023-01-02"
"25436","2022","COM","2020","57","2","59","2023-01-02"
"25437","2022","COM","2020","349","3","352","2023-01-02"
"25438","2022","COM","2020","959","15","974","2023-01-02"
"25439","2022","COM","2020","254","2","256","2023-01-02"
"25440","2022","COM","2020","383","8","391","2023-01-02"
"25441","2022","COM","2020","67","1","68","2023-01-02"
"25442","2022","COM","2020","725","26","751","2023-01-02"
"25443","2022","COM","2020","72","3","75","2023-01-02"
"25444","2022","COM","2020","142","4","146","2023-01-02"
"25445","2022","COM","2020","123","2","125","2023-01-02"
"25446","2022","COM","2020","188","11","199","2023-01-02"
"25447","2022","COM","2020","341","9","350","2023-01-02"
"25448","2022","COM","2020","1531","29","1560","2023-01-02"
"25449","2022","COM","2020","141","1","142","2023-01-02"
"25450","2022","COM","2020","85","3","88","2023-01-02"
"25451","2022","COM","2020","152","3","155","2023-01-02"
"25452","2022","COM","2020","473","9","482","2023-01-02"
"25453","2022","COM","2020","1384","39","1423","2023-01-02"
"25454","2022","COM","2020","2128","51","2179","2023-01-02"
"25455","2022","COM","2020","196","4","200","2023-01-02"
"25456","2022","COM","2020","271","9","280","2023-01-02"
"25457","2022","COM","2020","114","0","114","2023-01-02"
"25458","2022","COM","2020","214","5","219","2023-01-02"
"25459","2022","COM","2020","315","10","325","2023-01-02"
"25460","2022","COM","2020","242","18","260","2023-01-02"
"25461","2022","COM","2020","302","5","307","2023-01-02"
"25462","2022","COM","2020","17738","880","18618","2023-01-02"
"25463","2022","COM","2020","4088","74","4162","2023-01-02"
"25464","2022","COM","2020","135","4","139","2023-01-02"
"25465","2022","COM","2020","205","3","208","2023-01-02"
"25466","2022","COM","2020","826","17","843","2023-01-02"
"25467","2022","COM","2020","2042","36","2078","2023-01-02"
"25468","2022","COM","2020","844","19","863","2023-01-02"
"25469","2022","COM","2020","463","13","476","2023-01-02"
"25470","2022","COM","2020","158","5","163","2023-01-02"
"25471","2022","COM","2020","138","5","143","2023-01-02"
"25472","2022","COM","2020","33","3","36","2023-01-02"
"25473","2022","COM","2020","716","13","729","2023-01-02"
"25474","2022","COM","2020","111","3","114","2023-01-02"
"25475","2022","COM","2020","1399","23","1422","2023-01-02"
"25476","2022","COM","2020","128","3","131","2023-01-02"
"25477","2022","COM","2020","403","6","409","2023-01-02"
"25478","2022","COM","2020","122","2","124","2023-01-02"
"25479","2022","COM","2020","392","4","396","2023-01-02"
"25481","2022","COM","2020","340","5","345","2023-01-02"
"25482","2022","COM","2020","687","2","689","2023-01-02"
"25483","2022","COM","2020","38","3","41","2023-01-02"
"25485","2022","COM","2020","224","5","229","2023-01-02"
"25486","2022","COM","2020","435","11","446","2023-01-02"
"25487","2022","COM","2020","47","4","51","2023-01-02"
"25488","2022","COM","2020","108","1","109","2023-01-02"
"25489","2022","COM","2020","280","26","306","2023-01-02"
"25490","2022","COM","2020","377","19","396","2023-01-02"
"25491","2022","COM","2020","114","3","117","2023-01-02"
"25492","2022","COM","2020","93","3","96","2023-01-02"
"25493","2022","COM","2020","924","23","947","2023-01-02"
"25494","2022","COM","2020","729","25","754","2023-01-02"
"25495","2022","COM","2020","2169","24","2193","2023-01-02"
"25496","2022","COM","2020","99","0","99","2023-01-02"
"25497","2022","COM","2020","616","14","630","2023-01-02"
"25498","2022","COM","2020","49","0","49","2023-01-02"
"25499","2022","COM","2020","122","2","124","2023-01-02"
"25500","2022","COM","2020","85","1","86","2023-01-02"
"25501","2022","COM","2020","37","1","38","2023-01-02"
"25502","2022","COM","2020","555","4","559","2023-01-02"
"25503","2022","COM","2020","114","4","118","2023-01-02"
"25504","2022","COM","2020","81","2","83","2023-01-02"
"25505","2022","COM","2020","1028","27","1055","2023-01-02"
"25506","2022","COM","2020","91","0","91","2023-01-02"
"25507","2022","COM","2020","72","2","74","2023-01-02"
"25508","2022","COM","2020","1127","27","1154","2023-01-02"
"25510","2022","COM","2020","360","9","369","2023-01-02"
"25511","2022","COM","2020","356","6","362","2023-01-02"
"25512","2022","COM","2020","2446","53","2499","2023-01-02"
"25513","2022","COM","2020","49","0","49","2023-01-02"
"25514","2022","COM","2020","330","12","342","2023-01-02"
"25515","2022","COM","2020","446","6","452","2023-01-02"
"25516","2022","COM","2020","124","6","130","2023-01-02"
"25517","2022","COM","2020","276","9","285","2023-01-02"
"25518","2022","COM","2020","157","9","166","2023-01-02"
"25519","2022","COM","2020","913","13","926","2023-01-02"
"25520","2022","COM","2020","181","1","182","2023-01-02"
"25521","2022","COM","2020","159","5","164","2023-01-02"
"25522","2022","COM","2020","184","3","187","2023-01-02"
"25523","2022","COM","2020","672","15","687","2023-01-02"
"25524","2022","COM","2020","902","26","928","2023-01-02"
"25525","2022","COM","2020","298","12","310","2023-01-02"
"25526","2022","COM","2020","1447","41","1488","2023-01-02"
"25527","2022","COM","2020","4924","74","4998","2023-01-02"
"25528","2022","COM","2020","72","1","73","2023-01-02"
"25529","2022","COM","2020","1327","18","1345","2023-01-02"
"25532","2022","COM","2020","3164","68","3232","2023-01-02"
"25533","2022","COM","2020","17","0","17","2023-01-02"
"25534","2022","COM","2020","194","4","198","2023-01-02"
"25535","2022","COM","2020","231","6","237","2023-01-02"
"25536","2022","COM","2020","188","2","190","2023-01-02"
"25537","2022","COM","2020","287","9","296","2023-01-02"
"25538","2022","COM","2020","117","4","121","2023-01-02"
"25539","2022","COM","2020","5756","138","5894","2023-01-02"
"25540","2022","COM","2020","309","6","315","2023-01-02"
"25541","2022","COM","2020","378","8","386","2023-01-02"
"25542","2022","COM","2020","1794","29","1823","2023-01-02"
"25544","2022","COM","2020","209","8","217","2023-01-02"
"25545","2022","COM","2020","145","2","147","2023-01-02"
"25546","2022","COM","2020","61","1","62","2023-01-02"
"25547","2022","COM","2020","3820","42","3862","2023-01-02"
"25548","2022","COM","2020","137","7","144","2023-01-02"
"25549","2022","COM","2020","632","7","639","2023-01-02"
"25550","2022","COM","2020","245","8","253","2023-01-02"
"25551","2022","COM","2020","133","1","134","2023-01-02"
"25552","2022","COM","2020","117","2","119","2023-01-02"
"25553","2022","COM","2020","387","8","395","2023-01-02"
"25554","2022","COM","2020","115","3","118","2023-01-02"
"25555","2022","COM","2020","1104","25","1129","2023-01-02"
"25556","2022","COM","2020","47","3","50","2023-01-02"
"25557","2022","COM","2020","430","8","438","2023-01-02"
"25558","2022","COM","2020","1518","35","1553","2023-01-02"
"25559","2022","COM","2020","258","6","264","2023-01-02"
"25560","2022","COM","2020","3010","38","3048","2023-01-02"
"25561","2022","COM","2020","341","9","350","2023-01-02"
"25562","2022","COM","2020","212","6","218","2023-01-02"
"25563","2022","COM","2020","119","2","121","2023-01-02"
"25564","2022","COM","2020","1020","16","1036","2023-01-02"
"25565","2022","COM","2020","273","8","281","2023-01-02"
"25566","2022","COM","2020","307","4","311","2023-01-02"
"25567","2022","COM","2020","115","3","118","2023-01-02"
"25569","2022","COM","2020","544","11","555","2023-01-02"
"25570","2022","COM","2020","28","1","29","2023-01-02"
"25571","2022","COM","2020","509","9","518","2023-01-02"
"25572","2022","COM","2020","104","5","109","2023-01-02"
"25573","2022","COM","2020","14","0","14","2023-01-02"
"25574","2022","COM","2020","179","1","180","2023-01-02"
"25575","2022","COM","2020","801","11","812","2023-01-02"
"25578","2022","COM","2020","5734","107","5841","2023-01-02"
"25579","2022","COM","2020","209","3","212","2023-01-02"
"25580","2022","COM","2020","10897","168","11065","2023-01-02"
"25582","2022","COM","2020","143","2","145","2023-01-02"
"25583","2022","COM","2020","254","5","259","2023-01-02"
"25584","2022","COM","2020","124","4","128","2023-01-02"
"25586","2022","COM","2020","809","31","840","2023-01-02"
"25588","2022","COM","2020","123","23","146","2023-01-02"
"25589","2022","COM","2020","82","1","83","2023-01-02"
"25590","2022","COM","2020","80","2","82","2023-01-02"
"25591","2022","COM","2020","153","0","153","2023-01-02"
"25592","2022","COM","2020","630","16","646","2023-01-02"
"25594","2022","COM","2020","350","5","355","2023-01-02"
"25595","2022","COM","2020","94","1","95","2023-01-02"
"25596","2022","COM","2020","69","1","70","2023-01-02"
"25597","2022","COM","2020","237","3","240","2023-01-02"
"25598","2022","COM","2020","521","7","528","2023-01-02"
"25599","2022","COM","2020","255","8","263","2023-01-02"
"25600","2022","COM","2020","224","5","229","2023-01-02"
"25601","2022","COM","2020","1691","84","1775","2023-01-02"
"25602","2022","COM","2020","118","5","123","2023-01-02"
"25604","2022","COM","2020","125","1","126","2023-01-02"
"25605","2022","COM","2020","481","12","493","2023-01-02"
"25607","2022","COM","2020","57","1","58","2023-01-02"
"25608","2022","COM","2020","178","2","180","2023-01-02"
"25609","2022","COM","2020","489","12","501","2023-01-02"
"25611","2022","COM","2020","483","7","490","2023-01-02"
"25612","2022","COM","2020","684","18","702","2023-01-02"
"25613","2022","COM","2020","93","2","95","2023-01-02"
"25614","2022","COM","2020","2850","54","2904","2023-01-02"
"25615","2022","COM","2020","450","8","458","2023-01-02"
"25616","2022","COM","2020","284","3","287","2023-01-02"
"25617","2022","COM","2020","351","6","357","2023-01-02"
"25618","2022","COM","2020","345","8","353","2023-01-02"
"25619","2022","COM","2020","199","2","201","2023-01-02"
"25620","2022","COM","2020","333","7","340","2023-01-02"
"25621","2022","COM","2020","223","36","259","2023-01-02"
"25622","2022","COM","2020","260","1","261","2023-01-02"
"25623","2022","COM","2020","131","2","133","2023-01-02"
"25624","2022","COM","2020","146","3","149","2023-01-02"
"25625","2022","COM","2020","51","1","52","2023-01-02"
"25626","2022","COM","2020","226","8","234","2023-01-02"
"25627","2022","COM","2020","300","11","311","2023-01-02"
"25629","2022","COM","2020","200","6","206","2023-01-02"
"25630","2022","COM","2020","78","0","78","2023-01-02"
"25631","2022","COM","2020","591","8","599","2023-01-02"
"25632","2022","COM","2020","3105","85","3190","2023-01-02"
"25633","2022","COM","2020","717","14","731","2023-01-02"
"25634","2022","COM","2020","648","11","659","2023-01-02"
"25635","2022","COM","2020","186","7","193","2023-01-02"
"26001","2022","COM","2020","428","8","436","2023-01-02"
"26002","2022","COM","2020","1967","46","2013","2023-01-02"
"26003","2022","COM","2020","52","0","52","2023-01-02"
"26004","2022","COM","2020","2592","56","2648","2023-01-02"
"26005","2022","COM","2020","1824","51","1875","2023-01-02"
"26006","2022","COM","2020","2488","75","2563","2023-01-02"
"26007","2022","COM","2020","101","7","108","2023-01-02"
"26008","2022","COM","2020","1366","26","1392","2023-01-02"
"26009","2022","COM","2020","1328","35","1363","2023-01-02"
"26010","2022","COM","2020","4117","101","4218","2023-01-02"
"26011","2022","COM","2020","2601","43","2644","2023-01-02"
"26012","2022","COM","2020","20","3","23","2023-01-02"
"26013","2022","COM","2020","76","2","78","2023-01-02"
"26014","2022","COM","2020","618","9","627","2023-01-02"
"26015","2022","COM","2020","78","4","82","2023-01-02"
"26016","2022","COM","2020","420","9","429","2023-01-02"
"26017","2022","COM","2020","16","0","16","2023-01-02"
"26018","2022","COM","2020","10","0","10","2023-01-02"
"26019","2022","COM","2020","244","3","247","2023-01-02"
"26020","2022","COM","2020","245","6","251","2023-01-02"
"26021","2022","COM","2020","133","2","135","2023-01-02"
"26022","2022","COM","2020","91","2","93","2023-01-02"
"26023","2022","COM","2020","1128","19","1147","2023-01-02"
"26024","2022","COM","2020","354","10","364","2023-01-02"
"26025","2022","COM","2020","209","7","216","2023-01-02"
"26026","2022","COM","2020","64","0","64","2023-01-02"
"26027","2022","COM","2020","143","1","144","2023-01-02"
"26028","2022","COM","2020","227","13","240","2023-01-02"
"26030","2022","COM","2020","2","0","2","2023-01-02"
"26031","2022","COM","2020","1031","26","1057","2023-01-02"
"26032","2022","COM","2020","451","9","460","2023-01-02"
"26033","2022","COM","2020","926","16","942","2023-01-02"
"26034","2022","COM","2020","592","8","600","2023-01-02"
"26035","2022","COM","2020","477","8","485","2023-01-02"
"26036","2022","COM","2020","104","4","108","2023-01-02"
"26037","2022","COM","2020","4154","86","4240","2023-01-02"
"26038","2022","COM","2020","1328","32","1360","2023-01-02"
"26039","2022","COM","2020","896","14","910","2023-01-02"
"26040","2022","COM","2020","69","2","71","2023-01-02"
"26041","2022","COM","2020","1430","25","1455","2023-01-02"
"26042","2022","COM","2020","1595","26","1621","2023-01-02"
"26043","2022","COM","2020","146","6","152","2023-01-02"
"26045","2022","COM","2020","1656","46","1702","2023-01-02"
"26046","2022","COM","2020","65","3","68","2023-01-02"
"26047","2022","COM","2020","95","0","95","2023-01-02"
"26048","2022","COM","2020","75","1","76","2023-01-02"
"26049","2022","COM","2020","1248","38","1286","2023-01-02"
"26050","2022","COM","2020","85","2","87","2023-01-02"
"26051","2022","COM","2020","68","2","70","2023-01-02"
"26052","2022","COM","2020","473","7","480","2023-01-02"
"26054","2022","COM","2020","1501","36","1537","2023-01-02"
"26055","2022","COM","2020","156","2","158","2023-01-02"
"26056","2022","COM","2020","686","17","703","2023-01-02"
"26057","2022","COM","2020","9818","159","9977","2023-01-02"
"26058","2022","COM","2020","19814","517","20331","2023-01-02"
"26059","2022","COM","2020","210","3","213","2023-01-02"
"26060","2022","COM","2020","148","6","154","2023-01-02"
"26061","2022","COM","2020","624","10","634","2023-01-02"
"26062","2022","COM","2020","34","3","37","2023-01-02"
"26063","2022","COM","2020","2291","79","2370","2023-01-02"
"26064","2022","COM","2020","6839","182","7021","2023-01-02"
"26065","2022","COM","2020","757","8","765","2023-01-02"
"26066","2022","COM","2020","41","0","41","2023-01-02"
"26067","2022","COM","2020","58","1","59","2023-01-02"
"26068","2022","COM","2020","203","6","209","2023-01-02"
"26069","2022","COM","2020","126","6","132","2023-01-02"
"26070","2022","COM","2020","520","9","529","2023-01-02"
"26071","2022","COM","2020","1146","35","1181","2023-01-02"
"26072","2022","COM","2020","1327","22","1349","2023-01-02"
"26073","2022","COM","2020","244","3","247","2023-01-02"
"26074","2022","COM","2020","724","133","857","2023-01-02"
"26075","2022","COM","2020","25","1","26","2023-01-02"
"26076","2022","COM","2020","28","0","28","2023-01-02"
"26077","2022","COM","2020","867","22","889","2023-01-02"
"26078","2022","COM","2020","935","13","948","2023-01-02"
"26079","2022","COM","2020","1515","38","1553","2023-01-02"
"26080","2022","COM","2020","44","0","44","2023-01-02"
"26081","2022","COM","2020","573","23","596","2023-01-02"
"26082","2022","COM","2020","104","1","105","2023-01-02"
"26083","2022","COM","2020","1827","585","2412","2023-01-02"
"26084","2022","COM","2020","3988","149","4137","2023-01-02"
"26085","2022","COM","2020","2784","52","2836","2023-01-02"
"26086","2022","COM","2020","658","12","670","2023-01-02"
"26087","2022","COM","2020","1294","44","1338","2023-01-02"
"26088","2022","COM","2020","6122","143","6265","2023-01-02"
"26089","2022","COM","2020","61","1","62","2023-01-02"
"26090","2022","COM","2020","35","0","35","2023-01-02"
"26091","2022","COM","2020","42","0","42","2023-01-02"
"26092","2022","COM","2020","738","11","749","2023-01-02"
"26093","2022","COM","2020","526","12","538","2023-01-02"
"26094","2022","COM","2020","883","16","899","2023-01-02"
"26095","2022","COM","2020","965","33","998","2023-01-02"
"26096","2022","COM","2020","2049","36","2085","2023-01-02"
"26097","2022","COM","2020","615","17","632","2023-01-02"
"26098","2022","COM","2020","170","5","175","2023-01-02"
"26099","2022","COM","2020","547","14","561","2023-01-02"
"26100","2022","COM","2020","460","15","475","2023-01-02"
"26101","2022","COM","2020","140","9","149","2023-01-02"
"26102","2022","COM","2020","135","3","138","2023-01-02"
"26103","2022","COM","2020","500","4","504","2023-01-02"
"26104","2022","COM","2020","91","0","91","2023-01-02"
"26105","2022","COM","2020","74","1","75","2023-01-02"
"26106","2022","COM","2020","1163","26","1189","2023-01-02"
"26107","2022","COM","2020","532","15","547","2023-01-02"
"26108","2022","COM","2020","8707","267","8974","2023-01-02"
"26110","2022","COM","2020","657","18","675","2023-01-02"
"26111","2022","COM","2020","100","1","101","2023-01-02"
"26112","2022","COM","2020","201","8","209","2023-01-02"
"26113","2022","COM","2020","4770","244","5014","2023-01-02"
"26114","2022","COM","2020","3238","133","3371","2023-01-02"
"26115","2022","COM","2020","671","73","744","2023-01-02"
"26116","2022","COM","2020","5963","99","6062","2023-01-02"
"26117","2022","COM","2020","56","4","60","2023-01-02"
"26118","2022","COM","2020","1520","24","1544","2023-01-02"
"26119","2022","COM","2020","808","8","816","2023-01-02"
"26121","2022","COM","2020","1114","29","1143","2023-01-02"
"26122","2022","COM","2020","179","2","181","2023-01-02"
"26123","2022","COM","2020","23","0","23","2023-01-02"
"26124","2022","COM","2020","5545","128","5673","2023-01-02"
"26125","2022","COM","2020","1409","34","1443","2023-01-02"
"26126","2022","COM","2020","90","0","90","2023-01-02"
"26127","2022","COM","2020","120","2","122","2023-01-02"
"26128","2022","COM","2020","69","1","70","2023-01-02"
"26129","2022","COM","2020","1048","20","1068","2023-01-02"
"26130","2022","COM","2020","23","0","23","2023-01-02"
"26131","2022","COM","2020","151","3","154","2023-01-02"
"26133","2022","COM","2020","176","4","180","2023-01-02"
"26134","2022","COM","2020","86","1","87","2023-01-02"
"26135","2022","COM","2020","122","2","124","2023-01-02"
"26136","2022","COM","2020","51","0","51","2023-01-02"
"26137","2022","COM","2020","192","2","194","2023-01-02"
"26138","2022","COM","2020","1126","27","1153","2023-01-02"
"26139","2022","COM","2020","2409","59","2468","2023-01-02"
"26140","2022","COM","2020","706","27","733","2023-01-02"
"26141","2022","COM","2020","213","5","218","2023-01-02"
"26142","2022","COM","2020","118","1","119","2023-01-02"
"26143","2022","COM","2020","900","53","953","2023-01-02"
"26144","2022","COM","2020","2007","52","2059","2023-01-02"
"26145","2022","COM","2020","680","21","701","2023-01-02"
"26146","2022","COM","2020","1590","43","1633","2023-01-02"
"26147","2022","COM","2020","19","1","20","2023-01-02"
"26148","2022","COM","2020","1876","55","1931","2023-01-02"
"26149","2022","COM","2020","1009","16","1025","2023-01-02"
"26150","2022","COM","2020","11","0","11","2023-01-02"
"26152","2022","COM","2020","26","0","26","2023-01-02"
"26153","2022","COM","2020","103","3","106","2023-01-02"
"26154","2022","COM","2020","233","1","234","2023-01-02"
"26155","2022","COM","2020","1210","16","1226","2023-01-02"
"26156","2022","COM","2020","1046","42","1088","2023-01-02"
"26157","2022","COM","2020","749","17","766","2023-01-02"
"26159","2022","COM","2020","115","2","117","2023-01-02"
"26160","2022","COM","2020","1239","21","1260","2023-01-02"
"26161","2022","COM","2020","49","0","49","2023-01-02"
"26162","2022","COM","2020","888","28","916","2023-01-02"
"26163","2022","COM","2020","46","0","46","2023-01-02"
"26164","2022","COM","2020","57","1","58","2023-01-02"
"26165","2022","COM","2020","9254","150","9404","2023-01-02"
"26166","2022","COM","2020","6629","93","6722","2023-01-02"
"26167","2022","COM","2020","543","1","544","2023-01-02"
"26168","2022","COM","2020","528","13","541","2023-01-02"
"26169","2022","COM","2020","2198","43","2241","2023-01-02"
"26170","2022","COM","2020","3239","94","3333","2023-01-02"
"26171","2022","COM","2020","184","10","194","2023-01-02"
"26172","2022","COM","2020","665","10","675","2023-01-02"
"26173","2022","COM","2020","872","22","894","2023-01-02"
"26174","2022","COM","2020","1094","33","1127","2023-01-02"
"26175","2022","COM","2020","225","2","227","2023-01-02"
"26176","2022","COM","2020","1280","41","1321","2023-01-02"
"26177","2022","COM","2020","702","22","724","2023-01-02"
"26178","2022","COM","2020","535","7","542","2023-01-02"
"26179","2022","COM","2020","2807","57","2864","2023-01-02"
"26180","2022","COM","2020","213","6","219","2023-01-02"
"26181","2022","COM","2020","233","7","240","2023-01-02"
"26182","2022","COM","2020","1515","35","1550","2023-01-02"
"26183","2022","COM","2020","1185","30","1215","2023-01-02"
"26185","2022","COM","2020","592","15","607","2023-01-02"
"26186","2022","COM","2020","60","0","60","2023-01-02"
"26188","2022","COM","2020","1065","24","1089","2023-01-02"
"26189","2022","COM","2020","120","2","122","2023-01-02"
"26190","2022","COM","2020","85","2","87","2023-01-02"
"26191","2022","COM","2020","2456","70","2526","2023-01-02"
"26192","2022","COM","2020","274","10","284","2023-01-02"
"26193","2022","COM","2020","443","2","445","2023-01-02"
"26194","2022","COM","2020","591","17","608","2023-01-02"
"26195","2022","COM","2020","192","2","194","2023-01-02"
"26196","2022","COM","2020","1743","141","1884","2023-01-02"
"26197","2022","COM","2020","4278","117","4395","2023-01-02"
"26198","2022","COM","2020","39790","1179","40969","2023-01-02"
"26199","2022","COM","2020","28","1","29","2023-01-02"
"26200","2022","COM","2020","84","1","85","2023-01-02"
"26201","2022","COM","2020","48","6","54","2023-01-02"
"26202","2022","COM","2020","333","11","344","2023-01-02"
"26203","2022","COM","2020","278","6","284","2023-01-02"
"26204","2022","COM","2020","144","5","149","2023-01-02"
"26205","2022","COM","2020","85","0","85","2023-01-02"
"26206","2022","COM","2020","2955","102","3057","2023-01-02"
"26207","2022","COM","2020","685","10","695","2023-01-02"
"26208","2022","COM","2020","1942","34","1976","2023-01-02"
"26209","2022","COM","2020","23","0","23","2023-01-02"
"26210","2022","COM","2020","1021","17","1038","2023-01-02"
"26211","2022","COM","2020","1352","29","1381","2023-01-02"
"26212","2022","COM","2020","1227","29","1256","2023-01-02"
"26213","2022","COM","2020","679","15","694","2023-01-02"
"26214","2022","COM","2020","77","0","77","2023-01-02"
"26215","2022","COM","2020","410","22","432","2023-01-02"
"26216","2022","COM","2020","1275","24","1299","2023-01-02"
"26217","2022","COM","2020","193","4","197","2023-01-02"
"26218","2022","COM","2020","3255","59","3314","2023-01-02"
"26220","2022","COM","2020","6737","184","6921","2023-01-02"
"26221","2022","COM","2020","70","2","72","2023-01-02"
"26222","2022","COM","2020","37","0","37","2023-01-02"
"26223","2022","COM","2020","523","6","529","2023-01-02"
"26224","2022","COM","2020","273","8","281","2023-01-02"
"26225","2022","COM","2020","707","22","729","2023-01-02"
"26226","2022","COM","2020","365","6","371","2023-01-02"
"26227","2022","COM","2020","26","0","26","2023-01-02"
"26228","2022","COM","2020","34","0","34","2023-01-02"
"26229","2022","COM","2020","94","5","99","2023-01-02"
"26231","2022","COM","2020","2644","71","2715","2023-01-02"
"26232","2022","COM","2020","580","8","588","2023-01-02"
"26233","2022","COM","2020","241","9","250","2023-01-02"
"26234","2022","COM","2020","887","16","903","2023-01-02"
"26235","2022","COM","2020","13708","271","13979","2023-01-02"
"26236","2022","COM","2020","220","2","222","2023-01-02"
"26238","2022","COM","2020","240","2","242","2023-01-02"
"26239","2022","COM","2020","208","5","213","2023-01-02"
"26240","2022","COM","2020","154","2","156","2023-01-02"
"26241","2022","COM","2020","137","2","139","2023-01-02"
"26242","2022","COM","2020","16","0","16","2023-01-02"
"26243","2022","COM","2020","966","39","1005","2023-01-02"
"26244","2022","COM","2020","128","5","133","2023-01-02"
"26245","2022","COM","2020","5","0","5","2023-01-02"
"26246","2022","COM","2020","132","3","135","2023-01-02"
"26247","2022","COM","2020","530","6","536","2023-01-02"
"26248","2022","COM","2020","178","5","183","2023-01-02"
"26249","2022","COM","2020","668","17","685","2023-01-02"
"26250","2022","COM","2020","3608","53","3661","2023-01-02"
"26251","2022","COM","2020","427","7","434","2023-01-02"
"26252","2022","COM","2020","10526","159","10685","2023-01-02"
"26253","2022","COM","2020","72","1","73","2023-01-02"
"26254","2022","COM","2020","21","0","21","2023-01-02"
"26255","2022","COM","2020","22","0","22","2023-01-02"
"26256","2022","COM","2020","138","5","143","2023-01-02"
"26257","2022","COM","2020","459","20","479","2023-01-02"
"26258","2022","COM","2020","869","19","888","2023-01-02"
"26259","2022","COM","2020","269","4","273","2023-01-02"
"26261","2022","COM","2020","396","10","406","2023-01-02"
"26262","2022","COM","2020","288","2","290","2023-01-02"
"26263","2022","COM","2020","146","2","148","2023-01-02"
"26264","2022","COM","2020","325","7","332","2023-01-02"
"26266","2022","COM","2020","23","0","23","2023-01-02"
"26267","2022","COM","2020","24","1","25","2023-01-02"
"26268","2022","COM","2020","125","0","125","2023-01-02"
"26269","2022","COM","2020","54","0","54","2023-01-02"
"26270","2022","COM","2020","129","2","131","2023-01-02"
"26271","2022","COM","2020","3456","65","3521","2023-01-02"
"26272","2022","COM","2020","370","9","379","2023-01-02"
"26273","2022","COM","2020","1022","19","1041","2023-01-02"
"26274","2022","COM","2020","1","0","1","2023-01-02"
"26275","2022","COM","2020","1671","48","1719","2023-01-02"
"26276","2022","COM","2020","469","14","483","2023-01-02"
"26277","2022","COM","2020","173","4","177","2023-01-02"
"26278","2022","COM","2020","285","9","294","2023-01-02"
"26279","2022","COM","2020","57","1","58","2023-01-02"
"26281","2022","COM","2020","32818","668","33486","2023-01-02"
"26282","2022","COM","2020","202","4","206","2023-01-02"
"26283","2022","COM","2020","24","0","24","2023-01-02"
"26284","2022","COM","2020","383","8","391","2023-01-02"
"26285","2022","COM","2020","279","9","288","2023-01-02"
"26286","2022","COM","2020","24","1","25","2023-01-02"
"26287","2022","COM","2020","483","15","498","2023-01-02"
"26288","2022","COM","2020","306","6","312","2023-01-02"
"26289","2022","COM","2020","1388","21","1409","2023-01-02"
"26290","2022","COM","2020","354","9","363","2023-01-02"
"26291","2022","COM","2020","85","2","87","2023-01-02"
"26292","2022","COM","2020","212","4","216","2023-01-02"
"26293","2022","COM","2020","326","9","335","2023-01-02"
"26294","2022","COM","2020","594","18","612","2023-01-02"
"26295","2022","COM","2020","1859","31","1890","2023-01-02"
"26296","2022","COM","2020","32","1","33","2023-01-02"
"26298","2022","COM","2020","421","5","426","2023-01-02"
"26299","2022","COM","2020","105","3","108","2023-01-02"
"26300","2022","COM","2020","49","1","50","2023-01-02"
"26301","2022","COM","2020","4294","94","4388","2023-01-02"
"26302","2022","COM","2020","549","10","559","2023-01-02"
"26303","2022","COM","2020","74","4","78","2023-01-02"
"26304","2022","COM","2020","257","8","265","2023-01-02"
"26305","2022","COM","2020","1083","23","1106","2023-01-02"
"26306","2022","COM","2020","318","5","323","2023-01-02"
"26307","2022","COM","2020","2796","66","2862","2023-01-02"
"26308","2022","COM","2020","148","0","148","2023-01-02"
"26309","2022","COM","2020","228","5","233","2023-01-02"
"26310","2022","COM","2020","158","4","162","2023-01-02"
"26311","2022","COM","2020","1409","51","1460","2023-01-02"
"26312","2022","COM","2020","1269","29","1298","2023-01-02"
"26313","2022","COM","2020","6320","124","6444","2023-01-02"
"26314","2022","COM","2020","390","16","406","2023-01-02"
"26315","2022","COM","2020","382","7","389","2023-01-02"
"26316","2022","COM","2020","210","7","217","2023-01-02"
"26317","2022","COM","2020","796","12","808","2023-01-02"
"26318","2022","COM","2020","33","1","34","2023-01-02"
"26319","2022","COM","2020","558","12","570","2023-01-02"
"26320","2022","COM","2020","811","10","821","2023-01-02"
"26321","2022","COM","2020","208","1","209","2023-01-02"
"26322","2022","COM","2020","410","22","432","2023-01-02"
"26323","2022","COM","2020","1858","34","1892","2023-01-02"
"26324","2022","COM","2020","8731","431","9162","2023-01-02"
"26325","2022","COM","2020","6833","67","6900","2023-01-02"
"26326","2022","COM","2020","1462","48","1510","2023-01-02"
"26327","2022","COM","2020","218","3","221","2023-01-02"
"26328","2022","COM","2020","53","1","54","2023-01-02"
"26329","2022","COM","2020","178","6","184","2023-01-02"
"26330","2022","COM","2020","2247","44","2291","2023-01-02"
"26331","2022","COM","2020","608","14","622","2023-01-02"
"26332","2022","COM","2020","2083","23","2106","2023-01-02"
"26333","2022","COM","2020","4017","155","4172","2023-01-02"
"26334","2022","COM","2020","141","2","143","2023-01-02"
"26335","2022","COM","2020","202","3","205","2023-01-02"
"26336","2022","COM","2020","565","23","588","2023-01-02"
"26337","2022","COM","2020","1838","30","1868","2023-01-02"
"26338","2022","COM","2020","1830","58","1888","2023-01-02"
"26339","2022","COM","2020","1536","43","1579","2023-01-02"
"26340","2022","COM","2020","251","5","256","2023-01-02"
"26341","2022","COM","2020","726","13","739","2023-01-02"
"26342","2022","COM","2020","315","7","322","2023-01-02"
"26343","2022","COM","2020","107","2","109","2023-01-02"
"26344","2022","COM","2020","395","7","402","2023-01-02"
"26345","2022","COM","2020","2126","71","2197","2023-01-02"
"26346","2022","COM","2020","236","8","244","2023-01-02"
"26347","2022","COM","2020","6025","244","6269","2023-01-02"
"26348","2022","COM","2020","1645","28","1673","2023-01-02"
"26349","2022","COM","2020","363","8","371","2023-01-02"
"26350","2022","COM","2020","68","1","69","2023-01-02"
"26351","2022","COM","2020","34","0","34","2023-01-02"
"26352","2022","COM","2020","261","8","269","2023-01-02"
"26353","2022","COM","2020","1034","19","1053","2023-01-02"
"26355","2022","COM","2020","617","8","625","2023-01-02"
"26356","2022","COM","2020","127","6","133","2023-01-02"
"26357","2022","COM","2020","2004","39","2043","2023-01-02"
"26358","2022","COM","2020","1523","41","1564","2023-01-02"
"26359","2022","COM","2020","36","0","36","2023-01-02"
"26360","2022","COM","2020","692","26","718","2023-01-02"
"26361","2022","COM","2020","134","3","137","2023-01-02"
"26362","2022","COM","2020","64431","1278","65709","2023-01-02"
"26363","2022","COM","2020","40","0","40","2023-01-02"
"26364","2022","COM","2020","333","8","341","2023-01-02"
"26365","2022","COM","2020","583","11","594","2023-01-02"
"26367","2022","COM","2020","672","11","683","2023-01-02"
"26368","2022","COM","2020","461","8","469","2023-01-02"
"26369","2022","COM","2020","61","0","61","2023-01-02"
"26370","2022","COM","2020","138","4","142","2023-01-02"
"26371","2022","COM","2020","44","1","45","2023-01-02"
"26372","2022","COM","2020","39","1","40","2023-01-02"
"26373","2022","COM","2020","242","8","250","2023-01-02"
"26374","2022","COM","2020","14","0","14","2023-01-02"
"26375","2022","COM","2020","17","1","18","2023-01-02"
"26376","2022","COM","2020","101","1","102","2023-01-02"
"26377","2022","COM","2020","1025","23","1048","2023-01-02"
"26378","2022","COM","2020","33","0","33","2023-01-02"
"26379","2022","COM","2020","890","12","902","2023-01-02"
"26380","2022","COM","2020","546","10","556","2023-01-02"
"26381","2022","COM","2020","910","12","922","2023-01-02"
"26382","2022","COM","2020","571","7","578","2023-01-02"
"27001","2022","COM","2020","330","9","339","2023-01-02"
"27002","2022","COM","2020","460","9","469","2023-01-02"
"27003","2022","COM","2020","1674","34","1708","2023-01-02"
"27004","2022","COM","2020","420","13","433","2023-01-02"
"27005","2022","COM","2020","1191","21","1212","2023-01-02"
"27006","2022","COM","2020","154","3","157","2023-01-02"
"27008","2022","COM","2020","1597","17","1614","2023-01-02"
"27009","2022","COM","2020","565","11","576","2023-01-02"
"27010","2022","COM","2020","174","7","181","2023-01-02"
"27011","2022","COM","2020","1197","13","1210","2023-01-02"
"27012","2022","COM","2020","443","16","459","2023-01-02"
"27013","2022","COM","2020","488","11","499","2023-01-02"
"27014","2022","COM","2020","859","21","880","2023-01-02"
"27015","2022","COM","2020","1304","32","1336","2023-01-02"
"27016","2022","COM","2020","8055","138","8193","2023-01-02"
"27017","2022","COM","2020","1350","38","1388","2023-01-02"
"27018","2022","COM","2020","989","12","1001","2023-01-02"
"27019","2022","COM","2020","161","7","168","2023-01-02"
"27020","2022","COM","2020","1667","43","1710","2023-01-02"
"27021","2022","COM","2020","338","9","347","2023-01-02"
"27022","2022","COM","2020","5248","106","5354","2023-01-02"
"27023","2022","COM","2020","706","19","725","2023-01-02"
"27025","2022","COM","2020","949","20","969","2023-01-02"
"27026","2022","COM","2020","448","9","457","2023-01-02"
"27027","2022","COM","2020","291","7","298","2023-01-02"
"27028","2022","COM","2020","336","4","340","2023-01-02"
"27031","2022","COM","2020","1102","37","1139","2023-01-02"
"27032","2022","COM","2020","1398","31","1429","2023-01-02"
"27033","2022","COM","2020","306","4","310","2023-01-02"
"27034","2022","COM","2020","628","7","635","2023-01-02"
"27035","2022","COM","2020","100","1","101","2023-01-02"
"27036","2022","COM","2020","541","21","562","2023-01-02"
"27037","2022","COM","2020","1155","21","1176","2023-01-02"
"27038","2022","COM","2020","276","6","282","2023-01-02"
"27039","2022","COM","2020","517","35","552","2023-01-02"
"27040","2022","COM","2020","448","5","453","2023-01-02"
"27042","2022","COM","2020","82","0","82","2023-01-02"
"27043","2022","COM","2020","677","21","698","2023-01-02"
"27044","2022","COM","2020","836","19","855","2023-01-02"
"27045","2022","COM","2020","783","12","795","2023-01-02"
"27046","2022","COM","2020","143","1","144","2023-01-02"
"27047","2022","COM","2020","336","8","344","2023-01-02"
"27048","2022","COM","2020","186","3","189","2023-01-02"
"27049","2022","COM","2020","4484","119","4603","2023-01-02"
"27050","2022","COM","2020","636","17","653","2023-01-02"
"27051","2022","COM","2020","2791","40","2831","2023-01-02"
"27052","2022","COM","2020","402","3","405","2023-01-02"
"27053","2022","COM","2020","213","2","215","2023-01-02"
"27054","2022","COM","2020","582","8","590","2023-01-02"
"27055","2022","COM","2020","330","6","336","2023-01-02"
"27056","2022","COM","2020","9654","281","9935","2023-01-02"
"27057","2022","COM","2020","288","6","294","2023-01-02"
"27058","2022","COM","2020","1759","45","1804","2023-01-02"
"27059","2022","COM","2020","313","4","317","2023-01-02"
"27061","2022","COM","2020","327","5","332","2023-01-02"
"27062","2022","COM","2020","1571","45","1616","2023-01-02"
"27063","2022","COM","2020","258","1","259","2023-01-02"
"27064","2022","COM","2020","680","9","689","2023-01-02"
"27065","2022","COM","2020","4682","53","4735","2023-01-02"
"27066","2022","COM","2020","315","3","318","2023-01-02"
"27067","2022","COM","2020","1572","28","1600","2023-01-02"
"27068","2022","COM","2020","171","2","173","2023-01-02"
"27069","2022","COM","2020","689","15","704","2023-01-02"
"27070","2022","COM","2020","1714","27","1741","2023-01-02"
"27071","2022","COM","2020","213","2","215","2023-01-02"
"27072","2022","COM","2020","748","23","771","2023-01-02"
"27073","2022","COM","2020","1238","19","1257","2023-01-02"
"27074","2022","COM","2020","276","8","284","2023-01-02"
"27075","2022","COM","2020","350","6","356","2023-01-02"
"27076","2022","COM","2020","498","8","506","2023-01-02"
"27077","2022","COM","2020","854","10","864","2023-01-02"
"27078","2022","COM","2020","262","11","273","2023-01-02"
"27079","2022","COM","2020","367","5","372","2023-01-02"
"27081","2022","COM","2020","181","7","188","2023-01-02"
"27082","2022","COM","2020","2047","47","2094","2023-01-02"
"27083","2022","COM","2020","264","4","268","2023-01-02"
"27085","2022","COM","2020","1554","22","1576","2023-01-02"
"27089","2022","COM","2020","1008","17","1025","2023-01-02"
"27090","2022","COM","2020","3718","68","3786","2023-01-02"
"27091","2022","COM","2020","755","4","759","2023-01-02"
"27094","2022","COM","2020","125","1","126","2023-01-02"
"27095","2022","COM","2020","668","11","679","2023-01-02"
"27096","2022","COM","2020","344","11","355","2023-01-02"
"27097","2022","COM","2020","663","12","675","2023-01-02"
"27098","2022","COM","2020","79","5","84","2023-01-02"
"27099","2022","COM","2020","810","10","820","2023-01-02"
"27100","2022","COM","2020","1204","24","1228","2023-01-02"
"27101","2022","COM","2020","526","10","536","2023-01-02"
"27102","2022","COM","2020","1035","22","1057","2023-01-02"
"27103","2022","COM","2020","3939","73","4012","2023-01-02"
"27104","2022","COM","2020","707","10","717","2023-01-02"
"27105","2022","COM","2020","4038","79","4117","2023-01-02"
"27106","2022","COM","2020","482","5","487","2023-01-02"
"27107","2022","COM","2020","1336","24","1360","2023-01-02"
"27108","2022","COM","2020","1188","31","1219","2023-01-02"
"27109","2022","COM","2020","398","8","406","2023-01-02"
"27110","2022","COM","2020","652","8","660","2023-01-02"
"27111","2022","COM","2020","203","5","208","2023-01-02"
"27112","2022","COM","2020","4321","124","4445","2023-01-02"
"27113","2022","COM","2020","141","2","143","2023-01-02"
"27114","2022","COM","2020","1210","23","1233","2023-01-02"
"27115","2022","COM","2020","339","7","346","2023-01-02"
"27116","2022","COM","2020","4184","152","4336","2023-01-02"
"27117","2022","COM","2020","1013","20","1033","2023-01-02"
"27118","2022","COM","2020","644","10","654","2023-01-02"
"27119","2022","COM","2020","1625","28","1653","2023-01-02"
"27120","2022","COM","2020","405","5","410","2023-01-02"
"27123","2022","COM","2020","487","12","499","2023-01-02"
"27124","2022","COM","2020","213","2","215","2023-01-02"
"27125","2022","COM","2020","654","10","664","2023-01-02"
"27126","2022","COM","2020","1101","21","1122","2023-01-02"
"27127","2022","COM","2020","699","22","721","2023-01-02"
"27129","2022","COM","2020","597","19","616","2023-01-02"
"27130","2022","COM","2020","417","11","428","2023-01-02"
"27132","2022","COM","2020","846","21","867","2023-01-02"
"27133","2022","COM","2020","1086","12","1098","2023-01-02"
"27134","2022","COM","2020","213","0","213","2023-01-02"
"27135","2022","COM","2020","444","11","455","2023-01-02"
"27136","2022","COM","2020","276","4","280","2023-01-02"
"27137","2022","COM","2020","199","5","204","2023-01-02"
"27138","2022","COM","2020","385","11","396","2023-01-02"
"27139","2022","COM","2020","175","6","181","2023-01-02"
"27140","2022","COM","2020","407","9","416","2023-01-02"
"27141","2022","COM","2020","63","0","63","2023-01-02"
"27142","2022","COM","2020","288","7","295","2023-01-02"
"27144","2022","COM","2020","273","5","278","2023-01-02"
"27146","2022","COM","2020","382","5","387","2023-01-02"
"27147","2022","COM","2020","693","11","704","2023-01-02"
"27148","2022","COM","2020","410","9","419","2023-01-02"
"27149","2022","COM","2020","117","3","120","2023-01-02"
"27151","2022","COM","2020","1706","22","1728","2023-01-02"
"27152","2022","COM","2020","559","9","568","2023-01-02"
"27153","2022","COM","2020","377","7","384","2023-01-02"
"27154","2022","COM","2020","597","16","613","2023-01-02"
"27155","2022","COM","2020","105","2","107","2023-01-02"
"27156","2022","COM","2020","467","17","484","2023-01-02"
"27157","2022","COM","2020","1321","20","1341","2023-01-02"
"27158","2022","COM","2020","774","27","801","2023-01-02"
"27161","2022","COM","2020","1080","21","1101","2023-01-02"
"27162","2022","COM","2020","242","4","246","2023-01-02"
"27163","2022","COM","2020","198","3","201","2023-01-02"
"27164","2022","COM","2020","819","7","826","2023-01-02"
"27165","2022","COM","2020","4950","72","5022","2023-01-02"
"27167","2022","COM","2020","661","6","667","2023-01-02"
"27168","2022","COM","2020","177","7","184","2023-01-02"
"27169","2022","COM","2020","1015","12","1027","2023-01-02"
"27170","2022","COM","2020","1195","20","1215","2023-01-02"
"27171","2022","COM","2020","373","10","383","2023-01-02"
"27173","2022","COM","2020","123","3","126","2023-01-02"
"27174","2022","COM","2020","1371","26","1397","2023-01-02"
"27176","2022","COM","2020","217","5","222","2023-01-02"
"27177","2022","COM","2020","551","13","564","2023-01-02"
"27179","2022","COM","2020","717","16","733","2023-01-02"
"27180","2022","COM","2020","2129","38","2167","2023-01-02"
"27181","2022","COM","2020","600","11","611","2023-01-02"
"27182","2022","COM","2020","162","2","164","2023-01-02"
"27183","2022","COM","2020","2315","41","2356","2023-01-02"
"27184","2022","COM","2020","123","3","126","2023-01-02"
"27185","2022","COM","2020","575","8","583","2023-01-02"
"27187","2022","COM","2020","338","6","344","2023-01-02"
"27188","2022","COM","2020","1512","16","1528","2023-01-02"
"27189","2022","COM","2020","425","7","432","2023-01-02"
"27190","2022","COM","2020","216","4","220","2023-01-02"
"27191","2022","COM","2020","2482","65","2547","2023-01-02"
"27192","2022","COM","2020","604","11","615","2023-01-02"
"27193","2022","COM","2020","1374","16","1390","2023-01-02"
"27194","2022","COM","2020","250","2","252","2023-01-02"
"27196","2022","COM","2020","1360","10","1370","2023-01-02"
"27198","2022","COM","2020","6149","216","6365","2023-01-02"
"27199","2022","COM","2020","570","12","582","2023-01-02"
"27200","2022","COM","2020","143","7","150","2023-01-02"
"27201","2022","COM","2020","238","3","241","2023-01-02"
"27202","2022","COM","2020","461","8","469","2023-01-02"
"27203","2022","COM","2020","461","17","478","2023-01-02"
"27204","2022","COM","2020","275","7","282","2023-01-02"
"27205","2022","COM","2020","439","8","447","2023-01-02"
"27206","2022","COM","2020","458","3","461","2023-01-02"
"27207","2022","COM","2020","584","7","591","2023-01-02"
"27208","2022","COM","2020","150","2","152","2023-01-02"
"27209","2022","COM","2020","601","11","612","2023-01-02"
"27210","2022","COM","2020","465","12","477","2023-01-02"
"27212","2022","COM","2020","110","2","112","2023-01-02"
"27213","2022","COM","2020","5964","135","6099","2023-01-02"
"27214","2022","COM","2020","818","14","832","2023-01-02"
"27215","2022","COM","2020","389","10","399","2023-01-02"
"27216","2022","COM","2020","483","25","508","2023-01-02"
"27217","2022","COM","2020","554","9","563","2023-01-02"
"27218","2022","COM","2020","1561","25","1586","2023-01-02"
"27219","2022","COM","2020","536","7","543","2023-01-02"
"27220","2022","COM","2020","347","8","355","2023-01-02"
"27222","2022","COM","2020","200","4","204","2023-01-02"
"27224","2022","COM","2020","454","9","463","2023-01-02"
"27226","2022","COM","2020","3703","81","3784","2023-01-02"
"27227","2022","COM","2020","667","11","678","2023-01-02"
"27228","2022","COM","2020","304","3","307","2023-01-02"
"27229","2022","COM","2020","46869","1227","48096","2023-01-02"
"27230","2022","COM","2020","3686","49","3735","2023-01-02"
"27231","2022","COM","2020","451","7","458","2023-01-02"
"27232","2022","COM","2020","345","7","352","2023-01-02"
"27233","2022","COM","2020","725","11","736","2023-01-02"
"27234","2022","COM","2020","351","6","357","2023-01-02"
"27235","2022","COM","2020","166","2","168","2023-01-02"
"27237","2022","COM","2020","171","4","175","2023-01-02"
"27238","2022","COM","2020","1162","30","1192","2023-01-02"
"27239","2022","COM","2020","416","7","423","2023-01-02"
"27240","2022","COM","2020","222","4","226","2023-01-02"
"27241","2022","COM","2020","173","5","178","2023-01-02"
"27242","2022","COM","2020","1013","10","1023","2023-01-02"
"27243","2022","COM","2020","748","10","758","2023-01-02"
"27245","2022","COM","2020","269","5","274","2023-01-02"
"27246","2022","COM","2020","1826","20","1846","2023-01-02"
"27247","2022","COM","2020","323","3","326","2023-01-02"
"27248","2022","COM","2020","195","3","198","2023-01-02"
"27249","2022","COM","2020","1161","21","1182","2023-01-02"
"27251","2022","COM","2020","553","6","559","2023-01-02"
"27252","2022","COM","2020","328","7","335","2023-01-02"
"27254","2022","COM","2020","847","23","870","2023-01-02"
"27256","2022","COM","2020","628","9","637","2023-01-02"
"27258","2022","COM","2020","526","6","532","2023-01-02"
"27259","2022","COM","2020","91","4","95","2023-01-02"
"27260","2022","COM","2020","664","8","672","2023-01-02"
"27261","2022","COM","2020","442","11","453","2023-01-02"
"27263","2022","COM","2020","1236","20","1256","2023-01-02"
"27266","2022","COM","2020","310","2","312","2023-01-02"
"27267","2022","COM","2020","345","4","349","2023-01-02"
"27269","2022","COM","2020","193","3","196","2023-01-02"
"27271","2022","COM","2020","320","13","333","2023-01-02"
"27273","2022","COM","2020","375","11","386","2023-01-02"
"27275","2022","COM","2020","6833","102","6935","2023-01-02"
"27276","2022","COM","2020","281","8","289","2023-01-02"
"27277","2022","COM","2020","748","15","763","2023-01-02"
"27278","2022","COM","2020","1967","38","2005","2023-01-02"
"27279","2022","COM","2020","3065","64","3129","2023-01-02"
"27280","2022","COM","2020","835","7","842","2023-01-02"
"27281","2022","COM","2020","222","8","230","2023-01-02"
"27282","2022","COM","2020","620","16","636","2023-01-02"
"27284","2022","COM","2020","11863","183","12046","2023-01-02"
"27285","2022","COM","2020","486","13","499","2023-01-02"
"27286","2022","COM","2020","400","10","410","2023-01-02"
"27287","2022","COM","2020","864","16","880","2023-01-02"
"27288","2022","COM","2020","604","14","618","2023-01-02"
"27289","2022","COM","2020","170","2","172","2023-01-02"
"27290","2022","COM","2020","1256","17","1273","2023-01-02"
"27291","2022","COM","2020","124","5","129","2023-01-02"
"27294","2022","COM","2020","993","15","1008","2023-01-02"
"27295","2022","COM","2020","470","15","485","2023-01-02"
"27298","2022","COM","2020","319","6","325","2023-01-02"
"27299","2022","COM","2020","4016","81","4097","2023-01-02"
"27300","2022","COM","2020","530","6","536","2023-01-02"
"27301","2022","COM","2020","1366","35","1401","2023-01-02"
"27302","2022","COM","2020","1300","13","1313","2023-01-02"
"27304","2022","COM","2020","163","4","167","2023-01-02"
"27306","2022","COM","2020","3017","61","3078","2023-01-02"
"27307","2022","COM","2020","473","11","484","2023-01-02"
"27309","2022","COM","2020","502","7","509","2023-01-02"
"27310","2022","COM","2020","420","8","428","2023-01-02"
"27311","2022","COM","2020","1096","4","1100","2023-01-02"
"27312","2022","COM","2020","275","12","287","2023-01-02"
"27313","2022","COM","2020","618","5","623","2023-01-02"
"27315","2022","COM","2020","272","8","280","2023-01-02"
"27316","2022","COM","2020","1294","28","1322","2023-01-02"
"27317","2022","COM","2020","453","9","462","2023-01-02"
"27318","2022","COM","2020","256","3","259","2023-01-02"
"27319","2022","COM","2020","300","2","302","2023-01-02"
"27320","2022","COM","2020","309","0","309","2023-01-02"
"27321","2022","COM","2020","136","5","141","2023-01-02"
"27322","2022","COM","2020","1388","18","1406","2023-01-02"
"27323","2022","COM","2020","286","3","289","2023-01-02"
"27324","2022","COM","2020","623","13","636","2023-01-02"
"27325","2022","COM","2020","194","3","197","2023-01-02"
"27326","2022","COM","2020","314","13","327","2023-01-02"
"27327","2022","COM","2020","211","8","219","2023-01-02"
"27329","2022","COM","2020","762","22","784","2023-01-02"
"27330","2022","COM","2020","132","4","136","2023-01-02"
"27331","2022","COM","2020","456","10","466","2023-01-02"
"27332","2022","COM","2020","787","13","800","2023-01-02"
"27333","2022","COM","2020","736","7","743","2023-01-02"
"27334","2022","COM","2020","110","1","111","2023-01-02"
"27335","2022","COM","2020","1073","26","1099","2023-01-02"
"27336","2022","COM","2020","450","4","454","2023-01-02"
"27337","2022","COM","2020","352","6","358","2023-01-02"
"27338","2022","COM","2020","679","9","688","2023-01-02"
"27339","2022","COM","2020","785","16","801","2023-01-02"
"27340","2022","COM","2020","707","11","718","2023-01-02"
"27341","2022","COM","2020","67","1","68","2023-01-02"
"27342","2022","COM","2020","198","6","204","2023-01-02"
"27343","2022","COM","2020","1271","55","1326","2023-01-02"
"27345","2022","COM","2020","207","2","209","2023-01-02"
"27346","2022","COM","2020","235","4","239","2023-01-02"
"27347","2022","COM","2020","778","26","804","2023-01-02"
"27348","2022","COM","2020","1747","26","1773","2023-01-02"
"27349","2022","COM","2020","861","13","874","2023-01-02"
"27350","2022","COM","2020","1026","17","1043","2023-01-02"
"27351","2022","COM","2020","1397","21","1418","2023-01-02"
"27353","2022","COM","2020","467","8","475","2023-01-02"
"27354","2022","COM","2020","417","4","421","2023-01-02"
"27355","2022","COM","2020","2658","30","2688","2023-01-02"
"27358","2022","COM","2020","592","13","605","2023-01-02"
"27359","2022","COM","2020","224","1","225","2023-01-02"
"27360","2022","COM","2020","328","7","335","2023-01-02"
"27361","2022","COM","2020","395","4","399","2023-01-02"
"27363","2022","COM","2020","223","7","230","2023-01-02"
"27364","2022","COM","2020","193","5","198","2023-01-02"
"27365","2022","COM","2020","2013","26","2039","2023-01-02"
"27366","2022","COM","2020","207","3","210","2023-01-02"
"27367","2022","COM","2020","1502","15","1517","2023-01-02"
"27368","2022","COM","2020","342","9","351","2023-01-02"
"27369","2022","COM","2020","77","2","79","2023-01-02"
"27370","2022","COM","2020","319","9","328","2023-01-02"
"27371","2022","COM","2020","161","1","162","2023-01-02"
"27372","2022","COM","2020","684","5","689","2023-01-02"
"27373","2022","COM","2020","105","1","106","2023-01-02"
"27374","2022","COM","2020","522","15","537","2023-01-02"
"27375","2022","COM","2020","18636","386","19022","2023-01-02"
"27376","2022","COM","2020","224","5","229","2023-01-02"
"27377","2022","COM","2020","709","6","715","2023-01-02"
"27378","2022","COM","2020","1139","24","1163","2023-01-02"
"27379","2022","COM","2020","445","8","453","2023-01-02"
"27380","2022","COM","2020","266","5","271","2023-01-02"
"27381","2022","COM","2020","164","0","164","2023-01-02"
"27382","2022","COM","2020","317","9","326","2023-01-02"
"27383","2022","COM","2020","367","12","379","2023-01-02"
"27384","2022","COM","2020","497","10","507","2023-01-02"
"27385","2022","COM","2020","1479","43","1522","2023-01-02"
"27386","2022","COM","2020","1311","13","1324","2023-01-02"
"27388","2022","COM","2020","475","10","485","2023-01-02"
"27389","2022","COM","2020","471","6","477","2023-01-02"
"27390","2022","COM","2020","1119","16","1135","2023-01-02"
"27391","2022","COM","2020","1594","20","1614","2023-01-02"
"27392","2022","COM","2020","146","3","149","2023-01-02"
"27393","2022","COM","2020","501","6","507","2023-01-02"
"27394","2022","COM","2020","454","11","465","2023-01-02"
"27395","2022","COM","2020","89","1","90","2023-01-02"
"27396","2022","COM","2020","465","9","474","2023-01-02"
"27397","2022","COM","2020","1738","41","1779","2023-01-02"
"27398","2022","COM","2020","1525","106","1631","2023-01-02"
"27399","2022","COM","2020","53","1","54","2023-01-02"
"27400","2022","COM","2020","339","5","344","2023-01-02"
"27401","2022","COM","2020","180","3","183","2023-01-02"
"27403","2022","COM","2020","236","12","248","2023-01-02"
"27404","2022","COM","2020","88","4","92","2023-01-02"
"27405","2022","COM","2020","99","4","103","2023-01-02"
"27406","2022","COM","2020","912","23","935","2023-01-02"
"27407","2022","COM","2020","332","9","341","2023-01-02"
"27408","2022","COM","2020","595","19","614","2023-01-02"
"27410","2022","COM","2020","634","12","646","2023-01-02"
"27411","2022","COM","2020","229","2","231","2023-01-02"
"27412","2022","COM","2020","1520","32","1552","2023-01-02"
"27413","2022","COM","2020","783","12","795","2023-01-02"
"27414","2022","COM","2020","829","7","836","2023-01-02"
"27415","2022","COM","2020","368","7","375","2023-01-02"
"27417","2022","COM","2020","673","12","685","2023-01-02"
"27418","2022","COM","2020","111","3","114","2023-01-02"
"27419","2022","COM","2020","747","17","764","2023-01-02"
"27420","2022","COM","2020","164","6","170","2023-01-02"
"27421","2022","COM","2020","634","13","647","2023-01-02"
"27422","2022","COM","2020","876","21","897","2023-01-02"
"27423","2022","COM","2020","766","17","783","2023-01-02"
"27424","2022","COM","2020","329","4","333","2023-01-02"
"27425","2022","COM","2020","2366","40","2406","2023-01-02"
"27426","2022","COM","2020","1341","6","1347","2023-01-02"
"27427","2022","COM","2020","419","9","428","2023-01-02"
"27428","2022","COM","2020","4254","224","4478","2023-01-02"
"27429","2022","COM","2020","186","0","186","2023-01-02"
"27430","2022","COM","2020","358","4","362","2023-01-02"
"27431","2022","COM","2020","580","5","585","2023-01-02"
"27432","2022","COM","2020","719","7","726","2023-01-02"
"27433","2022","COM","2020","194","2","196","2023-01-02"
"27434","2022","COM","2020","54","0","54","2023-01-02"
"27435","2022","COM","2020","274","5","279","2023-01-02"
"27436","2022","COM","2020","441","6","447","2023-01-02"
"27437","2022","COM","2020","341","6","347","2023-01-02"
"27438","2022","COM","2020","2260","41","2301","2023-01-02"
"27439","2022","COM","2020","1105","25","1130","2023-01-02"
"27440","2022","COM","2020","653","22","675","2023-01-02"
"27441","2022","COM","2020","71","1","72","2023-01-02"
"27442","2022","COM","2020","194","7","201","2023-01-02"
"27444","2022","COM","2020","231","1","232","2023-01-02"
"27445","2022","COM","2020","248","4","252","2023-01-02"
"27446","2022","COM","2020","479","3","482","2023-01-02"
"27447","2022","COM","2020","888","55","943","2023-01-02"
"27448","2022","COM","2020","5042","126","5168","2023-01-02"
"27451","2022","COM","2020","291","6","297","2023-01-02"
"27453","2022","COM","2020","1801","21","1822","2023-01-02"
"27454","2022","COM","2020","463","7","470","2023-01-02"
"27455","2022","COM","2020","166","3","169","2023-01-02"
"27456","2022","COM","2020","767","18","785","2023-01-02"
"27457","2022","COM","2020","694","12","706","2023-01-02"
"27458","2022","COM","2020","2620","25","2645","2023-01-02"
"27459","2022","COM","2020","71","2","73","2023-01-02"
"27460","2022","COM","2020","205","5","210","2023-01-02"
"27462","2022","COM","2020","166","1","167","2023-01-02"
"27463","2022","COM","2020","724","18","742","2023-01-02"
"27464","2022","COM","2020","919","19","938","2023-01-02"
"27465","2022","COM","2020","399","13","412","2023-01-02"
"27466","2022","COM","2020","341","5","346","2023-01-02"
"27467","2022","COM","2020","9891","261","10152","2023-01-02"
"27468","2022","COM","2020","589","9","598","2023-01-02"
"27469","2022","COM","2020","4139","51","4190","2023-01-02"
"27470","2022","COM","2020","1137","22","1159","2023-01-02"
"27471","2022","COM","2020","207","5","212","2023-01-02"
"27472","2022","COM","2020","271","6","277","2023-01-02"
"27473","2022","COM","2020","903","21","924","2023-01-02"
"27474","2022","COM","2020","1143","19","1162","2023-01-02"
"27475","2022","COM","2020","164","1","165","2023-01-02"
"27476","2022","COM","2020","393","8","401","2023-01-02"
"27477","2022","COM","2020","696","16","712","2023-01-02"
"27478","2022","COM","2020","968","25","993","2023-01-02"
"27480","2022","COM","2020","640","19","659","2023-01-02"
"27481","2022","COM","2020","401","54","455","2023-01-02"
"27482","2022","COM","2020","168","4","172","2023-01-02"
"27483","2022","COM","2020","437","3","440","2023-01-02"
"27485","2022","COM","2020","826","9","835","2023-01-02"
"27486","2022","COM","2020","650","19","669","2023-01-02"
"27487","2022","COM","2020","655","3","658","2023-01-02"
"27488","2022","COM","2020","191","6","197","2023-01-02"
"27489","2022","COM","2020","519","13","532","2023-01-02"
"27490","2022","COM","2020","267","4","271","2023-01-02"
"27492","2022","COM","2020","321","11","332","2023-01-02"
"27493","2022","COM","2020","3268","43","3311","2023-01-02"
"27495","2022","COM","2020","239","2","241","2023-01-02"
"27496","2022","COM","2020","510","6","516","2023-01-02"
"27497","2022","COM","2020","1038","17","1055","2023-01-02"
"27498","2022","COM","2020","365","4","369","2023-01-02"
"27500","2022","COM","2020","1699","56","1755","2023-01-02"
"27501","2022","COM","2020","260","6","266","2023-01-02"
"27502","2022","COM","2020","2204","27","2231","2023-01-02"
"27504","2022","COM","2020","1261","37","1298","2023-01-02"
"27505","2022","COM","2020","166","1","167","2023-01-02"
"27507","2022","COM","2020","4055","66","4121","2023-01-02"
"27508","2022","COM","2020","206","2","208","2023-01-02"
"27511","2022","COM","2020","735","11","746","2023-01-02"
"27512","2022","COM","2020","335","7","342","2023-01-02"
"27514","2022","COM","2020","370","6","376","2023-01-02"
"27516","2022","COM","2020","1386","34","1420","2023-01-02"
"27517","2022","COM","2020","2171","49","2220","2023-01-02"
"27518","2022","COM","2020","758","14","772","2023-01-02"
"27520","2022","COM","2020","141","1","142","2023-01-02"
"27521","2022","COM","2020","136","6","142","2023-01-02"
"27522","2022","COM","2020","439","4","443","2023-01-02"
"27524","2022","COM","2020","879","7","886","2023-01-02"
"27525","2022","COM","2020","299","18","317","2023-01-02"
"27527","2022","COM","2020","205","1","206","2023-01-02"
"27528","2022","COM","2020","3660","88","3748","2023-01-02"
"27529","2022","COM","2020","433","6","439","2023-01-02"
"27530","2022","COM","2020","80","3","83","2023-01-02"
"27531","2022","COM","2020","204","4","208","2023-01-02"
"27533","2022","COM","2020","491","19","510","2023-01-02"
"27534","2022","COM","2020","890","10","900","2023-01-02"
"27535","2022","COM","2020","427","11","438","2023-01-02"
"27536","2022","COM","2020","543","15","558","2023-01-02"
"27537","2022","COM","2020","872","15","887","2023-01-02"
"27538","2022","COM","2020","541","9","550","2023-01-02"
"27539","2022","COM","2020","386","6","392","2023-01-02"
"27540","2022","COM","2020","660","12","672","2023-01-02"
"27541","2022","COM","2020","202","5","207","2023-01-02"
"27542","2022","COM","2020","889","12","901","2023-01-02"
"27543","2022","COM","2020","879","11","890","2023-01-02"
"27544","2022","COM","2020","202","5","207","2023-01-02"
"27545","2022","COM","2020","122","0","122","2023-01-02"
"27546","2022","COM","2020","168","2","170","2023-01-02"
"27547","2022","COM","2020","864","21","885","2023-01-02"
"27548","2022","COM","2020","1179","25","1204","2023-01-02"
"27550","2022","COM","2020","307","7","314","2023-01-02"
"27552","2022","COM","2020","237","6","243","2023-01-02"
"27553","2022","COM","2020","418","2","420","2023-01-02"
"27554","2022","COM","2020","3319","105","3424","2023-01-02"
"27555","2022","COM","2020","246","5","251","2023-01-02"
"27556","2022","COM","2020","65","0","65","2023-01-02"
"27557","2022","COM","2020","466","6","472","2023-01-02"
"27558","2022","COM","2020","177","6","183","2023-01-02"
"27560","2022","COM","2020","249","12","261","2023-01-02"
"27561","2022","COM","2020","658","11","669","2023-01-02"
"27562","2022","COM","2020","4412","135","4547","2023-01-02"
"27563","2022","COM","2020","831","23","854","2023-01-02"
"27564","2022","COM","2020","334","5","339","2023-01-02"
"27565","2022","COM","2020","684","9","693","2023-01-02"
"27567","2022","COM","2020","280","6","286","2023-01-02"
"27568","2022","COM","2020","496","8","504","2023-01-02"
"27569","2022","COM","2020","247","10","257","2023-01-02"
"27570","2022","COM","2020","102","2","104","2023-01-02"
"27571","2022","COM","2020","336","11","347","2023-01-02"
"27572","2022","COM","2020","299","4","303","2023-01-02"
"27576","2022","COM","2020","647","15","662","2023-01-02"
"27577","2022","COM","2020","435","11","446","2023-01-02"
"27578","2022","COM","2020","591","12","603","2023-01-02"
"27579","2022","COM","2020","101","2","103","2023-01-02"
"27580","2022","COM","2020","2452","29","2481","2023-01-02"
"27582","2022","COM","2020","1747","16","1763","2023-01-02"
"27584","2022","COM","2020","277","9","286","2023-01-02"
"27586","2022","COM","2020","173","1","174","2023-01-02"
"27587","2022","COM","2020","789","6","795","2023-01-02"
"27589","2022","COM","2020","977","32","1009","2023-01-02"
"27590","2022","COM","2020","239","4","243","2023-01-02"
"27591","2022","COM","2020","589","11","600","2023-01-02"
"27592","2022","COM","2020","244","3","247","2023-01-02"
"27593","2022","COM","2020","1634","22","1656","2023-01-02"
"27594","2022","COM","2020","272","3","275","2023-01-02"
"27595","2022","COM","2020","995","19","1014","2023-01-02"
"27597","2022","COM","2020","589","1","590","2023-01-02"
"27598","2022","COM","2020","1240","22","1262","2023-01-02"
"27599","2022","COM","2020","918","10","928","2023-01-02"
"27601","2022","COM","2020","431","12","443","2023-01-02"
"27602","2022","COM","2020","5561","167","5728","2023-01-02"
"27603","2022","COM","2020","310","6","316","2023-01-02"
"27604","2022","COM","2020","154","2","156","2023-01-02"
"27605","2022","COM","2020","229","4","233","2023-01-02"
"27606","2022","COM","2020","482","4","486","2023-01-02"
"27608","2022","COM","2020","444","9","453","2023-01-02"
"27609","2022","COM","2020","339","6","345","2023-01-02"
"27610","2022","COM","2020","55","1","56","2023-01-02"
"27611","2022","COM","2020","316","10","326","2023-01-02"
"27612","2022","COM","2020","335","9","344","2023-01-02"
"27613","2022","COM","2020","376","5","381","2023-01-02"
"27614","2022","COM","2020","173","2","175","2023-01-02"
"27615","2022","COM","2020","194","5","199","2023-01-02"
"27616","2022","COM","2020","1889","53","1942","2023-01-02"
"27617","2022","COM","2020","530","9","539","2023-01-02"
"27618","2022","COM","2020","465","11","476","2023-01-02"
"27620","2022","COM","2020","468","2","470","2023-01-02"
"27621","2022","COM","2020","172","5","177","2023-01-02"
"27622","2022","COM","2020","1793","45","1838","2023-01-02"
"27623","2022","COM","2020","491","14","505","2023-01-02"
"27624","2022","COM","2020","877","23","900","2023-01-02"
"27625","2022","COM","2020","354","6","360","2023-01-02"
"27627","2022","COM","2020","243","12","255","2023-01-02"
"27629","2022","COM","2020","1781","22","1803","2023-01-02"
"27630","2022","COM","2020","321","32","353","2023-01-02"
"27631","2022","COM","2020","371","4","375","2023-01-02"
"27632","2022","COM","2020","596","8","604","2023-01-02"
"27633","2022","COM","2020","497","4","501","2023-01-02"
"27635","2022","COM","2020","141","1","142","2023-01-02"
"27638","2022","COM","2020","3734","55","3789","2023-01-02"
"27640","2022","COM","2020","190","4","194","2023-01-02"
"27641","2022","COM","2020","262","5","267","2023-01-02"
"27643","2022","COM","2020","1059","16","1075","2023-01-02"
"27644","2022","COM","2020","566","41","607","2023-01-02"
"27645","2022","COM","2020","155","4","159","2023-01-02"
"27646","2022","COM","2020","443","5","448","2023-01-02"
"27649","2022","COM","2020","353","7","360","2023-01-02"
"27650","2022","COM","2020","464","8","472","2023-01-02"
"27652","2022","COM","2020","305","8","313","2023-01-02"
"27654","2022","COM","2020","1127","12","1139","2023-01-02"
"27655","2022","COM","2020","731","160","891","2023-01-02"
"27656","2022","COM","2020","1294","32","1326","2023-01-02"
"27658","2022","COM","2020","369","9","378","2023-01-02"
"27659","2022","COM","2020","127","6","133","2023-01-02"
"27660","2022","COM","2020","236","2","238","2023-01-02"
"27661","2022","COM","2020","424","9","433","2023-01-02"
"27662","2022","COM","2020","336","5","341","2023-01-02"
"27663","2022","COM","2020","169","4","173","2023-01-02"
"27664","2022","COM","2020","516","8","524","2023-01-02"
"27665","2022","COM","2020","756","13","769","2023-01-02"
"27666","2022","COM","2020","570","19","589","2023-01-02"
"27667","2022","COM","2020","392","11","403","2023-01-02"
"27668","2022","COM","2020","690","11","701","2023-01-02"
"27669","2022","COM","2020","431","8","439","2023-01-02"
"27670","2022","COM","2020","966","18","984","2023-01-02"
"27671","2022","COM","2020","163","0","163","2023-01-02"
"27672","2022","COM","2020","355","1","356","2023-01-02"
"27673","2022","COM","2020","176","4","180","2023-01-02"
"27674","2022","COM","2020","268","10","278","2023-01-02"
"27677","2022","COM","2020","405","6","411","2023-01-02"
"27678","2022","COM","2020","1043","23","1066","2023-01-02"
"27679","2022","COM","2020","7374","343","7717","2023-01-02"
"27680","2022","COM","2020","189","6","195","2023-01-02"
"27681","2022","COM","2020","24056","622","24678","2023-01-02"
"27682","2022","COM","2020","639","16","655","2023-01-02"
"27683","2022","COM","2020","231","3","234","2023-01-02"
"27684","2022","COM","2020","838","11","849","2023-01-02"
"27685","2022","COM","2020","663","19","682","2023-01-02"
"27686","2022","COM","2020","48","0","48","2023-01-02"
"27689","2022","COM","2020","350","17","367","2023-01-02"
"27690","2022","COM","2020","312","7","319","2023-01-02"
"27691","2022","COM","2020","865","19","884","2023-01-02"
"27692","2022","COM","2020","164","7","171","2023-01-02"
"27693","2022","COM","2020","1299","32","1331","2023-01-02"
"27694","2022","COM","2020","319","15","334","2023-01-02"
"27695","2022","COM","2020","265","11","276","2023-01-02"
"27696","2022","COM","2020","908","22","930","2023-01-02"
"27697","2022","COM","2020","329","17","346","2023-01-02"
"27698","2022","COM","2020","564","13","577","2023-01-02"
"27699","2022","COM","2020","118","3","121","2023-01-02"
"27700","2022","COM","2020","727","14","741","2023-01-02"
"27701","2022","COM","2020","12702","286","12988","2023-01-02"
"28001","2022","COM","2020","2409","46","2455","2023-01-02"
"28003","2022","COM","2020","141","4","145","2023-01-02"
"28004","2022","COM","2020","316","3","319","2023-01-02"
"28005","2022","COM","2020","751","87","838","2023-01-02"
"28006","2022","COM","2020","1809","47","1856","2023-01-02"
"28007","2022","COM","2020","2689","104","2793","2023-01-02"
"28008","2022","COM","2020","208","2","210","2023-01-02"
"28009","2022","COM","2020","71","1","72","2023-01-02"
"28010","2022","COM","2020","323","8","331","2023-01-02"
"28012","2022","COM","2020","3580","59","3639","2023-01-02"
"28013","2022","COM","2020","1565","24","1589","2023-01-02"
"28014","2022","COM","2020","686","7","693","2023-01-02"
"28015","2022","COM","2020","6230","94","6324","2023-01-02"
"28016","2022","COM","2020","118","6","124","2023-01-02"
"28018","2022","COM","2020","1492","16","1508","2023-01-02"
"28019","2022","COM","2020","204","3","207","2023-01-02"
"28021","2022","COM","2020","1597","30","1627","2023-01-02"
"28022","2022","COM","2020","1146","31","1177","2023-01-02"
"28023","2022","COM","2020","1367","26","1393","2023-01-02"
"28024","2022","COM","2020","1780","61","1841","2023-01-02"
"28025","2022","COM","2020","100","2","102","2023-01-02"
"28026","2022","COM","2020","243","0","243","2023-01-02"
"28027","2022","COM","2020","1223","20","1243","2023-01-02"
"28028","2022","COM","2020","260","4","264","2023-01-02"
"28029","2022","COM","2020","322","6","328","2023-01-02"
"28030","2022","COM","2020","278","5","283","2023-01-02"
"28031","2022","COM","2020","386","111","497","2023-01-02"
"28032","2022","COM","2020","343","4","347","2023-01-02"
"28033","2022","COM","2020","797","32","829","2023-01-02"
"28034","2022","COM","2020","890","13","903","2023-01-02"
"28035","2022","COM","2020","969","23","992","2023-01-02"
"28036","2022","COM","2020","842","21","863","2023-01-02"
"28037","2022","COM","2020","337","4","341","2023-01-02"
"28038","2022","COM","2020","118","4","122","2023-01-02"
"28039","2022","COM","2020","1670","32","1702","2023-01-02"
"28040","2022","COM","2020","320","9","329","2023-01-02"
"28041","2022","COM","2020","278","4","282","2023-01-02"
"28045","2022","COM","2020","228","6","234","2023-01-02"
"28046","2022","COM","2020","480","8","488","2023-01-02"
"28047","2022","COM","2020","718","15","733","2023-01-02"
"28048","2022","COM","2020","744","14","758","2023-01-02"
"28049","2022","COM","2020","244","5","249","2023-01-02"
"28050","2022","COM","2020","268","6","274","2023-01-02"
"28051","2022","COM","2020","4841","101","4942","2023-01-02"
"28052","2022","COM","2020","746","15","761","2023-01-02"
"28053","2022","COM","2020","246","3","249","2023-01-02"
"28054","2022","COM","2020","506","10","516","2023-01-02"
"28055","2022","COM","2020","563","9","572","2023-01-02"
"28056","2022","COM","2020","1676","45","1721","2023-01-02"
"28057","2022","COM","2020","598","9","607","2023-01-02"
"28058","2022","COM","2020","363","4","367","2023-01-02"
"28059","2022","COM","2020","1814","26","1840","2023-01-02"
"28060","2022","COM","2020","264","4","268","2023-01-02"
"28061","2022","COM","2020","3265","37","3302","2023-01-02"
"28062","2022","COM","2020","904","15","919","2023-01-02"
"28064","2022","COM","2020","2026","51","2077","2023-01-02"
"28065","2022","COM","2020","107","5","112","2023-01-02"
"28067","2022","COM","2020","89","2","91","2023-01-02"
"28068","2022","COM","2020","431","12","443","2023-01-02"
"28070","2022","COM","2020","3737","111","3848","2023-01-02"
"28071","2022","COM","2020","702","3","705","2023-01-02"
"28072","2022","COM","2020","405","12","417","2023-01-02"
"28073","2022","COM","2020","344","5","349","2023-01-02"
"28074","2022","COM","2020","247","4","251","2023-01-02"
"28075","2022","COM","2020","1014","180","1194","2023-01-02"
"28076","2022","COM","2020","196","3","199","2023-01-02"
"28077","2022","COM","2020","169","4","173","2023-01-02"
"28078","2022","COM","2020","184","4","188","2023-01-02"
"28079","2022","COM","2020","296","4","300","2023-01-02"
"28080","2022","COM","2020","255","3","258","2023-01-02"
"28081","2022","COM","2020","302","5","307","2023-01-02"
"28082","2022","COM","2020","646","14","660","2023-01-02"
"28084","2022","COM","2020","690","22","712","2023-01-02"
"28085","2022","COM","2020","38443","1068","39511","2023-01-02"
"28086","2022","COM","2020","320","8","328","2023-01-02"
"28087","2022","COM","2020","240","4","244","2023-01-02"
"28088","2022","COM","2020","12949","310","13259","2023-01-02"
"28089","2022","COM","2020","2614","33","2647","2023-01-02"
"28090","2022","COM","2020","107","3","110","2023-01-02"
"28091","2022","COM","2020","146","3","149","2023-01-02"
"28092","2022","COM","2020","230","6","236","2023-01-02"
"28094","2022","COM","2020","1662","27","1689","2023-01-02"
"28095","2022","COM","2020","281","6","287","2023-01-02"
"28096","2022","COM","2020","1264","19","1283","2023-01-02"
"28098","2022","COM","2020","1829","48","1877","2023-01-02"
"28099","2022","COM","2020","1096","21","1117","2023-01-02"
"28100","2022","COM","2020","452","6","458","2023-01-02"
"28102","2022","COM","2020","716","9","725","2023-01-02"
"28103","2022","COM","2020","5618","106","5724","2023-01-02"
"28104","2022","COM","2020","911","28","939","2023-01-02"
"28105","2022","COM","2020","552","6","558","2023-01-02"
"28106","2022","COM","2020","400","11","411","2023-01-02"
"28107","2022","COM","2020","356","9","365","2023-01-02"
"28108","2022","COM","2020","231","8","239","2023-01-02"
"28109","2022","COM","2020","319","5","324","2023-01-02"
"28110","2022","COM","2020","4042","118","4160","2023-01-02"
"28111","2022","COM","2020","366","13","379","2023-01-02"
"28113","2022","COM","2020","1337","32","1369","2023-01-02"
"28114","2022","COM","2020","135","0","135","2023-01-02"
"28116","2022","COM","2020","2812","62","2874","2023-01-02"
"28117","2022","COM","2020","266","9","275","2023-01-02"
"28118","2022","COM","2020","426","15","441","2023-01-02"
"28119","2022","COM","2020","148","2","150","2023-01-02"
"28120","2022","COM","2020","449","2","451","2023-01-02"
"28121","2022","COM","2020","110","0","110","2023-01-02"
"28122","2022","COM","2020","1499","23","1522","2023-01-02"
"28123","2022","COM","2020","449","5","454","2023-01-02"
"28124","2022","COM","2020","746","18","764","2023-01-02"
"28126","2022","COM","2020","199","4","203","2023-01-02"
"28127","2022","COM","2020","1250","26","1276","2023-01-02"
"28128","2022","COM","2020","434","6","440","2023-01-02"
"28129","2022","COM","2020","775","21","796","2023-01-02"
"28130","2022","COM","2020","996","13","1009","2023-01-02"
"28132","2022","COM","2020","662","16","678","2023-01-02"
"28134","2022","COM","2020","30744","495","31239","2023-01-02"
"28135","2022","COM","2020","1208","57","1265","2023-01-02"
"28136","2022","COM","2020","164","1","165","2023-01-02"
"28137","2022","COM","2020","829","17","846","2023-01-02"
"28139","2022","COM","2020","184","1","185","2023-01-02"
"28140","2022","COM","2020","5601","68","5669","2023-01-02"
"28141","2022","COM","2020","319","11","330","2023-01-02"
"28142","2022","COM","2020","182","2","184","2023-01-02"
"28143","2022","COM","2020","245","3","248","2023-01-02"
"28144","2022","COM","2020","206","7","213","2023-01-02"
"28146","2022","COM","2020","852","9","861","2023-01-02"
"28147","2022","COM","2020","609","10","619","2023-01-02"
"28148","2022","COM","2020","371","11","382","2023-01-02"
"28149","2022","COM","2020","581","16","597","2023-01-02"
"28151","2022","COM","2020","176","5","181","2023-01-02"
"28153","2022","COM","2020","207","6","213","2023-01-02"
"28154","2022","COM","2020","1699","33","1732","2023-01-02"
"28155","2022","COM","2020","199","5","204","2023-01-02"
"28156","2022","COM","2020","894","16","910","2023-01-02"
"28157","2022","COM","2020","130","3","133","2023-01-02"
"28158","2022","COM","2020","1127","28","1155","2023-01-02"
"28159","2022","COM","2020","346","4","350","2023-01-02"
"28160","2022","COM","2020","864","8","872","2023-01-02"
"28161","2022","COM","2020","499","7","506","2023-01-02"
"28162","2022","COM","2020","294","5","299","2023-01-02"
"28163","2022","COM","2020","215","3","218","2023-01-02"
"28164","2022","COM","2020","737","10","747","2023-01-02"
"28166","2022","COM","2020","255","2","257","2023-01-02"
"28167","2022","COM","2020","382","7","389","2023-01-02"
"28168","2022","COM","2020","3641","66","3707","2023-01-02"
"28169","2022","COM","2020","225","7","232","2023-01-02"
"28170","2022","COM","2020","283","6","289","2023-01-02"
"28171","2022","COM","2020","943","22","965","2023-01-02"
"28172","2022","COM","2020","774","16","790","2023-01-02"
"28173","2022","COM","2020","1489","33","1522","2023-01-02"
"28175","2022","COM","2020","177","3","180","2023-01-02"
"28176","2022","COM","2020","680","13","693","2023-01-02"
"28177","2022","COM","2020","751","14","765","2023-01-02"
"28178","2022","COM","2020","325","6","331","2023-01-02"
"28180","2022","COM","2020","491","13","504","2023-01-02"
"28182","2022","COM","2020","316","2","318","2023-01-02"
"28183","2022","COM","2020","682","13","695","2023-01-02"
"28184","2022","COM","2020","341","4","345","2023-01-02"
"28185","2022","COM","2020","1307","21","1328","2023-01-02"
"28187","2022","COM","2020","661","14","675","2023-01-02"
"28188","2022","COM","2020","948","16","964","2023-01-02"
"28189","2022","COM","2020","178","4","182","2023-01-02"
"28190","2022","COM","2020","459","13","472","2023-01-02"
"28191","2022","COM","2020","2675","57","2732","2023-01-02"
"28192","2022","COM","2020","319","3","322","2023-01-02"
"28193","2022","COM","2020","131","3","134","2023-01-02"
"28194","2022","COM","2020","403","16","419","2023-01-02"
"28195","2022","COM","2020","749","12","761","2023-01-02"
"28196","2022","COM","2020","3237","50","3287","2023-01-02"
"28197","2022","COM","2020","139","1","140","2023-01-02"
"28198","2022","COM","2020","796","11","807","2023-01-02"
"28199","2022","COM","2020","2541","44","2585","2023-01-02"
"28200","2022","COM","2020","421","5","426","2023-01-02"
"28201","2022","COM","2020","1970","44","2014","2023-01-02"
"28202","2022","COM","2020","325","6","331","2023-01-02"
"28203","2022","COM","2020","641","6","647","2023-01-02"
"28206","2022","COM","2020","671","13","684","2023-01-02"
"28207","2022","COM","2020","233","3","236","2023-01-02"
"28208","2022","COM","2020","378","14","392","2023-01-02"
"28209","2022","COM","2020","5629","159","5788","2023-01-02"
"28210","2022","COM","2020","224","2","226","2023-01-02"
"28211","2022","COM","2020","577","7","584","2023-01-02"
"28212","2022","COM","2020","202","9","211","2023-01-02"
"28213","2022","COM","2020","676","11","687","2023-01-02"
"28214","2022","COM","2020","3327","81","3408","2023-01-02"
"28215","2022","COM","2020","252","6","258","2023-01-02"
"28216","2022","COM","2020","204","1","205","2023-01-02"
"28217","2022","COM","2020","179","2","181","2023-01-02"
"28218","2022","COM","2020","15525","209","15734","2023-01-02"
"28219","2022","COM","2020","413","10","423","2023-01-02"
"28220","2022","COM","2020","6686","313","6999","2023-01-02"
"28221","2022","COM","2020","135","7","142","2023-01-02"
"28222","2022","COM","2020","385","10","395","2023-01-02"
"28223","2022","COM","2020","1563","23","1586","2023-01-02"
"28225","2022","COM","2020","645","11","656","2023-01-02"
"28226","2022","COM","2020","896","15","911","2023-01-02"
"28227","2022","COM","2020","4494","78","4572","2023-01-02"
"28229","2022","COM","2020","11186","259","11445","2023-01-02"
"28230","2022","COM","2020","384","7","391","2023-01-02"
"28231","2022","COM","2020","169","4","173","2023-01-02"
"28232","2022","COM","2020","592","30","622","2023-01-02"
"28233","2022","COM","2020","1156","26","1182","2023-01-02"
"28234","2022","COM","2020","476","8","484","2023-01-02"
"28235","2022","COM","2020","383","3","386","2023-01-02"
"28236","2022","COM","2020","2190","42","2232","2023-01-02"
"28237","2022","COM","2020","207","4","211","2023-01-02"
"28239","2022","COM","2020","983","25","1008","2023-01-02"
"28240","2022","COM","2020","507","8","515","2023-01-02"
"28242","2022","COM","2020","101","1","102","2023-01-02"
"28243","2022","COM","2020","212","7","219","2023-01-02"
"28245","2022","COM","2020","367","9","376","2023-01-02"
"28246","2022","COM","2020","533","9","542","2023-01-02"
"28247","2022","COM","2020","570","15","585","2023-01-02"
"28248","2022","COM","2020","332","5","337","2023-01-02"
"28249","2022","COM","2020","617","14","631","2023-01-02"
"28251","2022","COM","2020","1063","27","1090","2023-01-02"
"28252","2022","COM","2020","186","3","189","2023-01-02"
"28253","2022","COM","2020","1091","82","1173","2023-01-02"
"28254","2022","COM","2020","797","13","810","2023-01-02"
"28255","2022","COM","2020","166","2","168","2023-01-02"
"28256","2022","COM","2020","444","14","458","2023-01-02"
"28257","2022","COM","2020","87","2","89","2023-01-02"
"28259","2022","COM","2020","332","5","337","2023-01-02"
"28260","2022","COM","2020","100","5","105","2023-01-02"
"28261","2022","COM","2020","597","12","609","2023-01-02"
"28263","2022","COM","2020","252","6","258","2023-01-02"
"28264","2022","COM","2020","138","3","141","2023-01-02"
"28265","2022","COM","2020","258","2","260","2023-01-02"
"28267","2022","COM","2020","514","5","519","2023-01-02"
"28268","2022","COM","2020","16","2","18","2023-01-02"
"28269","2022","COM","2020","1908","58","1966","2023-01-02"
"28270","2022","COM","2020","222","4","226","2023-01-02"
"28271","2022","COM","2020","136","4","140","2023-01-02"
"28272","2022","COM","2020","154","3","157","2023-01-02"
"28273","2022","COM","2020","139","2","141","2023-01-02"
"28274","2022","COM","2020","238","6","244","2023-01-02"
"28275","2022","COM","2020","667","15","682","2023-01-02"
"28276","2022","COM","2020","206","8","214","2023-01-02"
"28277","2022","COM","2020","304","13","317","2023-01-02"
"28278","2022","COM","2020","1484","34","1518","2023-01-02"
"28279","2022","COM","2020","3990","67","4057","2023-01-02"
"28280","2022","COM","2020","9433","433","9866","2023-01-02"
"28281","2022","COM","2020","513","15","528","2023-01-02"
"28282","2022","COM","2020","434","10","444","2023-01-02"
"28283","2022","COM","2020","283","5","288","2023-01-02"
"28284","2022","COM","2020","277","6","283","2023-01-02"
"28285","2022","COM","2020","352","9","361","2023-01-02"
"28286","2022","COM","2020","623","12","635","2023-01-02"
"28287","2022","COM","2020","1003","15","1018","2023-01-02"
"28289","2022","COM","2020","219","6","225","2023-01-02"
"28290","2022","COM","2020","284","9","293","2023-01-02"
"28291","2022","COM","2020","519","16","535","2023-01-02"
"28292","2022","COM","2020","751","14","765","2023-01-02"
"28293","2022","COM","2020","1190","27","1217","2023-01-02"
"28294","2022","COM","2020","523","13","536","2023-01-02"
"28296","2022","COM","2020","269","4","273","2023-01-02"
"28298","2022","COM","2020","2768","47","2815","2023-01-02"
"28299","2022","COM","2020","166","6","172","2023-01-02"
"28300","2022","COM","2020","160","6","166","2023-01-02"
"28301","2022","COM","2020","445","6","451","2023-01-02"
"28302","2022","COM","2020","1095","319","1414","2023-01-02"
"28303","2022","COM","2020","96","3","99","2023-01-02"
"28304","2022","COM","2020","438","7","445","2023-01-02"
"28305","2022","COM","2020","295","7","302","2023-01-02"
"28306","2022","COM","2020","191","3","194","2023-01-02"
"28308","2022","COM","2020","261","11","272","2023-01-02"
"28309","2022","COM","2020","1077","16","1093","2023-01-02"
"28310","2022","COM","2020","257","6","263","2023-01-02"
"28312","2022","COM","2020","128","2","130","2023-01-02"
"28313","2022","COM","2020","196","1","197","2023-01-02"
"28314","2022","COM","2020","128","4","132","2023-01-02"
"28315","2022","COM","2020","22","1","23","2023-01-02"
"28316","2022","COM","2020","126","3","129","2023-01-02"
"28317","2022","COM","2020","570","5","575","2023-01-02"
"28319","2022","COM","2020","343","11","354","2023-01-02"
"28321","2022","COM","2020","837","14","851","2023-01-02"
"28322","2022","COM","2020","489","9","498","2023-01-02"
"28323","2022","COM","2020","285","1","286","2023-01-02"
"28324","2022","COM","2020","886","22","908","2023-01-02"
"28325","2022","COM","2020","1055","26","1081","2023-01-02"
"28326","2022","COM","2020","358","2","360","2023-01-02"
"28327","2022","COM","2020","191","2","193","2023-01-02"
"28329","2022","COM","2020","158","2","160","2023-01-02"
"28330","2022","COM","2020","1350","32","1382","2023-01-02"
"28331","2022","COM","2020","949","19","968","2023-01-02"
"28332","2022","COM","2020","1092","21","1113","2023-01-02"
"28333","2022","COM","2020","143","7","150","2023-01-02"
"28334","2022","COM","2020","2164","53","2217","2023-01-02"
"28335","2022","COM","2020","843","24","867","2023-01-02"
"28336","2022","COM","2020","103","0","103","2023-01-02"
"28337","2022","COM","2020","2789","59","2848","2023-01-02"
"28339","2022","COM","2020","369","11","380","2023-01-02"
"28341","2022","COM","2020","250","5","255","2023-01-02"
"28342","2022","COM","2020","265","5","270","2023-01-02"
"28343","2022","COM","2020","448","11","459","2023-01-02"
"28344","2022","COM","2020","266","11","277","2023-01-02"
"28346","2022","COM","2020","56","3","59","2023-01-02"
"28347","2022","COM","2020","922","29","951","2023-01-02"
"28348","2022","COM","2020","4041","69","4110","2023-01-02"
"28349","2022","COM","2020","259","8","267","2023-01-02"
"28350","2022","COM","2020","954","23","977","2023-01-02"
"28351","2022","COM","2020","403","8","411","2023-01-02"
"28352","2022","COM","2020","1561","41","1602","2023-01-02"
"28353","2022","COM","2020","401","5","406","2023-01-02"
"28354","2022","COM","2020","423","69","492","2023-01-02"
"28355","2022","COM","2020","296","8","304","2023-01-02"
"28357","2022","COM","2020","1063","29","1092","2023-01-02"
"28358","2022","COM","2020","2093","64","2157","2023-01-02"
"28359","2022","COM","2020","4048","49","4097","2023-01-02"
"28360","2022","COM","2020","923","19","942","2023-01-02"
"28362","2022","COM","2020","505","3","508","2023-01-02"
"28363","2022","COM","2020","1021","13","1034","2023-01-02"
"28364","2022","COM","2020","758","11","769","2023-01-02"
"28365","2022","COM","2020","410","9","419","2023-01-02"
"28366","2022","COM","2020","320","3","323","2023-01-02"
"28367","2022","COM","2020","322","0","322","2023-01-02"
"28368","2022","COM","2020","202","3","205","2023-01-02"
"28369","2022","COM","2020","814","10","824","2023-01-02"
"28370","2022","COM","2020","492","14","506","2023-01-02"
"28371","2022","COM","2020","1100","21","1121","2023-01-02"
"28372","2022","COM","2020","558","11","569","2023-01-02"
"28373","2022","COM","2020","3005","44","3049","2023-01-02"
"28374","2022","COM","2020","541","4","545","2023-01-02"
"28375","2022","COM","2020","367","8","375","2023-01-02"
"28377","2022","COM","2020","1740","43","1783","2023-01-02"
"28378","2022","COM","2020","514","15","529","2023-01-02"
"28379","2022","COM","2020","474","10","484","2023-01-02"
"28380","2022","COM","2020","1973","155","2128","2023-01-02"
"28382","2022","COM","2020","882","12","894","2023-01-02"
"28383","2022","COM","2020","706","6","712","2023-01-02"
"28385","2022","COM","2020","450","17","467","2023-01-02"
"28386","2022","COM","2020","1240","21","1261","2023-01-02"
"28387","2022","COM","2020","983","11","994","2023-01-02"
"28388","2022","COM","2020","1048","32","1080","2023-01-02"
"28389","2022","COM","2020","341","8","349","2023-01-02"
"28390","2022","COM","2020","307","6","313","2023-01-02"
"28391","2022","COM","2020","2580","32","2612","2023-01-02"
"28392","2022","COM","2020","166","2","168","2023-01-02"
"28393","2022","COM","2020","2228","66","2294","2023-01-02"
"28394","2022","COM","2020","1420","27","1447","2023-01-02"
"28395","2022","COM","2020","432","14","446","2023-01-02"
"28396","2022","COM","2020","308","4","312","2023-01-02"
"28397","2022","COM","2020","409","13","422","2023-01-02"
"28398","2022","COM","2020","1181","21","1202","2023-01-02"
"28400","2022","COM","2020","194","8","202","2023-01-02"
"28401","2022","COM","2020","453","8","461","2023-01-02"
"28403","2022","COM","2020","763","21","784","2023-01-02"
"28404","2022","COM","2020","12411","172","12583","2023-01-02"
"28405","2022","COM","2020","1097","23","1120","2023-01-02"
"28406","2022","COM","2020","1244","19","1263","2023-01-02"
"28407","2022","COM","2020","290","8","298","2023-01-02"
"28408","2022","COM","2020","116","3","119","2023-01-02"
"28409","2022","COM","2020","444","16","460","2023-01-02"
"28410","2022","COM","2020","302","4","306","2023-01-02"
"28411","2022","COM","2020","171","2","173","2023-01-02"
"28414","2022","COM","2020","59","5","64","2023-01-02"
"28415","2022","COM","2020","1692","32","1724","2023-01-02"
"28417","2022","COM","2020","1366","34","1400","2023-01-02"
"28418","2022","COM","2020","163","5","168","2023-01-02"
"28419","2022","COM","2020","337","8","345","2023-01-02"
"28421","2022","COM","2020","267","3","270","2023-01-02"
"28422","2022","COM","2020","3932","61","3993","2023-01-02"
"28423","2022","COM","2020","599","15","614","2023-01-02"
"28424","2022","COM","2020","1635","32","1667","2023-01-02"
"28425","2022","COM","2020","564","11","575","2023-01-02"
"28426","2022","COM","2020","491","9","500","2023-01-02"
"29001","2022","COM","2020","998","19","1017","2023-01-02"
"29002","2022","COM","2020","1397","29","1426","2023-01-02"
"29003","2022","COM","2020","3690","66","3756","2023-01-02"
"29004","2022","COM","2020","5656","155","5811","2023-01-02"
"29005","2022","COM","2020","1281","31","1312","2023-01-02"
"29006","2022","COM","2020","3702","73","3775","2023-01-02"
"29007","2022","COM","2020","879","28","907","2023-01-02"
"29008","2022","COM","2020","1006","27","1033","2023-01-02"
"29010","2022","COM","2020","1653","36","1689","2023-01-02"
"29011","2022","COM","2020","3559","91","3650","2023-01-02"
"29012","2022","COM","2020","179","2","181","2023-01-02"
"29013","2022","COM","2020","222","5","227","2023-01-02"
"29014","2022","COM","2020","431","9","440","2023-01-02"
"29015","2022","COM","2020","3545","63","3608","2023-01-02"
"29016","2022","COM","2020","1025","8","1033","2023-01-02"
"29017","2022","COM","2020","860","26","886","2023-01-02"
"29018","2022","COM","2020","439","5","444","2023-01-02"
"29019","2022","COM","2020","139456","2654","142110","2023-01-02"
"29020","2022","COM","2020","5736","114","5850","2023-01-02"
"29021","2022","COM","2020","1926","54","1980","2023-01-02"
"29022","2022","COM","2020","2462","54","2516","2023-01-02"
"29023","2022","COM","2020","3212","97","3309","2023-01-02"
"29024","2022","COM","2020","7165","608","7773","2023-01-02"
"29025","2022","COM","2020","1532","44","1576","2023-01-02"
"29026","2022","COM","2020","5156","422","5578","2023-01-02"
"29027","2022","COM","2020","3650","91","3741","2023-01-02"
"29028","2022","COM","2020","915","20","935","2023-01-02"
"29029","2022","COM","2020","1138","17","1155","2023-01-02"
"29030","2022","COM","2020","3635","111","3746","2023-01-02"
"29031","2022","COM","2020","4625","117","4742","2023-01-02"
"29032","2022","COM","2020","2113","50","2163","2023-01-02"
"29033","2022","COM","2020","520","6","526","2023-01-02"
"29034","2022","COM","2020","653","12","665","2023-01-02"
"29035","2022","COM","2020","1121","19","1140","2023-01-02"
"29036","2022","COM","2020","603","9","612","2023-01-02"
"29037","2022","COM","2020","4236","128","4364","2023-01-02"
"29038","2022","COM","2020","997","23","1020","2023-01-02"
"29039","2022","COM","2020","20209","890","21099","2023-01-02"
"29040","2022","COM","2020","2768","76","2844","2023-01-02"
"29041","2022","COM","2020","1887","33","1920","2023-01-02"
"29042","2022","COM","2020","7360","215","7575","2023-01-02"
"29043","2022","COM","2020","1833","46","1879","2023-01-02"
"29044","2022","COM","2020","1864","38","1902","2023-01-02"
"29045","2022","COM","2020","2206","68","2274","2023-01-02"
"29046","2022","COM","2020","13956","423","14379","2023-01-02"
"29047","2022","COM","2020","1904","33","1937","2023-01-02"
"29048","2022","COM","2020","2235","52","2287","2023-01-02"
"29049","2022","COM","2020","3328","143","3471","2023-01-02"
"29051","2022","COM","2020","8484","206","8690","2023-01-02"
"29053","2022","COM","2020","1782","61","1843","2023-01-02"
"29054","2022","COM","2020","656","14","670","2023-01-02"
"29055","2022","COM","2020","3239","77","3316","2023-01-02"
"29056","2022","COM","2020","1962","33","1995","2023-01-02"
"29057","2022","COM","2020","3459","124","3583","2023-01-02"
"29058","2022","COM","2020","10060","497","10557","2023-01-02"
"29059","2022","COM","2020","1052","32","1084","2023-01-02"
"29060","2022","COM","2020","2781","79","2860","2023-01-02"
"29061","2022","COM","2020","6281","112","6393","2023-01-02"
"29062","2022","COM","2020","1104","25","1129","2023-01-02"
"29063","2022","COM","2020","430","7","437","2023-01-02"
"29064","2022","COM","2020","447","4","451","2023-01-02"
"29065","2022","COM","2020","924","11","935","2023-01-02"
"29066","2022","COM","2020","1824","30","1854","2023-01-02"
"29067","2022","COM","2020","1286","41","1327","2023-01-02"
"29068","2022","COM","2020","2529","48","2577","2023-01-02"
"29069","2022","COM","2020","8119","146","8265","2023-01-02"
"29070","2022","COM","2020","523","10","533","2023-01-02"
"29071","2022","COM","2020","790","15","805","2023-01-02"
"29072","2022","COM","2020","2693","48","2741","2023-01-02"
"29073","2022","COM","2020","932","32","964","2023-01-02"
"29074","2022","COM","2020","1007","21","1028","2023-01-02"
"29075","2022","COM","2020","15196","377","15573","2023-01-02"
"29076","2022","COM","2020","4606","65","4671","2023-01-02"
"29077","2022","COM","2020","1983","47","2030","2023-01-02"
"29078","2022","COM","2020","2036","41","2077","2023-01-02"
"29079","2022","COM","2020","1224","40","1264","2023-01-02"
"29080","2022","COM","2020","2224","65","2289","2023-01-02"
"29081","2022","COM","2020","1405","26","1431","2023-01-02"
"29082","2022","COM","2020","450","12","462","2023-01-02"
"29083","2022","COM","2020","266","1","267","2023-01-02"
"29084","2022","COM","2020","162","5","167","2023-01-02"
"29085","2022","COM","2020","737","18","755","2023-01-02"
"29086","2022","COM","2020","1459","22","1481","2023-01-02"
"29087","2022","COM","2020","725","16","741","2023-01-02"
"29089","2022","COM","2020","852","22","874","2023-01-02"
"29090","2022","COM","2020","784","25","809","2023-01-02"
"29091","2022","COM","2020","2087","37","2124","2023-01-02"
"29093","2022","COM","2020","1417","31","1448","2023-01-02"
"29094","2022","COM","2020","651","14","665","2023-01-02"
"29095","2022","COM","2020","1507","28","1535","2023-01-02"
"29097","2022","COM","2020","2023","49","2072","2023-01-02"
"29098","2022","COM","2020","2148","50","2198","2023-01-02"
"29099","2022","COM","2020","825","21","846","2023-01-02"
"29100","2022","COM","2020","411","12","423","2023-01-02"
"29101","2022","COM","2020","3613","95","3708","2023-01-02"
"29102","2022","COM","2020","963","13","976","2023-01-02"
"29103","2022","COM","2020","16025","602","16627","2023-01-02"
"29104","2022","COM","2020","342","8","350","2023-01-02"
"29105","2022","COM","2020","9204","318","9522","2023-01-02"
"29106","2022","COM","2020","1855","42","1897","2023-01-02"
"29107","2022","COM","2020","888","14","902","2023-01-02"
"29108","2022","COM","2020","1490","39","1529","2023-01-02"
"29109","2022","COM","2020","1487","37","1524","2023-01-02"
"29110","2022","COM","2020","854","14","868","2023-01-02"
"29111","2022","COM","2020","1317","22","1339","2023-01-02"
"29112","2022","COM","2020","956","17","973","2023-01-02"
"29113","2022","COM","2020","2369","38","2407","2023-01-02"
"29114","2022","COM","2020","347","7","354","2023-01-02"
"29115","2022","COM","2020","301","8","309","2023-01-02"
"29116","2022","COM","2020","152","2","154","2023-01-02"
"29117","2022","COM","2020","5694","114","5808","2023-01-02"
"29119","2022","COM","2020","1485","17","1502","2023-01-02"
"29120","2022","COM","2020","1966","65","2031","2023-01-02"
"29122","2022","COM","2020","683","15","698","2023-01-02"
"29123","2022","COM","2020","778","23","801","2023-01-02"
"29124","2022","COM","2020","7285","221","7506","2023-01-02"
"29125","2022","COM","2020","828","17","845","2023-01-02"
"29126","2022","COM","2020","208","7","215","2023-01-02"
"29128","2022","COM","2020","396","5","401","2023-01-02"
"29130","2022","COM","2020","5115","127","5242","2023-01-02"
"29131","2022","COM","2020","472","12","484","2023-01-02"
"29132","2022","COM","2020","799","31","830","2023-01-02"
"29133","2022","COM","2020","1521","43","1564","2023-01-02"
"29134","2022","COM","2020","790","25","815","2023-01-02"
"29135","2022","COM","2020","3980","106","4086","2023-01-02"
"29136","2022","COM","2020","1167","26","1193","2023-01-02"
"29137","2022","COM","2020","2120","49","2169","2023-01-02"
"29139","2022","COM","2020","877","140","1017","2023-01-02"
"29140","2022","COM","2020","3931","87","4018","2023-01-02"
"29141","2022","COM","2020","343","3","346","2023-01-02"
"29142","2022","COM","2020","463","4","467","2023-01-02"
"29143","2022","COM","2020","971","21","992","2023-01-02"
"29144","2022","COM","2020","757","9","766","2023-01-02"
"29145","2022","COM","2020","873","28","901","2023-01-02"
"29146","2022","COM","2020","3422","50","3472","2023-01-02"
"29147","2022","COM","2020","3303","81","3384","2023-01-02"
"29148","2022","COM","2020","932","29","961","2023-01-02"
"29150","2022","COM","2020","6748","158","6906","2023-01-02"
"29151","2022","COM","2020","14709","463","15172","2023-01-02"
"29152","2022","COM","2020","707","12","719","2023-01-02"
"29153","2022","COM","2020","2694","54","2748","2023-01-02"
"29155","2022","COM","2020","832","16","848","2023-01-02"
"29156","2022","COM","2020","2089","44","2133","2023-01-02"
"29158","2022","COM","2020","5139","102","5241","2023-01-02"
"29159","2022","COM","2020","865","18","883","2023-01-02"
"29160","2022","COM","2020","8545","176","8721","2023-01-02"
"29161","2022","COM","2020","3223","84","3307","2023-01-02"
"29162","2022","COM","2020","3579","267","3846","2023-01-02"
"29163","2022","COM","2020","3190","77","3267","2023-01-02"
"29165","2022","COM","2020","3615","82","3697","2023-01-02"
"29166","2022","COM","2020","502","19","521","2023-01-02"
"29167","2022","COM","2020","1989","43","2032","2023-01-02"
"29168","2022","COM","2020","1230","19","1249","2023-01-02"
"29169","2022","COM","2020","3196","76","3272","2023-01-02"
"29170","2022","COM","2020","4195","162","4357","2023-01-02"
"29171","2022","COM","2020","3855","76","3931","2023-01-02"
"29172","2022","COM","2020","2245","68","2313","2023-01-02"
"29173","2022","COM","2020","2449","60","2509","2023-01-02"
"29174","2022","COM","2020","6300","185","6485","2023-01-02"
"29175","2022","COM","2020","2130","44","2174","2023-01-02"
"29176","2022","COM","2020","1787","44","1831","2023-01-02"
"29177","2022","COM","2020","3924","93","4017","2023-01-02"
"29178","2022","COM","2020","6333","132","6465","2023-01-02"
"29179","2022","COM","2020","3750","118","3868","2023-01-02"
"29180","2022","COM","2020","894","22","916","2023-01-02"
"29181","2022","COM","2020","3009","71","3080","2023-01-02"
"29182","2022","COM","2020","1061","23","1084","2023-01-02"
"29183","2022","COM","2020","716","14","730","2023-01-02"
"29184","2022","COM","2020","2539","54","2593","2023-01-02"
"29185","2022","COM","2020","3522","90","3612","2023-01-02"
"29186","2022","COM","2020","1620","59","1679","2023-01-02"
"29187","2022","COM","2020","794","27","821","2023-01-02"
"29188","2022","COM","2020","2724","120","2844","2023-01-02"
"29189","2022","COM","2020","13277","360","13637","2023-01-02"
"29190","2022","COM","2020","4299","97","4396","2023-01-02"
"29191","2022","COM","2020","3432","93","3525","2023-01-02"
"29192","2022","COM","2020","1774","41","1815","2023-01-02"
"29193","2022","COM","2020","1449","29","1478","2023-01-02"
"29195","2022","COM","2020","6633","127","6760","2023-01-02"
"29196","2022","COM","2020","2173","42","2215","2023-01-02"
"29197","2022","COM","2020","3940","79","4019","2023-01-02"
"29198","2022","COM","2020","1824","45","1869","2023-01-02"
"29199","2022","COM","2020","5082","167","5249","2023-01-02"
"29201","2022","COM","2020","2143","41","2184","2023-01-02"
"29202","2022","COM","2020","1296","35","1331","2023-01-02"
"29204","2022","COM","2020","2134","34","2168","2023-01-02"
"29205","2022","COM","2020","1171","25","1196","2023-01-02"
"29206","2022","COM","2020","2297","94","2391","2023-01-02"
"29207","2022","COM","2020","4510","291","4801","2023-01-02"
"29208","2022","COM","2020","1253","28","1281","2023-01-02"
"29209","2022","COM","2020","3851","107","3958","2023-01-02"
"29210","2022","COM","2020","2879","72","2951","2023-01-02"
"29211","2022","COM","2020","654","17","671","2023-01-02"
"29212","2022","COM","2020","13558","250","13808","2023-01-02"
"29213","2022","COM","2020","1775","36","1811","2023-01-02"
"29214","2022","COM","2020","683","20","703","2023-01-02"
"29215","2022","COM","2020","2945","70","3015","2023-01-02"
"29216","2022","COM","2020","4196","104","4300","2023-01-02"
"29217","2022","COM","2020","2831","57","2888","2023-01-02"
"29218","2022","COM","2020","1566","30","1596","2023-01-02"
"29220","2022","COM","2020","8392","394","8786","2023-01-02"
"29221","2022","COM","2020","1764","51","1815","2023-01-02"
"29222","2022","COM","2020","398","7","405","2023-01-02"
"29224","2022","COM","2020","1214","27","1241","2023-01-02"
"29225","2022","COM","2020","2157","43","2200","2023-01-02"
"29226","2022","COM","2020","1485","80","1565","2023-01-02"
"29227","2022","COM","2020","1473","33","1506","2023-01-02"
"29228","2022","COM","2020","650","16","666","2023-01-02"
"29229","2022","COM","2020","1112","34","1146","2023-01-02"
"29230","2022","COM","2020","1665","34","1699","2023-01-02"
"29232","2022","COM","2020","63473","2402","65875","2023-01-02"
"29233","2022","COM","2020","12077","476","12553","2023-01-02"
"29234","2022","COM","2020","2911","65","2976","2023-01-02"
"29235","2022","COM","2020","11710","220","11930","2023-01-02"
"29236","2022","COM","2020","4240","87","4327","2023-01-02"
"29237","2022","COM","2020","1810","44","1854","2023-01-02"
"29238","2022","COM","2020","830","30","860","2023-01-02"
"29239","2022","COM","2020","3362","84","3446","2023-01-02"
"29240","2022","COM","2020","960","23","983","2023-01-02"
"29241","2022","COM","2020","7594","161","7755","2023-01-02"
"29243","2022","COM","2020","459","13","472","2023-01-02"
"29244","2022","COM","2020","829","13","842","2023-01-02"
"29245","2022","COM","2020","1572","19","1591","2023-01-02"
"29246","2022","COM","2020","216","4","220","2023-01-02"
"29247","2022","COM","2020","3521","114","3635","2023-01-02"
"29248","2022","COM","2020","851","8","859","2023-01-02"
"29249","2022","COM","2020","713","9","722","2023-01-02"
"29250","2022","COM","2020","750","17","767","2023-01-02"
"29251","2022","COM","2020","662","12","674","2023-01-02"
"29252","2022","COM","2020","923","25","948","2023-01-02"
"29254","2022","COM","2020","4707","119","4826","2023-01-02"
"29255","2022","COM","2020","939","20","959","2023-01-02"
"29256","2022","COM","2020","754","20","774","2023-01-02"
"29257","2022","COM","2020","2067","61","2128","2023-01-02"
"29259","2022","COM","2020","6743","242","6985","2023-01-02"
"29260","2022","COM","2020","8276","194","8470","2023-01-02"
"29261","2022","COM","2020","214","3","217","2023-01-02"
"29262","2022","COM","2020","784","10","794","2023-01-02"
"29263","2022","COM","2020","1124","17","1141","2023-01-02"
"29264","2022","COM","2020","786","15","801","2023-01-02"
"29265","2022","COM","2020","1052","31","1083","2023-01-02"
"29266","2022","COM","2020","3059","79","3138","2023-01-02"
"29267","2022","COM","2020","722","17","739","2023-01-02"
"29268","2022","COM","2020","1916","37","1953","2023-01-02"
"29269","2022","COM","2020","1027","14","1041","2023-01-02"
"29270","2022","COM","2020","1667","32","1699","2023-01-02"
"29271","2022","COM","2020","887","25","912","2023-01-02"
"29272","2022","COM","2020","3308","67","3375","2023-01-02"
"29273","2022","COM","2020","2385","76","2461","2023-01-02"
"29274","2022","COM","2020","5245","109","5354","2023-01-02"
"29275","2022","COM","2020","739","20","759","2023-01-02"
"29276","2022","COM","2020","1182","31","1213","2023-01-02"
"29277","2022","COM","2020","2304","77","2381","2023-01-02"
"29278","2022","COM","2020","1757","42","1799","2023-01-02"
"29279","2022","COM","2020","2878","73","2951","2023-01-02"
"29280","2022","COM","2020","2102","61","2163","2023-01-02"
"29281","2022","COM","2020","998","28","1026","2023-01-02"
"29282","2022","COM","2020","363","10","373","2023-01-02"
"29284","2022","COM","2020","2410","107","2517","2023-01-02"
"29285","2022","COM","2020","523","8","531","2023-01-02"
"29286","2022","COM","2020","244","8","252","2023-01-02"
"29287","2022","COM","2020","975","19","994","2023-01-02"
"29288","2022","COM","2020","615","6","621","2023-01-02"
"29289","2022","COM","2020","112","7","119","2023-01-02"
"29290","2022","COM","2020","691","15","706","2023-01-02"
"29291","2022","COM","2020","955","18","973","2023-01-02"
"29292","2022","COM","2020","314","6","320","2023-01-02"
"29293","2022","COM","2020","7058","224","7282","2023-01-02"
"29294","2022","COM","2020","644","11","655","2023-01-02"
"29295","2022","COM","2020","511","21","532","2023-01-02"
"29296","2022","COM","2020","1400","39","1439","2023-01-02"
"29297","2022","COM","2020","2329","48","2377","2023-01-02"
"29298","2022","COM","2020","574","10","584","2023-01-02"
"29299","2022","COM","2020","329","3","332","2023-01-02"
"29300","2022","COM","2020","1608","52","1660","2023-01-02"
"29301","2022","COM","2020","401","9","410","2023-01-02"
"29302","2022","COM","2020","3617","138","3755","2023-01-02"
"2A001","2022","COM","2020","3277","58","3335","2023-01-02"
"2A004","2022","COM","2020","72647","836","73483","2023-01-02"
"2A006","2022","COM","2020","3562","71","3633","2023-01-02"
"2A008","2022","COM","2020","1785","26","1811","2023-01-02"
"2A011","2022","COM","2020","54","2","56","2023-01-02"
"2A014","2022","COM","2020","74","0","74","2023-01-02"
"2A017","2022","COM","2020","1795","38","1833","2023-01-02"
"2A018","2022","COM","2020","159","2","161","2023-01-02"
"2A019","2022","COM","2020","54","0","54","2023-01-02"
"2A021","2022","COM","2020","77","1","78","2023-01-02"
"2A022","2022","COM","2020","80","0","80","2023-01-02"
"2A024","2022","COM","2020","185","1","186","2023-01-02"
"2A026","2022","COM","2020","193","3","196","2023-01-02"
"2A027","2022","COM","2020","53","0","53","2023-01-02"
"2A028","2022","COM","2020","146","6","152","2023-01-02"
"2A031","2022","COM","2020","517","6","523","2023-01-02"
"2A032","2022","COM","2020","4250","114","4364","2023-01-02"
"2A035","2022","COM","2020","159","2","161","2023-01-02"
"2A038","2022","COM","2020","52","1","53","2023-01-02"
"2A040","2022","COM","2020","372","7","379","2023-01-02"
"2A041","2022","COM","2020","3204","55","3259","2023-01-02"
"2A048","2022","COM","2020","503","5","508","2023-01-02"
"2A056","2022","COM","2020","105","5","110","2023-01-02"
"2A060","2022","COM","2020","76","1","77","2023-01-02"
"2A061","2022","COM","2020","114","3","117","2023-01-02"
"2A062","2022","COM","2020","375","9","384","2023-01-02"
"2A064","2022","COM","2020","31","2","33","2023-01-02"
"2A065","2022","COM","2020","1280","21","1301","2023-01-02"
"2A066","2022","COM","2020","60","0","60","2023-01-02"
"2A070","2022","COM","2020","384","6","390","2023-01-02"
"2A071","2022","COM","2020","219","4","223","2023-01-02"
"2A085","2022","COM","2020","1492","38","1530","2023-01-02"
"2A089","2022","COM","2020","133","0","133","2023-01-02"
"2A090","2022","COM","2020","722","14","736","2023-01-02"
"2A091","2022","COM","2020","175","1","176","2023-01-02"
"2A092","2022","COM","2020","1151","20","1171","2023-01-02"
"2A094","2022","COM","2020","73","1","74","2023-01-02"
"2A098","2022","COM","2020","724","9","733","2023-01-02"
"2A099","2022","COM","2020","278","1","279","2023-01-02"
"2A100","2022","COM","2020","67","0","67","2023-01-02"
"2A103","2022","COM","2020","2032","33","2065","2023-01-02"
"2A104","2022","COM","2020","1353","36","1389","2023-01-02"
"2A108","2022","COM","2020","213","5","218","2023-01-02"
"2A114","2022","COM","2020","1559","34","1593","2023-01-02"
"2A115","2022","COM","2020","151","2","153","2023-01-02"
"2A117","2022","COM","2020","83","0","83","2023-01-02"
"2A118","2022","COM","2020","209","2","211","2023-01-02"
"2A119","2022","COM","2020","140","3","143","2023-01-02"
"2A127","2022","COM","2020","91","4","95","2023-01-02"
"2A128","2022","COM","2020","93","2","95","2023-01-02"
"2A129","2022","COM","2020","53","1","54","2023-01-02"
"2A130","2022","COM","2020","3398","57","3455","2023-01-02"
"2A131","2022","COM","2020","158","2","160","2023-01-02"
"2A132","2022","COM","2020","153","1","154","2023-01-02"
"2A133","2022","COM","2020","152","3","155","2023-01-02"
"2A139","2022","COM","2020","1889","31","1920","2023-01-02"
"2A141","2022","COM","2020","128","0","128","2023-01-02"
"2A142","2022","COM","2020","674","13","687","2023-01-02"
"2A144","2022","COM","2020","102","3","105","2023-01-02"
"2A146","2022","COM","2020","52","1","53","2023-01-02"
"2A154","2022","COM","2020","106","6","112","2023-01-02"
"2A158","2022","COM","2020","28","1","29","2023-01-02"
"2A160","2022","COM","2020","259","2","261","2023-01-02"
"2A163","2022","COM","2020","559","15","574","2023-01-02"
"2A174","2022","COM","2020","101","3","104","2023-01-02"
"2A181","2022","COM","2020","628","17","645","2023-01-02"
"2A186","2022","COM","2020","218","1","219","2023-01-02"
"2A189","2022","COM","2020","1217","28","1245","2023-01-02"
"2A191","2022","COM","2020","119","4","123","2023-01-02"
"2A196","2022","COM","2020","50","1","51","2023-01-02"
"2A197","2022","COM","2020","98","0","98","2023-01-02"
"2A198","2022","COM","2020","511","9","520","2023-01-02"
"2A200","2022","COM","2020","134","3","137","2023-01-02"
"2A203","2022","COM","2020","95","0","95","2023-01-02"
"2A204","2022","COM","2020","96","1","97","2023-01-02"
"2A209","2022","COM","2020","2038","33","2071","2023-01-02"
"2A211","2022","COM","2020","564","17","581","2023-01-02"
"2A212","2022","COM","2020","461","9","470","2023-01-02"
"2A215","2022","COM","2020","901","7","908","2023-01-02"
"2A228","2022","COM","2020","1945","19","1964","2023-01-02"
"2A232","2022","COM","2020","278","3","281","2023-01-02"
"2A240","2022","COM","2020","114","0","114","2023-01-02"
"2A247","2022","COM","2020","11040","170","11210","2023-01-02"
"2A249","2022","COM","2020","3705","42","3747","2023-01-02"
"2A253","2022","COM","2020","51","0","51","2023-01-02"
"2A254","2022","COM","2020","195","4","199","2023-01-02"
"2A258","2022","COM","2020","61","2","63","2023-01-02"
"2A259","2022","COM","2020","65","1","66","2023-01-02"
"2A262","2022","COM","2020","50","1","51","2023-01-02"
"2A266","2022","COM","2020","89","4","93","2023-01-02"
"2A268","2022","COM","2020","81","0","81","2023-01-02"
"2A269","2022","COM","2020","1411","20","1431","2023-01-02"
"2A270","2022","COM","2020","352","3","355","2023-01-02"
"2A271","2022","COM","2020","3309","52","3361","2023-01-02"
"2A272","2022","COM","2020","3408","95","3503","2023-01-02"
"2A276","2022","COM","2020","563","10","573","2023-01-02"
"2A278","2022","COM","2020","81","3","84","2023-01-02"
"2A279","2022","COM","2020","120","0","120","2023-01-02"
"2A282","2022","COM","2020","152","2","154","2023-01-02"
"2A284","2022","COM","2020","372","5","377","2023-01-02"
"2A285","2022","COM","2020","72","0","72","2023-01-02"
"2A288","2022","COM","2020","1556","22","1578","2023-01-02"
"2A295","2022","COM","2020","125","4","129","2023-01-02"
"2A300","2022","COM","2020","1077","21","1098","2023-01-02"
"2A308","2022","COM","2020","381","7","388","2023-01-02"
"2A310","2022","COM","2020","102","0","102","2023-01-02"
"2A312","2022","COM","2020","387","9","396","2023-01-02"
"2A322","2022","COM","2020","87","0","87","2023-01-02"
"2A323","2022","COM","2020","405","7","412","2023-01-02"
"2A324","2022","COM","2020","394","4","398","2023-01-02"
"2A326","2022","COM","2020","121","2","123","2023-01-02"
"2A330","2022","COM","2020","501","2","503","2023-01-02"
"2A331","2022","COM","2020","59","0","59","2023-01-02"
"2A336","2022","COM","2020","522","11","533","2023-01-02"
"2A345","2022","COM","2020","606","4","610","2023-01-02"
"2A348","2022","COM","2020","929","11","940","2023-01-02"
"2A349","2022","COM","2020","854","18","872","2023-01-02"
"2A351","2022","COM","2020","403","5","408","2023-01-02"
"2A357","2022","COM","2020","48","3","51","2023-01-02"
"2A358","2022","COM","2020","52","1","53","2023-01-02"
"2A359","2022","COM","2020","219","2","221","2023-01-02"
"2A360","2022","COM","2020","128","5","133","2023-01-02"
"2A362","2022","COM","2020","2755","35","2790","2023-01-02"
"2A363","2022","COM","2020","66","0","66","2023-01-02"
"2B002","2022","COM","2020","235","4","239","2023-01-02"
"2B003","2022","COM","2020","26","0","26","2023-01-02"
"2B005","2022","COM","2020","27","2","29","2023-01-02"
"2B007","2022","COM","2020","204","5","209","2023-01-02"
"2B009","2022","COM","2020","2185","26","2211","2023-01-02"
"2B010","2022","COM","2020","358","7","365","2023-01-02"
"2B012","2022","COM","2020","52","1","53","2023-01-02"
"2B013","2022","COM","2020","25","0","25","2023-01-02"
"2B015","2022","COM","2020","25","0","25","2023-01-02"
"2B016","2022","COM","2020","556","0","556","2023-01-02"
"2B020","2022","COM","2020","597","12","609","2023-01-02"
"2B023","2022","COM","2020","115","1","116","2023-01-02"
"2B025","2022","COM","2020","82","2","84","2023-01-02"
"2B029","2022","COM","2020","297","4","301","2023-01-02"
"2B030","2022","COM","2020","132","4","136","2023-01-02"
"2B033","2022","COM","2020","48296","632","48928","2023-01-02"
"2B034","2022","COM","2020","696","8","704","2023-01-02"
"2B036","2022","COM","2020","87","0","87","2023-01-02"
"2B037","2022","COM","2020","7732","126","7858","2023-01-02"
"2B039","2022","COM","2020","228","2","230","2023-01-02"
"2B042","2022","COM","2020","9254","178","9432","2023-01-02"
"2B043","2022","COM","2020","1602","36","1638","2023-01-02"
"2B045","2022","COM","2020","66","0","66","2023-01-02"
"2B046","2022","COM","2020","154","3","157","2023-01-02"
"2B047","2022","COM","2020","268","3","271","2023-01-02"
"2B049","2022","COM","2020","2520","31","2551","2023-01-02"
"2B050","2022","COM","2020","5766","82","5848","2023-01-02"
"2B051","2022","COM","2020","70","0","70","2023-01-02"
"2B052","2022","COM","2020","20","0","20","2023-01-02"
"2B053","2022","COM","2020","19","0","19","2023-01-02"
"2B054","2022","COM","2020","185","4","189","2023-01-02"
"2B055","2022","COM","2020","116","1","117","2023-01-02"
"2B057","2022","COM","2020","312","2","314","2023-01-02"
"2B058","2022","COM","2020","316","1","317","2023-01-02"
"2B059","2022","COM","2020","112","1","113","2023-01-02"
"2B063","2022","COM","2020","39","0","39","2023-01-02"
"2B067","2022","COM","2020","35","0","35","2023-01-02"
"2B068","2022","COM","2020","25","0","25","2023-01-02"
"2B069","2022","COM","2020","116","1","117","2023-01-02"
"2B072","2022","COM","2020","55","1","56","2023-01-02"
"2B073","2022","COM","2020","109","2","111","2023-01-02"
"2B074","2022","COM","2020","395","3","398","2023-01-02"
"2B075","2022","COM","2020","72","2","74","2023-01-02"
"2B077","2022","COM","2020","697","6","703","2023-01-02"
"2B078","2022","COM","2020","28","1","29","2023-01-02"
"2B079","2022","COM","2020","499","1","500","2023-01-02"
"2B080","2022","COM","2020","139","1","140","2023-01-02"
"2B081","2022","COM","2020","42","0","42","2023-01-02"
"2B082","2022","COM","2020","38","0","38","2023-01-02"
"2B083","2022","COM","2020","154","2","156","2023-01-02"
"2B084","2022","COM","2020","244","1","245","2023-01-02"
"2B086","2022","COM","2020","185","1","186","2023-01-02"
"2B087","2022","COM","2020","2182","26","2208","2023-01-02"
"2B088","2022","COM","2020","214","3","217","2023-01-02"
"2B093","2022","COM","2020","901","32","933","2023-01-02"
"2B095","2022","COM","2020","127","3","130","2023-01-02"
"2B096","2022","COM","2020","7549","116","7665","2023-01-02"
"2B097","2022","COM","2020","51","1","52","2023-01-02"
"2B101","2022","COM","2020","80","3","83","2023-01-02"
"2B102","2022","COM","2020","80","0","80","2023-01-02"
"2B105","2022","COM","2020","108","0","108","2023-01-02"
"2B106","2022","COM","2020","12","0","12","2023-01-02"
"2B107","2022","COM","2020","145","0","145","2023-01-02"
"2B109","2022","COM","2020","236","2","238","2023-01-02"
"2B110","2022","COM","2020","67","1","68","2023-01-02"
"2B111","2022","COM","2020","51","0","51","2023-01-02"
"2B112","2022","COM","2020","236","4","240","2023-01-02"
"2B113","2022","COM","2020","56","1","57","2023-01-02"
"2B116","2022","COM","2020","29","1","30","2023-01-02"
"2B120","2022","COM","2020","5772","129","5901","2023-01-02"
"2B121","2022","COM","2020","373","5","378","2023-01-02"
"2B122","2022","COM","2020","59","0","59","2023-01-02"
"2B123","2022","COM","2020","4215","54","4269","2023-01-02"
"2B124","2022","COM","2020","207","6","213","2023-01-02"
"2B125","2022","COM","2020","53","0","53","2023-01-02"
"2B126","2022","COM","2020","70","0","70","2023-01-02"
"2B134","2022","COM","2020","3224","67","3291","2023-01-02"
"2B135","2022","COM","2020","315","4","319","2023-01-02"
"2B136","2022","COM","2020","149","2","151","2023-01-02"
"2B137","2022","COM","2020","22","0","22","2023-01-02"
"2B138","2022","COM","2020","149","2","151","2023-01-02"
"2B140","2022","COM","2020","107","0","107","2023-01-02"
"2B143","2022","COM","2020","1104","8","1112","2023-01-02"
"2B145","2022","COM","2020","208","6","214","2023-01-02"
"2B147","2022","COM","2020","111","1","112","2023-01-02"
"2B148","2022","COM","2020","6036","51","6087","2023-01-02"
"2B149","2022","COM","2020","84","1","85","2023-01-02"
"2B150","2022","COM","2020","1237","36","1273","2023-01-02"
"2B152","2022","COM","2020","848","9","857","2023-01-02"
"2B153","2022","COM","2020","119","2","121","2023-01-02"
"2B155","2022","COM","2020","49","0","49","2023-01-02"
"2B156","2022","COM","2020","26","0","26","2023-01-02"
"2B157","2022","COM","2020","30","0","30","2023-01-02"
"2B159","2022","COM","2020","80","1","81","2023-01-02"
"2B161","2022","COM","2020","64","0","64","2023-01-02"
"2B162","2022","COM","2020","709","11","720","2023-01-02"
"2B164","2022","COM","2020","22","0","22","2023-01-02"
"2B165","2022","COM","2020","337","6","343","2023-01-02"
"2B166","2022","COM","2020","644","5","649","2023-01-02"
"2B167","2022","COM","2020","425","14","439","2023-01-02"
"2B168","2022","COM","2020","2000","44","2044","2023-01-02"
"2B169","2022","COM","2020","971","10","981","2023-01-02"
"2B170","2022","COM","2020","107","2","109","2023-01-02"
"2B171","2022","COM","2020","34","1","35","2023-01-02"
"2B172","2022","COM","2020","565","6","571","2023-01-02"
"2B173","2022","COM","2020","257","3","260","2023-01-02"
"2B175","2022","COM","2020","114","3","117","2023-01-02"
"2B176","2022","COM","2020","76","2","78","2023-01-02"
"2B177","2022","COM","2020","59","2","61","2023-01-02"
"2B178","2022","COM","2020","71","1","72","2023-01-02"
"2B179","2022","COM","2020","62","1","63","2023-01-02"
"2B180","2022","COM","2020","79","1","80","2023-01-02"
"2B182","2022","COM","2020","264","2","266","2023-01-02"
"2B183","2022","COM","2020","93","2","95","2023-01-02"
"2B184","2022","COM","2020","93","1","94","2023-01-02"
"2B185","2022","COM","2020","1795","15","1810","2023-01-02"
"2B187","2022","COM","2020","131","1","132","2023-01-02"
"2B188","2022","COM","2020","538","8","546","2023-01-02"
"2B190","2022","COM","2020","185","4","189","2023-01-02"
"2B192","2022","COM","2020","147","3","150","2023-01-02"
"2B193","2022","COM","2020","600","6","606","2023-01-02"
"2B194","2022","COM","2020","26","0","26","2023-01-02"
"2B195","2022","COM","2020","123","1","124","2023-01-02"
"2B199","2022","COM","2020","185","5","190","2023-01-02"
"2B201","2022","COM","2020","197","1","198","2023-01-02"
"2B202","2022","COM","2020","24","0","24","2023-01-02"
"2B205","2022","COM","2020","881","12","893","2023-01-02"
"2B206","2022","COM","2020","38","0","38","2023-01-02"
"2B207","2022","COM","2020","3366","38","3404","2023-01-02"
"2B208","2022","COM","2020","108","1","109","2023-01-02"
"2B210","2022","COM","2020","114","0","114","2023-01-02"
"2B213","2022","COM","2020","59","0","59","2023-01-02"
"2B214","2022","COM","2020","19","0","19","2023-01-02"
"2B216","2022","COM","2020","19","0","19","2023-01-02"
"2B217","2022","COM","2020","44","0","44","2023-01-02"
"2B218","2022","COM","2020","99","3","102","2023-01-02"
"2B219","2022","COM","2020","83","1","84","2023-01-02"
"2B220","2022","COM","2020","132","3","135","2023-01-02"
"2B221","2022","COM","2020","16","0","16","2023-01-02"
"2B222","2022","COM","2020","38","0","38","2023-01-02"
"2B223","2022","COM","2020","496","3","499","2023-01-02"
"2B224","2022","COM","2020","658","10","668","2023-01-02"
"2B225","2022","COM","2020","99","2","101","2023-01-02"
"2B226","2022","COM","2020","59","1","60","2023-01-02"
"2B227","2022","COM","2020","33","1","34","2023-01-02"
"2B229","2022","COM","2020","349","0","349","2023-01-02"
"2B230","2022","COM","2020","111","0","111","2023-01-02"
"2B231","2022","COM","2020","109","6","115","2023-01-02"
"2B233","2022","COM","2020","167","2","169","2023-01-02"
"2B234","2022","COM","2020","17","0","17","2023-01-02"
"2B235","2022","COM","2020","85","0","85","2023-01-02"
"2B236","2022","COM","2020","183","3","186","2023-01-02"
"2B238","2022","COM","2020","208","7","215","2023-01-02"
"2B239","2022","COM","2020","214","11","225","2023-01-02"
"2B241","2022","COM","2020","32","1","33","2023-01-02"
"2B242","2022","COM","2020","699","13","712","2023-01-02"
"2B243","2022","COM","2020","42","0","42","2023-01-02"
"2B244","2022","COM","2020","42","0","42","2023-01-02"
"2B245","2022","COM","2020","43","1","44","2023-01-02"
"2B246","2022","COM","2020","191","2","193","2023-01-02"
"2B248","2022","COM","2020","45","2","47","2023-01-02"
"2B250","2022","COM","2020","149","0","149","2023-01-02"
"2B251","2022","COM","2020","3719","43","3762","2023-01-02"
"2B252","2022","COM","2020","181","3","184","2023-01-02"
"2B255","2022","COM","2020","40","0","40","2023-01-02"
"2B256","2022","COM","2020","28","1","29","2023-01-02"
"2B257","2022","COM","2020","160","4","164","2023-01-02"
"2B260","2022","COM","2020","152","3","155","2023-01-02"
"2B261","2022","COM","2020","538","11","549","2023-01-02"
"2B263","2022","COM","2020","69","5","74","2023-01-02"
"2B264","2022","COM","2020","59","1","60","2023-01-02"
"2B265","2022","COM","2020","413","5","418","2023-01-02"
"2B267","2022","COM","2020","45","3","48","2023-01-02"
"2B273","2022","COM","2020","43","5","48","2023-01-02"
"2B274","2022","COM","2020","90","1","91","2023-01-02"
"2B275","2022","COM","2020","73","2","75","2023-01-02"
"2B277","2022","COM","2020","334","3","337","2023-01-02"
"2B280","2022","COM","2020","106","0","106","2023-01-02"
"2B281","2022","COM","2020","1151","9","1160","2023-01-02"
"2B283","2022","COM","2020","730","12","742","2023-01-02"
"2B286","2022","COM","2020","882","19","901","2023-01-02"
"2B287","2022","COM","2020","142","0","142","2023-01-02"
"2B289","2022","COM","2020","116","0","116","2023-01-02"
"2B290","2022","COM","2020","277","8","285","2023-01-02"
"2B291","2022","COM","2020","34","1","35","2023-01-02"
"2B292","2022","COM","2020","66","1","67","2023-01-02"
"2B293","2022","COM","2020","206","2","208","2023-01-02"
"2B296","2022","COM","2020","136","5","141","2023-01-02"
"2B297","2022","COM","2020","55","0","55","2023-01-02"
"2B298","2022","COM","2020","1688","18","1706","2023-01-02"
"2B299","2022","COM","2020","105","1","106","2023-01-02"
"2B301","2022","COM","2020","57","1","58","2023-01-02"
"2B302","2022","COM","2020","88","2","90","2023-01-02"
"2B303","2022","COM","2020","758","6","764","2023-01-02"
"2B304","2022","COM","2020","142","2","144","2023-01-02"
"2B305","2022","COM","2020","2920","42","2962","2023-01-02"
"2B306","2022","COM","2020","118","0","118","2023-01-02"
"2B307","2022","COM","2020","1519","30","1549","2023-01-02"
"2B309","2022","COM","2020","1971","102","2073","2023-01-02"
"2B311","2022","COM","2020","787","11","798","2023-01-02"
"2B313","2022","COM","2020","2037","18","2055","2023-01-02"
"2B314","2022","COM","2020","338","1","339","2023-01-02"
"2B315","2022","COM","2020","284","5","289","2023-01-02"
"2B316","2022","COM","2020","1000","14","1014","2023-01-02"
"2B317","2022","COM","2020","59","0","59","2023-01-02"
"2B318","2022","COM","2020","581","10","591","2023-01-02"
"2B319","2022","COM","2020","811","6","817","2023-01-02"
"2B320","2022","COM","2020","283","2","285","2023-01-02"
"2B321","2022","COM","2020","15","0","15","2023-01-02"
"2B327","2022","COM","2020","184","3","187","2023-01-02"
"2B328","2022","COM","2020","97","0","97","2023-01-02"
"2B329","2022","COM","2020","111","1","112","2023-01-02"
"2B332","2022","COM","2020","238","6","244","2023-01-02"
"2B333","2022","COM","2020","146","4","150","2023-01-02"
"2B334","2022","COM","2020","107","1","108","2023-01-02"
"2B335","2022","COM","2020","352","7","359","2023-01-02"
"2B337","2022","COM","2020","141","2","143","2023-01-02"
"2B338","2022","COM","2020","28","0","28","2023-01-02"
"2B339","2022","COM","2020","28","0","28","2023-01-02"
"2B340","2022","COM","2020","117","2","119","2023-01-02"
"2B341","2022","COM","2020","690","8","698","2023-01-02"
"2B342","2022","COM","2020","2520","48","2568","2023-01-02"
"2B343","2022","COM","2020","1795","14","1809","2023-01-02"
"2B344","2022","COM","2020","42","2","44","2023-01-02"
"2B346","2022","COM","2020","3032","21","3053","2023-01-02"
"2B347","2022","COM","2020","268","0","268","2023-01-02"
"2B350","2022","COM","2020","212","4","216","2023-01-02"
"2B352","2022","COM","2020","207","5","212","2023-01-02"
"2B353","2022","COM","2020","3278","64","3342","2023-01-02"
"2B354","2022","COM","2020","428","5","433","2023-01-02"
"2B355","2022","COM","2020","352","6","358","2023-01-02"
"2B356","2022","COM","2020","146","1","147","2023-01-02"
"2B361","2022","COM","2020","298","4","302","2023-01-02"
"2B364","2022","COM","2020","36","0","36","2023-01-02"
"2B365","2022","COM","2020","102","2","104","2023-01-02"
"2B366","2022","COM","2020","104","2","106","2023-01-02"
"30001","2022","COM","2020","525","14","539","2023-01-02"
"30002","2022","COM","2020","770","16","786","2023-01-02"
"30003","2022","COM","2020","8664","78","8742","2023-01-02"
"30004","2022","COM","2020","3339","60","3399","2023-01-02"
"30005","2022","COM","2020","218","3","221","2023-01-02"
"30006","2022","COM","2020","5729","55","5784","2023-01-02"
"30007","2022","COM","2020","42867","625","43492","2023-01-02"
"30008","2022","COM","2020","984","17","1001","2023-01-02"
"30009","2022","COM","2020","173","2","175","2023-01-02"
"30010","2022","COM","2020","3335","39","3374","2023-01-02"
"30011","2022","COM","2020","8507","207","8714","2023-01-02"
"30012","2022","COM","2020","4172","57","4229","2023-01-02"
"30013","2022","COM","2020","448","21","469","2023-01-02"
"30014","2022","COM","2020","1044","18","1062","2023-01-02"
"30015","2022","COM","2020","143","5","148","2023-01-02"
"30016","2022","COM","2020","278","11","289","2023-01-02"
"30017","2022","COM","2020","212","2","214","2023-01-02"
"30018","2022","COM","2020","530","16","546","2023-01-02"
"30019","2022","COM","2020","2952","60","3012","2023-01-02"
"30020","2022","COM","2020","2347","43","2390","2023-01-02"
"30021","2022","COM","2020","321","4","325","2023-01-02"
"30022","2022","COM","2020","178","6","184","2023-01-02"
"30023","2022","COM","2020","788","14","802","2023-01-02"
"30024","2022","COM","2020","451","7","458","2023-01-02"
"30025","2022","COM","2020","230","3","233","2023-01-02"
"30026","2022","COM","2020","1067","22","1089","2023-01-02"
"30027","2022","COM","2020","2570","61","2631","2023-01-02"
"30028","2022","COM","2020","18072","333","18405","2023-01-02"
"30029","2022","COM","2020","1616","29","1645","2023-01-02"
"30030","2022","COM","2020","358","10","368","2023-01-02"
"30031","2022","COM","2020","202","2","204","2023-01-02"
"30032","2022","COM","2020","15659","141","15800","2023-01-02"
"30033","2022","COM","2020","5323","55","5378","2023-01-02"
"30034","2022","COM","2020","7550","74","7624","2023-01-02"
"30035","2022","COM","2020","240","1","241","2023-01-02"
"30036","2022","COM","2020","3452","26","3478","2023-01-02"
"30037","2022","COM","2020","2766","27","2793","2023-01-02"
"30038","2022","COM","2020","326","11","337","2023-01-02"
"30039","2022","COM","2020","2315","26","2341","2023-01-02"
"30040","2022","COM","2020","127","2","129","2023-01-02"
"30041","2022","COM","2020","1233","21","1254","2023-01-02"
"30042","2022","COM","2020","2568","45","2613","2023-01-02"
"30043","2022","COM","2020","585","16","601","2023-01-02"
"30044","2022","COM","2020","84","3","87","2023-01-02"
"30045","2022","COM","2020","392","3","395","2023-01-02"
"30046","2022","COM","2020","989","14","1003","2023-01-02"
"30047","2022","COM","2020","6238","136","6374","2023-01-02"
"30048","2022","COM","2020","183","3","186","2023-01-02"
"30049","2022","COM","2020","371","17","388","2023-01-02"
"30050","2022","COM","2020","167","1","168","2023-01-02"
"30051","2022","COM","2020","1336","35","1371","2023-01-02"
"30052","2022","COM","2020","658","19","677","2023-01-02"
"30053","2022","COM","2020","762","10","772","2023-01-02"
"30054","2022","COM","2020","303","4","307","2023-01-02"
"30055","2022","COM","2020","678","13","691","2023-01-02"
"30056","2022","COM","2020","329","7","336","2023-01-02"
"30057","2022","COM","2020","1710","30","1740","2023-01-02"
"30058","2022","COM","2020","218","6","224","2023-01-02"
"30059","2022","COM","2020","2467","19","2486","2023-01-02"
"30060","2022","COM","2020","4118","80","4198","2023-01-02"
"30061","2022","COM","2020","2432","28","2460","2023-01-02"
"30062","2022","COM","2020","5914","99","6013","2023-01-02"
"30064","2022","COM","2020","134","2","136","2023-01-02"
"30065","2022","COM","2020","466","3","469","2023-01-02"
"30066","2022","COM","2020","559","13","572","2023-01-02"
"30067","2022","COM","2020","416","6","422","2023-01-02"
"30068","2022","COM","2020","905","23","928","2023-01-02"
"30069","2022","COM","2020","516","12","528","2023-01-02"
"30070","2022","COM","2020","770","25","795","2023-01-02"
"30071","2022","COM","2020","413","8","421","2023-01-02"
"30072","2022","COM","2020","481","10","491","2023-01-02"
"30073","2022","COM","2020","1679","86","1765","2023-01-02"
"30074","2022","COM","2020","26","0","26","2023-01-02"
"30075","2022","COM","2020","4372","115","4487","2023-01-02"
"30076","2022","COM","2020","849","32","881","2023-01-02"
"30077","2022","COM","2020","1652","31","1683","2023-01-02"
"30079","2022","COM","2020","257","3","260","2023-01-02"
"30080","2022","COM","2020","891","5","896","2023-01-02"
"30081","2022","COM","2020","966","29","995","2023-01-02"
"30082","2022","COM","2020","4190","97","4287","2023-01-02"
"30083","2022","COM","2020","2419","37","2456","2023-01-02"
"30084","2022","COM","2020","607","11","618","2023-01-02"
"30085","2022","COM","2020","1066","15","1081","2023-01-02"
"30086","2022","COM","2020","666","11","677","2023-01-02"
"30087","2022","COM","2020","226","6","232","2023-01-02"
"30088","2022","COM","2020","677","13","690","2023-01-02"
"30089","2022","COM","2020","1736","31","1767","2023-01-02"
"30090","2022","COM","2020","263","3","266","2023-01-02"
"30091","2022","COM","2020","1666","34","1700","2023-01-02"
"30092","2022","COM","2020","1701","49","1750","2023-01-02"
"30093","2022","COM","2020","101","0","101","2023-01-02"
"30094","2022","COM","2020","150","1","151","2023-01-02"
"30095","2022","COM","2020","609","12","621","2023-01-02"
"30096","2022","COM","2020","935","17","952","2023-01-02"
"30097","2022","COM","2020","280","4","284","2023-01-02"
"30098","2022","COM","2020","436","4","440","2023-01-02"
"30099","2022","COM","2020","237","8","245","2023-01-02"
"30100","2022","COM","2020","705","10","715","2023-01-02"
"30101","2022","COM","2020","656","17","673","2023-01-02"
"30102","2022","COM","2020","539","9","548","2023-01-02"
"30103","2022","COM","2020","951","11","962","2023-01-02"
"30104","2022","COM","2020","752","19","771","2023-01-02"
"30105","2022","COM","2020","138","5","143","2023-01-02"
"30106","2022","COM","2020","750","17","767","2023-01-02"
"30107","2022","COM","2020","605","12","617","2023-01-02"
"30108","2022","COM","2020","155","5","160","2023-01-02"
"30109","2022","COM","2020","470","7","477","2023-01-02"
"30110","2022","COM","2020","365","9","374","2023-01-02"
"30111","2022","COM","2020","446","9","455","2023-01-02"
"30112","2022","COM","2020","1733","16","1749","2023-01-02"
"30113","2022","COM","2020","233","3","236","2023-01-02"
"30114","2022","COM","2020","682","10","692","2023-01-02"
"30115","2022","COM","2020","247","8","255","2023-01-02"
"30116","2022","COM","2020","1073","13","1086","2023-01-02"
"30117","2022","COM","2020","2748","52","2800","2023-01-02"
"30119","2022","COM","2020","157","5","162","2023-01-02"
"30120","2022","COM","2020","1088","16","1104","2023-01-02"
"30121","2022","COM","2020","264","4","268","2023-01-02"
"30122","2022","COM","2020","723","13","736","2023-01-02"
"30123","2022","COM","2020","3596","113","3709","2023-01-02"
"30124","2022","COM","2020","212","2","214","2023-01-02"
"30125","2022","COM","2020","5035","50","5085","2023-01-02"
"30126","2022","COM","2020","734","19","753","2023-01-02"
"30127","2022","COM","2020","1071","25","1096","2023-01-02"
"30128","2022","COM","2020","4048","69","4117","2023-01-02"
"30129","2022","COM","2020","692","20","712","2023-01-02"
"30130","2022","COM","2020","824","9","833","2023-01-02"
"30131","2022","COM","2020","1108","32","1140","2023-01-02"
"30132","2022","COM","2020","4955","74","5029","2023-01-02"
"30133","2022","COM","2020","8356","70","8426","2023-01-02"
"30134","2022","COM","2020","310","4","314","2023-01-02"
"30135","2022","COM","2020","3811","37","3848","2023-01-02"
"30136","2022","COM","2020","1152","17","1169","2023-01-02"
"30137","2022","COM","2020","138","3","141","2023-01-02"
"30138","2022","COM","2020","2239","56","2295","2023-01-02"
"30139","2022","COM","2020","339","29","368","2023-01-02"
"30140","2022","COM","2020","1093","11","1104","2023-01-02"
"30141","2022","COM","2020","6327","120","6447","2023-01-02"
"30142","2022","COM","2020","1116","21","1137","2023-01-02"
"30143","2022","COM","2020","214","5","219","2023-01-02"
"30144","2022","COM","2020","458","9","467","2023-01-02"
"30145","2022","COM","2020","1651","24","1675","2023-01-02"
"30146","2022","COM","2020","1491","24","1515","2023-01-02"
"30147","2022","COM","2020","1535","26","1561","2023-01-02"
"30148","2022","COM","2020","329","7","336","2023-01-02"
"30149","2022","COM","2020","922","20","942","2023-01-02"
"30150","2022","COM","2020","264","6","270","2023-01-02"
"30151","2022","COM","2020","499","7","506","2023-01-02"
"30152","2022","COM","2020","2061","33","2094","2023-01-02"
"30153","2022","COM","2020","124","0","124","2023-01-02"
"30154","2022","COM","2020","389","10","399","2023-01-02"
"30155","2022","COM","2020","7092","93","7185","2023-01-02"
"30156","2022","COM","2020","8564","149","8713","2023-01-02"
"30158","2022","COM","2020","436","9","445","2023-01-02"
"30159","2022","COM","2020","779","4","783","2023-01-02"
"30160","2022","COM","2020","266","4","270","2023-01-02"
"30161","2022","COM","2020","204","6","210","2023-01-02"
"30162","2022","COM","2020","669","15","684","2023-01-02"
"30163","2022","COM","2020","171","6","177","2023-01-02"
"30164","2022","COM","2020","725","9","734","2023-01-02"
"30165","2022","COM","2020","1195","37","1232","2023-01-02"
"30166","2022","COM","2020","2542","151","2693","2023-01-02"
"30167","2022","COM","2020","791","16","807","2023-01-02"
"30168","2022","COM","2020","623","17","640","2023-01-02"
"30169","2022","COM","2020","5821","136","5957","2023-01-02"
"30170","2022","COM","2020","912","31","943","2023-01-02"
"30171","2022","COM","2020","1209","13","1222","2023-01-02"
"30172","2022","COM","2020","767","8","775","2023-01-02"
"30173","2022","COM","2020","1760","32","1792","2023-01-02"
"30174","2022","COM","2020","1389","37","1426","2023-01-02"
"30175","2022","COM","2020","188","1","189","2023-01-02"
"30176","2022","COM","2020","191","3","194","2023-01-02"
"30177","2022","COM","2020","647","10","657","2023-01-02"
"30178","2022","COM","2020","1521","38","1559","2023-01-02"
"30179","2022","COM","2020","3149","50","3199","2023-01-02"
"30180","2022","COM","2020","566","9","575","2023-01-02"
"30181","2022","COM","2020","471","5","476","2023-01-02"
"30182","2022","COM","2020","1388","24","1412","2023-01-02"
"30183","2022","COM","2020","656","9","665","2023-01-02"
"30184","2022","COM","2020","1534","12","1546","2023-01-02"
"30185","2022","COM","2020","1486","25","1511","2023-01-02"
"30186","2022","COM","2020","2021","51","2072","2023-01-02"
"30187","2022","COM","2020","304","8","312","2023-01-02"
"30188","2022","COM","2020","712","13","725","2023-01-02"
"30189","2022","COM","2020","147496","2265","149761","2023-01-02"
"30191","2022","COM","2020","1183","28","1211","2023-01-02"
"30192","2022","COM","2020","435","12","447","2023-01-02"
"30193","2022","COM","2020","711","6","717","2023-01-02"
"30194","2022","COM","2020","277","3","280","2023-01-02"
"30195","2022","COM","2020","34","3","37","2023-01-02"
"30196","2022","COM","2020","468","11","479","2023-01-02"
"30197","2022","COM","2020","284","8","292","2023-01-02"
"30198","2022","COM","2020","249","6","255","2023-01-02"
"30199","2022","COM","2020","55","1","56","2023-01-02"
"30200","2022","COM","2020","943","15","958","2023-01-02"
"30201","2022","COM","2020","372","5","377","2023-01-02"
"30202","2022","COM","2020","10482","178","10660","2023-01-02"
"30203","2022","COM","2020","330","3","333","2023-01-02"
"30204","2022","COM","2020","358","5","363","2023-01-02"
"30205","2022","COM","2020","248","4","252","2023-01-02"
"30206","2022","COM","2020","4171","122","4293","2023-01-02"
"30207","2022","COM","2020","739","15","754","2023-01-02"
"30208","2022","COM","2020","46","0","46","2023-01-02"
"30209","2022","COM","2020","3883","131","4014","2023-01-02"
"30210","2022","COM","2020","3333","33","3366","2023-01-02"
"30211","2022","COM","2020","4135","61","4196","2023-01-02"
"30212","2022","COM","2020","2255","43","2298","2023-01-02"
"30213","2022","COM","2020","20","0","20","2023-01-02"
"30214","2022","COM","2020","2066","47","2113","2023-01-02"
"30215","2022","COM","2020","406","3","409","2023-01-02"
"30216","2022","COM","2020","834","14","848","2023-01-02"
"30217","2022","COM","2020","7775","208","7983","2023-01-02"
"30218","2022","COM","2020","253","5","258","2023-01-02"
"30219","2022","COM","2020","106","2","108","2023-01-02"
"30220","2022","COM","2020","264","6","270","2023-01-02"
"30221","2022","COM","2020","5531","67","5598","2023-01-02"
"30222","2022","COM","2020","177","7","184","2023-01-02"
"30223","2022","COM","2020","4325","115","4440","2023-01-02"
"30224","2022","COM","2020","607","15","622","2023-01-02"
"30225","2022","COM","2020","1610","52","1662","2023-01-02"
"30226","2022","COM","2020","1245","31","1276","2023-01-02"
"30227","2022","COM","2020","3324","42","3366","2023-01-02"
"30228","2022","COM","2020","1740","33","1773","2023-01-02"
"30229","2022","COM","2020","603","9","612","2023-01-02"
"30230","2022","COM","2020","590","9","599","2023-01-02"
"30231","2022","COM","2020","361","11","372","2023-01-02"
"30232","2022","COM","2020","438","15","453","2023-01-02"
"30233","2022","COM","2020","660","10","670","2023-01-02"
"30234","2022","COM","2020","284","6","290","2023-01-02"
"30235","2022","COM","2020","851","12","863","2023-01-02"
"30236","2022","COM","2020","115","3","118","2023-01-02"
"30237","2022","COM","2020","648","10","658","2023-01-02"
"30238","2022","COM","2020","66","0","66","2023-01-02"
"30239","2022","COM","2020","572","9","581","2023-01-02"
"30240","2022","COM","2020","388","3","391","2023-01-02"
"30241","2022","COM","2020","1979","31","2010","2023-01-02"
"30242","2022","COM","2020","160","2","162","2023-01-02"
"30243","2022","COM","2020","7106","185","7291","2023-01-02"
"30244","2022","COM","2020","354","6","360","2023-01-02"
"30245","2022","COM","2020","800","14","814","2023-01-02"
"30246","2022","COM","2020","107","7","114","2023-01-02"
"30247","2022","COM","2020","292","9","301","2023-01-02"
"30248","2022","COM","2020","462","4","466","2023-01-02"
"30249","2022","COM","2020","1073","13","1086","2023-01-02"
"30250","2022","COM","2020","401","7","408","2023-01-02"
"30251","2022","COM","2020","540","11","551","2023-01-02"
"30252","2022","COM","2020","214","7","221","2023-01-02"
"30253","2022","COM","2020","1169","17","1186","2023-01-02"
"30254","2022","COM","2020","1999","39","2038","2023-01-02"
"30255","2022","COM","2020","3067","33","3100","2023-01-02"
"30256","2022","COM","2020","781","16","797","2023-01-02"
"30257","2022","COM","2020","1997","26","2023","2023-01-02"
"30258","2022","COM","2020","14197","116","14313","2023-01-02"
"30259","2022","COM","2020","4598","81","4679","2023-01-02"
"30260","2022","COM","2020","1096","22","1118","2023-01-02"
"30261","2022","COM","2020","249","5","254","2023-01-02"
"30262","2022","COM","2020","253","12","265","2023-01-02"
"30263","2022","COM","2020","3752","134","3886","2023-01-02"
"30264","2022","COM","2020","175","1","176","2023-01-02"
"30265","2022","COM","2020","241","2","243","2023-01-02"
"30266","2022","COM","2020","852","11","863","2023-01-02"
"30267","2022","COM","2020","523","11","534","2023-01-02"
"30268","2022","COM","2020","605","15","620","2023-01-02"
"30269","2022","COM","2020","2436","169","2605","2023-01-02"
"30270","2022","COM","2020","1539","40","1579","2023-01-02"
"30271","2022","COM","2020","727","15","742","2023-01-02"
"30272","2022","COM","2020","144","2","146","2023-01-02"
"30273","2022","COM","2020","1440","27","1467","2023-01-02"
"30274","2022","COM","2020","3417","65","3482","2023-01-02"
"30275","2022","COM","2020","322","5","327","2023-01-02"
"30276","2022","COM","2020","3576","44","3620","2023-01-02"
"30277","2022","COM","2020","500","9","509","2023-01-02"
"30278","2022","COM","2020","2968","66","3034","2023-01-02"
"30279","2022","COM","2020","672","16","688","2023-01-02"
"30280","2022","COM","2020","369","11","380","2023-01-02"
"30281","2022","COM","2020","1641","32","1673","2023-01-02"
"30282","2022","COM","2020","867","19","886","2023-01-02"
"30283","2022","COM","2020","183","2","185","2023-01-02"
"30284","2022","COM","2020","4592","62","4654","2023-01-02"
"30285","2022","COM","2020","756","19","775","2023-01-02"
"30286","2022","COM","2020","778","18","796","2023-01-02"
"30287","2022","COM","2020","664","11","675","2023-01-02"
"30288","2022","COM","2020","1269","20","1289","2023-01-02"
"30289","2022","COM","2020","87","0","87","2023-01-02"
"30290","2022","COM","2020","1840","61","1901","2023-01-02"
"30291","2022","COM","2020","303","7","310","2023-01-02"
"30292","2022","COM","2020","467","13","480","2023-01-02"
"30293","2022","COM","2020","349","5","354","2023-01-02"
"30294","2022","COM","2020","5373","127","5500","2023-01-02"
"30295","2022","COM","2020","3049","62","3111","2023-01-02"
"30296","2022","COM","2020","156","6","162","2023-01-02"
"30297","2022","COM","2020","221","11","232","2023-01-02"
"30298","2022","COM","2020","505","19","524","2023-01-02"
"30299","2022","COM","2020","1112","49","1161","2023-01-02"
"30300","2022","COM","2020","541","11","552","2023-01-02"
"30301","2022","COM","2020","313","4","317","2023-01-02"
"30302","2022","COM","2020","2166","47","2213","2023-01-02"
"30303","2022","COM","2020","844","21","865","2023-01-02"
"30304","2022","COM","2020","188","3","191","2023-01-02"
"30305","2022","COM","2020","3651","44","3695","2023-01-02"
"30306","2022","COM","2020","553","9","562","2023-01-02"
"30307","2022","COM","2020","2507","25","2532","2023-01-02"
"30308","2022","COM","2020","793","49","842","2023-01-02"
"30309","2022","COM","2020","348","1","349","2023-01-02"
"30310","2022","COM","2020","282","6","288","2023-01-02"
"30311","2022","COM","2020","1893","22","1915","2023-01-02"
"30312","2022","COM","2020","2045","46","2091","2023-01-02"
"30313","2022","COM","2020","776","7","783","2023-01-02"
"30314","2022","COM","2020","239","4","243","2023-01-02"
"30315","2022","COM","2020","2112","39","2151","2023-01-02"
"30316","2022","COM","2020","242","6","248","2023-01-02"
"30317","2022","COM","2020","1782","16","1798","2023-01-02"
"30318","2022","COM","2020","207","4","211","2023-01-02"
"30319","2022","COM","2020","627","24","651","2023-01-02"
"30320","2022","COM","2020","157","2","159","2023-01-02"
"30321","2022","COM","2020","5053","56","5109","2023-01-02"
"30322","2022","COM","2020","262","6","268","2023-01-02"
"30323","2022","COM","2020","121","2","123","2023-01-02"
"30324","2022","COM","2020","883","15","898","2023-01-02"
"30325","2022","COM","2020","1308","33","1341","2023-01-02"
"30326","2022","COM","2020","2029","47","2076","2023-01-02"
"30327","2022","COM","2020","55","2","57","2023-01-02"
"30328","2022","COM","2020","1035","19","1054","2023-01-02"
"30329","2022","COM","2020","438","8","446","2023-01-02"
"30330","2022","COM","2020","947","26","973","2023-01-02"
"30331","2022","COM","2020","1803","40","1843","2023-01-02"
"30332","2022","COM","2020","111","1","112","2023-01-02"
"30333","2022","COM","2020","4542","44","4586","2023-01-02"
"30334","2022","COM","2020","8390","331","8721","2023-01-02"
"30335","2022","COM","2020","137","4","141","2023-01-02"
"30336","2022","COM","2020","1375","20","1395","2023-01-02"
"30337","2022","COM","2020","417","6","423","2023-01-02"
"30338","2022","COM","2020","139","2","141","2023-01-02"
"30339","2022","COM","2020","1419","28","1447","2023-01-02"
"30340","2022","COM","2020","611","10","621","2023-01-02"
"30341","2022","COM","2020","11465","108","11573","2023-01-02"
"30342","2022","COM","2020","1261","40","1301","2023-01-02"
"30343","2022","COM","2020","600","8","608","2023-01-02"
"30344","2022","COM","2020","5465","71","5536","2023-01-02"
"30345","2022","COM","2020","347","1","348","2023-01-02"
"30346","2022","COM","2020","1785","33","1818","2023-01-02"
"30347","2022","COM","2020","1360","21","1381","2023-01-02"
"30348","2022","COM","2020","1824","103","1927","2023-01-02"
"30349","2022","COM","2020","561","3","564","2023-01-02"
"30350","2022","COM","2020","3708","116","3824","2023-01-02"
"30351","2022","COM","2020","12848","401","13249","2023-01-02"
"30352","2022","COM","2020","1832","37","1869","2023-01-02"
"30353","2022","COM","2020","67","1","68","2023-01-02"
"30354","2022","COM","2020","196","4","200","2023-01-02"
"30355","2022","COM","2020","1029","21","1050","2023-01-02"
"30356","2022","COM","2020","2836","164","3000","2023-01-02"
"31001","2022","COM","2020","120","2","122","2023-01-02"
"31002","2022","COM","2020","242","5","247","2023-01-02"
"31003","2022","COM","2020","1271","29","1300","2023-01-02"
"31004","2022","COM","2020","2721","67","2788","2023-01-02"
"31005","2022","COM","2020","291","8","299","2023-01-02"
"31006","2022","COM","2020","226","6","232","2023-01-02"
"31007","2022","COM","2020","62","0","62","2023-01-02"
"31008","2022","COM","2020","258","3","261","2023-01-02"
"31009","2022","COM","2020","187","2","189","2023-01-02"
"31010","2022","COM","2020","90","1","91","2023-01-02"
"31011","2022","COM","2020","273","9","282","2023-01-02"
"31012","2022","COM","2020","97","2","99","2023-01-02"
"31013","2022","COM","2020","354","11","365","2023-01-02"
"31014","2022","COM","2020","86","4","90","2023-01-02"
"31015","2022","COM","2020","22","1","23","2023-01-02"
"31017","2022","COM","2020","102","2","104","2023-01-02"
"31018","2022","COM","2020","228","5","233","2023-01-02"
"31019","2022","COM","2020","31","1","32","2023-01-02"
"31020","2022","COM","2020","888","62","950","2023-01-02"
"31021","2022","COM","2020","124","3","127","2023-01-02"
"31022","2022","COM","2020","9245","95","9340","2023-01-02"
"31023","2022","COM","2020","311","7","318","2023-01-02"
"31024","2022","COM","2020","418","5","423","2023-01-02"
"31025","2022","COM","2020","969","16","985","2023-01-02"
"31026","2022","COM","2020","1062","21","1083","2023-01-02"
"31027","2022","COM","2020","198","5","203","2023-01-02"
"31028","2022","COM","2020","1242","70","1312","2023-01-02"
"31029","2022","COM","2020","344","6","350","2023-01-02"
"31030","2022","COM","2020","80","1","81","2023-01-02"
"31031","2022","COM","2020","592","18","610","2023-01-02"
"31032","2022","COM","2020","7265","83","7348","2023-01-02"
"31033","2022","COM","2020","9966","96","10062","2023-01-02"
"31034","2022","COM","2020","227","9","236","2023-01-02"
"31035","2022","COM","2020","4075","247","4322","2023-01-02"
"31036","2022","COM","2020","1587","48","1635","2023-01-02"
"31037","2022","COM","2020","1615","12","1627","2023-01-02"
"31038","2022","COM","2020","664","11","675","2023-01-02"
"31039","2022","COM","2020","86","2","88","2023-01-02"
"31040","2022","COM","2020","35","1","36","2023-01-02"
"31041","2022","COM","2020","112","2","114","2023-01-02"
"31042","2022","COM","2020","2222","146","2368","2023-01-02"
"31043","2022","COM","2020","137","6","143","2023-01-02"
"31044","2022","COM","2020","17006","294","17300","2023-01-02"
"31045","2022","COM","2020","498","10","508","2023-01-02"
"31046","2022","COM","2020","12","0","12","2023-01-02"
"31047","2022","COM","2020","93","1","94","2023-01-02"
"31048","2022","COM","2020","3456","46","3502","2023-01-02"
"31049","2022","COM","2020","592","14","606","2023-01-02"
"31050","2022","COM","2020","645","7","652","2023-01-02"
"31051","2022","COM","2020","472","10","482","2023-01-02"
"31052","2022","COM","2020","1590","32","1622","2023-01-02"
"31053","2022","COM","2020","1302","30","1332","2023-01-02"
"31054","2022","COM","2020","186","1","187","2023-01-02"
"31055","2022","COM","2020","173","3","176","2023-01-02"
"31056","2022","COM","2020","7127","89","7216","2023-01-02"
"31057","2022","COM","2020","1520","53","1573","2023-01-02"
"31058","2022","COM","2020","129","1","130","2023-01-02"
"31059","2022","COM","2020","114","6","120","2023-01-02"
"31060","2022","COM","2020","109","5","114","2023-01-02"
"31061","2022","COM","2020","195","9","204","2023-01-02"
"31062","2022","COM","2020","105","4","109","2023-01-02"
"31063","2022","COM","2020","168","2","170","2023-01-02"
"31064","2022","COM","2020","28","0","28","2023-01-02"
"31065","2022","COM","2020","3063","60","3123","2023-01-02"
"31066","2022","COM","2020","4194","64","4258","2023-01-02"
"31067","2022","COM","2020","41","0","41","2023-01-02"
"31068","2022","COM","2020","29","0","29","2023-01-02"
"31069","2022","COM","2020","26101","499","26600","2023-01-02"
"31070","2022","COM","2020","446","8","454","2023-01-02"
"31071","2022","COM","2020","447","9","456","2023-01-02"
"31072","2022","COM","2020","68","2","70","2023-01-02"
"31073","2022","COM","2020","720","21","741","2023-01-02"
"31074","2022","COM","2020","289","8","297","2023-01-02"
"31075","2022","COM","2020","1249","23","1272","2023-01-02"
"31076","2022","COM","2020","470","13","483","2023-01-02"
"31077","2022","COM","2020","619","16","635","2023-01-02"
"31078","2022","COM","2020","147","2","149","2023-01-02"
"31079","2022","COM","2020","4754","91","4845","2023-01-02"
"31080","2022","COM","2020","1654","34","1688","2023-01-02"
"31081","2022","COM","2020","7","0","7","2023-01-02"
"31082","2022","COM","2020","1110","14","1124","2023-01-02"
"31083","2022","COM","2020","234","2","236","2023-01-02"
"31084","2022","COM","2020","1054","23","1077","2023-01-02"
"31085","2022","COM","2020","253","3","256","2023-01-02"
"31086","2022","COM","2020","86","4","90","2023-01-02"
"31087","2022","COM","2020","317","2","319","2023-01-02"
"31088","2022","COM","2020","2887","96","2983","2023-01-02"
"31089","2022","COM","2020","675","18","693","2023-01-02"
"31090","2022","COM","2020","369","5","374","2023-01-02"
"31091","2022","COM","2020","6005","106","6111","2023-01-02"
"31092","2022","COM","2020","119","0","119","2023-01-02"
"31093","2022","COM","2020","943","11","954","2023-01-02"
"31094","2022","COM","2020","2859","51","2910","2023-01-02"
"31095","2022","COM","2020","129","2","131","2023-01-02"
"31096","2022","COM","2020","179","2","181","2023-01-02"
"31097","2022","COM","2020","463","13","476","2023-01-02"
"31098","2022","COM","2020","1102","19","1121","2023-01-02"
"31099","2022","COM","2020","409","4","413","2023-01-02"
"31100","2022","COM","2020","2371","32","2403","2023-01-02"
"31101","2022","COM","2020","477","4","481","2023-01-02"
"31102","2022","COM","2020","227","3","230","2023-01-02"
"31103","2022","COM","2020","58","0","58","2023-01-02"
"31104","2022","COM","2020","677","13","690","2023-01-02"
"31105","2022","COM","2020","231","5","236","2023-01-02"
"31106","2022","COM","2020","2524","62","2586","2023-01-02"
"31107","2022","COM","2020","5841","113","5954","2023-01-02"
"31108","2022","COM","2020","265","7","272","2023-01-02"
"31109","2022","COM","2020","467","4","471","2023-01-02"
"31110","2022","COM","2020","645","14","659","2023-01-02"
"31111","2022","COM","2020","293","4","297","2023-01-02"
"31112","2022","COM","2020","189","5","194","2023-01-02"
"31113","2022","COM","2020","14377","259","14636","2023-01-02"
"31114","2022","COM","2020","241","3","244","2023-01-02"
"31115","2022","COM","2020","58","1","59","2023-01-02"
"31116","2022","COM","2020","10784","117","10901","2023-01-02"
"31117","2022","COM","2020","4406","102","4508","2023-01-02"
"31118","2022","COM","2020","6689","107","6796","2023-01-02"
"31119","2022","COM","2020","209","5","214","2023-01-02"
"31120","2022","COM","2020","745","18","763","2023-01-02"
"31121","2022","COM","2020","61","1","62","2023-01-02"
"31122","2022","COM","2020","107","2","109","2023-01-02"
"31123","2022","COM","2020","76","1","77","2023-01-02"
"31124","2022","COM","2020","392","9","401","2023-01-02"
"31125","2022","COM","2020","36","0","36","2023-01-02"
"31126","2022","COM","2020","411","10","421","2023-01-02"
"31127","2022","COM","2020","4","1","5","2023-01-02"
"31128","2022","COM","2020","856","22","878","2023-01-02"
"31129","2022","COM","2020","16","4","20","2023-01-02"
"31130","2022","COM","2020","85","3","88","2023-01-02"
"31131","2022","COM","2020","69","1","70","2023-01-02"
"31132","2022","COM","2020","66","1","67","2023-01-02"
"31133","2022","COM","2020","102","4","106","2023-01-02"
"31134","2022","COM","2020","85","0","85","2023-01-02"
"31135","2022","COM","2020","4753","71","4824","2023-01-02"
"31136","2022","COM","2020","2224","28","2252","2023-01-02"
"31137","2022","COM","2020","158","0","158","2023-01-02"
"31138","2022","COM","2020","250","5","255","2023-01-02"
"31139","2022","COM","2020","195","6","201","2023-01-02"
"31140","2022","COM","2020","187","4","191","2023-01-02"
"31141","2022","COM","2020","220","2","222","2023-01-02"
"31142","2022","COM","2020","234","6","240","2023-01-02"
"31143","2022","COM","2020","274","5","279","2023-01-02"
"31144","2022","COM","2020","719","14","733","2023-01-02"
"31145","2022","COM","2020","2959","65","3024","2023-01-02"
"31146","2022","COM","2020","14","0","14","2023-01-02"
"31147","2022","COM","2020","668","12","680","2023-01-02"
"31148","2022","COM","2020","518","17","535","2023-01-02"
"31149","2022","COM","2020","39866","476","40342","2023-01-02"
"31150","2022","COM","2020","7715","112","7827","2023-01-02"
"31151","2022","COM","2020","871","28","899","2023-01-02"
"31152","2022","COM","2020","95","5","100","2023-01-02"
"31153","2022","COM","2020","412","12","424","2023-01-02"
"31155","2022","COM","2020","229","3","232","2023-01-02"
"31156","2022","COM","2020","366","12","378","2023-01-02"
"31157","2022","COM","2020","20100","258","20358","2023-01-02"
"31158","2022","COM","2020","174","7","181","2023-01-02"
"31159","2022","COM","2020","476","4","480","2023-01-02"
"31160","2022","COM","2020","2440","28","2468","2023-01-02"
"31161","2022","COM","2020","1300","24","1324","2023-01-02"
"31162","2022","COM","2020","1117","86","1203","2023-01-02"
"31163","2022","COM","2020","2649","65","2714","2023-01-02"
"31164","2022","COM","2020","201","6","207","2023-01-02"
"31165","2022","COM","2020","6448","99","6547","2023-01-02"
"31166","2022","COM","2020","291","4","295","2023-01-02"
"31167","2022","COM","2020","699","14","713","2023-01-02"
"31168","2022","COM","2020","130","0","130","2023-01-02"
"31169","2022","COM","2020","6982","129","7111","2023-01-02"
"31170","2022","COM","2020","232","2","234","2023-01-02"
"31171","2022","COM","2020","290","9","299","2023-01-02"
"31172","2022","COM","2020","42","1","43","2023-01-02"
"31173","2022","COM","2020","266","4","270","2023-01-02"
"31174","2022","COM","2020","534","4","538","2023-01-02"
"31175","2022","COM","2020","610","10","620","2023-01-02"
"31176","2022","COM","2020","192","5","197","2023-01-02"
"31177","2022","COM","2020","135","2","137","2023-01-02"
"31178","2022","COM","2020","200","4","204","2023-01-02"
"31179","2022","COM","2020","312","19","331","2023-01-02"
"31180","2022","COM","2020","143","6","149","2023-01-02"
"31181","2022","COM","2020","2178","28","2206","2023-01-02"
"31182","2022","COM","2020","5462","47","5509","2023-01-02"
"31183","2022","COM","2020","315","8","323","2023-01-02"
"31184","2022","COM","2020","2048","38","2086","2023-01-02"
"31185","2022","COM","2020","115","1","116","2023-01-02"
"31186","2022","COM","2020","2993","29","3022","2023-01-02"
"31187","2022","COM","2020","12119","335","12454","2023-01-02"
"31188","2022","COM","2020","5872","160","6032","2023-01-02"
"31189","2022","COM","2020","223","4","227","2023-01-02"
"31190","2022","COM","2020","232","0","232","2023-01-02"
"31191","2022","COM","2020","100","1","101","2023-01-02"
"31192","2022","COM","2020","774","22","796","2023-01-02"
"31193","2022","COM","2020","1895","33","1928","2023-01-02"
"31194","2022","COM","2020","174","2","176","2023-01-02"
"31195","2022","COM","2020","30","0","30","2023-01-02"
"31196","2022","COM","2020","242","3","245","2023-01-02"
"31197","2022","COM","2020","331","8","339","2023-01-02"
"31198","2022","COM","2020","103","3","106","2023-01-02"
"31199","2022","COM","2020","195","8","203","2023-01-02"
"31200","2022","COM","2020","78","4","82","2023-01-02"
"31201","2022","COM","2020","71","2","73","2023-01-02"
"31202","2022","COM","2020","6413","122","6535","2023-01-02"
"31203","2022","COM","2020","9382","164","9546","2023-01-02"
"31204","2022","COM","2020","79","2","81","2023-01-02"
"31205","2022","COM","2020","3161","31","3192","2023-01-02"
"31206","2022","COM","2020","1320","15","1335","2023-01-02"
"31207","2022","COM","2020","81","6","87","2023-01-02"
"31208","2022","COM","2020","320","5","325","2023-01-02"
"31209","2022","COM","2020","153","6","159","2023-01-02"
"31210","2022","COM","2020","1312","32","1344","2023-01-02"
"31211","2022","COM","2020","703","8","711","2023-01-02"
"31212","2022","COM","2020","1918","26","1944","2023-01-02"
"31213","2022","COM","2020","158","5","163","2023-01-02"
"31215","2022","COM","2020","465","15","480","2023-01-02"
"31216","2022","COM","2020","279","10","289","2023-01-02"
"31217","2022","COM","2020","71","1","72","2023-01-02"
"31218","2022","COM","2020","113","4","117","2023-01-02"
"31219","2022","COM","2020","448","4","452","2023-01-02"
"31220","2022","COM","2020","383","5","388","2023-01-02"
"31221","2022","COM","2020","56","1","57","2023-01-02"
"31222","2022","COM","2020","45","1","46","2023-01-02"
"31223","2022","COM","2020","41","1","42","2023-01-02"
"31224","2022","COM","2020","1182","183","1365","2023-01-02"
"31225","2022","COM","2020","185","3","188","2023-01-02"
"31226","2022","COM","2020","81","5","86","2023-01-02"
"31227","2022","COM","2020","843","37","880","2023-01-02"
"31228","2022","COM","2020","2141","48","2189","2023-01-02"
"31229","2022","COM","2020","706","18","724","2023-01-02"
"31230","2022","COM","2020","4501","82","4583","2023-01-02"
"31231","2022","COM","2020","743","9","752","2023-01-02"
"31232","2022","COM","2020","8846","170","9016","2023-01-02"
"31233","2022","COM","2020","1003","33","1036","2023-01-02"
"31234","2022","COM","2020","443","8","451","2023-01-02"
"31235","2022","COM","2020","49","0","49","2023-01-02"
"31236","2022","COM","2020","71","1","72","2023-01-02"
"31237","2022","COM","2020","236","29","265","2023-01-02"
"31238","2022","COM","2020","482","10","492","2023-01-02"
"31239","2022","COM","2020","1636","26","1662","2023-01-02"
"31240","2022","COM","2020","620","8","628","2023-01-02"
"31241","2022","COM","2020","295","5","300","2023-01-02"
"31242","2022","COM","2020","17","2","19","2023-01-02"
"31243","2022","COM","2020","67","4","71","2023-01-02"
"31244","2022","COM","2020","378","17","395","2023-01-02"
"31245","2022","COM","2020","188","5","193","2023-01-02"
"31246","2022","COM","2020","867","15","882","2023-01-02"
"31247","2022","COM","2020","1299","28","1327","2023-01-02"
"31248","2022","COM","2020","6364","115","6479","2023-01-02"
"31249","2022","COM","2020","1248","26","1274","2023-01-02"
"31250","2022","COM","2020","680","17","697","2023-01-02"
"31251","2022","COM","2020","147","1","148","2023-01-02"
"31252","2022","COM","2020","1954","46","2000","2023-01-02"
"31253","2022","COM","2020","2940","41","2981","2023-01-02"
"31254","2022","COM","2020","4122","146","4268","2023-01-02"
"31255","2022","COM","2020","322","10","332","2023-01-02"
"31256","2022","COM","2020","293","6","299","2023-01-02"
"31258","2022","COM","2020","242","6","248","2023-01-02"
"31259","2022","COM","2020","2089","49","2138","2023-01-02"
"31260","2022","COM","2020","98","1","99","2023-01-02"
"31261","2022","COM","2020","1201","44","1245","2023-01-02"
"31262","2022","COM","2020","429","11","440","2023-01-02"
"31263","2022","COM","2020","3231","57","3288","2023-01-02"
"31264","2022","COM","2020","563","7","570","2023-01-02"
"31265","2022","COM","2020","256","6","262","2023-01-02"
"31266","2022","COM","2020","196","1","197","2023-01-02"
"31267","2022","COM","2020","62","2","64","2023-01-02"
"31268","2022","COM","2020","135","3","138","2023-01-02"
"31269","2022","COM","2020","1558","23","1581","2023-01-02"
"31270","2022","COM","2020","1018","29","1047","2023-01-02"
"31271","2022","COM","2020","2197","42","2239","2023-01-02"
"31272","2022","COM","2020","63","3","66","2023-01-02"
"31273","2022","COM","2020","2919","70","2989","2023-01-02"
"31274","2022","COM","2020","185","5","190","2023-01-02"
"31275","2022","COM","2020","161","5","166","2023-01-02"
"31276","2022","COM","2020","289","5","294","2023-01-02"
"31277","2022","COM","2020","1622","44","1666","2023-01-02"
"31278","2022","COM","2020","313","4","317","2023-01-02"
"31279","2022","COM","2020","76","1","77","2023-01-02"
"31280","2022","COM","2020","395","8","403","2023-01-02"
"31281","2022","COM","2020","1323","32","1355","2023-01-02"
"31282","2022","COM","2020","9309","116","9425","2023-01-02"
"31283","2022","COM","2020","260","3","263","2023-01-02"
"31284","2022","COM","2020","1653","56","1709","2023-01-02"
"31285","2022","COM","2020","773","13","786","2023-01-02"
"31286","2022","COM","2020","628","7","635","2023-01-02"
"31287","2022","COM","2020","3394","88","3482","2023-01-02"
"31288","2022","COM","2020","317","9","326","2023-01-02"
"31289","2022","COM","2020","284","3","287","2023-01-02"
"31290","2022","COM","2020","33","3","36","2023-01-02"
"31291","2022","COM","2020","9361","254","9615","2023-01-02"
"31292","2022","COM","2020","73","1","74","2023-01-02"
"31293","2022","COM","2020","2862","22","2884","2023-01-02"
"31294","2022","COM","2020","85","1","86","2023-01-02"
"31295","2022","COM","2020","86","0","86","2023-01-02"
"31296","2022","COM","2020","435","11","446","2023-01-02"
"31297","2022","COM","2020","2206","43","2249","2023-01-02"
"31299","2022","COM","2020","3804","83","3887","2023-01-02"
"31300","2022","COM","2020","127","3","130","2023-01-02"
"31301","2022","COM","2020","129","1","130","2023-01-02"
"31302","2022","COM","2020","295","7","302","2023-01-02"
"31303","2022","COM","2020","3213","37","3250","2023-01-02"
"31304","2022","COM","2020","452","11","463","2023-01-02"
"31305","2022","COM","2020","199","6","205","2023-01-02"
"31306","2022","COM","2020","93","0","93","2023-01-02"
"31308","2022","COM","2020","47","0","47","2023-01-02"
"31309","2022","COM","2020","232","2","234","2023-01-02"
"31310","2022","COM","2020","340","5","345","2023-01-02"
"31311","2022","COM","2020","1200","22","1222","2023-01-02"
"31312","2022","COM","2020","35","1","36","2023-01-02"
"31313","2022","COM","2020","108","2","110","2023-01-02"
"31314","2022","COM","2020","378","7","385","2023-01-02"
"31315","2022","COM","2020","958","48","1006","2023-01-02"
"31316","2022","COM","2020","497","6","503","2023-01-02"
"31317","2022","COM","2020","465","9","474","2023-01-02"
"31318","2022","COM","2020","200","5","205","2023-01-02"
"31319","2022","COM","2020","135","1","136","2023-01-02"
"31320","2022","COM","2020","951","41","992","2023-01-02"
"31321","2022","COM","2020","130","7","137","2023-01-02"
"31322","2022","COM","2020","66","2","68","2023-01-02"
"31323","2022","COM","2020","373","10","383","2023-01-02"
"31324","2022","COM","2020","2407","43","2450","2023-01-02"
"31325","2022","COM","2020","185","5","190","2023-01-02"
"31326","2022","COM","2020","98","0","98","2023-01-02"
"31327","2022","COM","2020","205","1","206","2023-01-02"
"31328","2022","COM","2020","322","10","332","2023-01-02"
"31329","2022","COM","2020","208","3","211","2023-01-02"
"31330","2022","COM","2020","500","11","511","2023-01-02"
"31331","2022","COM","2020","305","12","317","2023-01-02"
"31332","2022","COM","2020","214","4","218","2023-01-02"
"31333","2022","COM","2020","87","3","90","2023-01-02"
"31334","2022","COM","2020","1327","24","1351","2023-01-02"
"31335","2022","COM","2020","27","0","27","2023-01-02"
"31336","2022","COM","2020","637","12","649","2023-01-02"
"31337","2022","COM","2020","90","1","91","2023-01-02"
"31338","2022","COM","2020","788","23","811","2023-01-02"
"31339","2022","COM","2020","491","6","497","2023-01-02"
"31340","2022","COM","2020","290","9","299","2023-01-02"
"31341","2022","COM","2020","6241","88","6329","2023-01-02"
"31342","2022","COM","2020","179","3","182","2023-01-02"
"31343","2022","COM","2020","61","0","61","2023-01-02"
"31344","2022","COM","2020","759","13","772","2023-01-02"
"31345","2022","COM","2020","2687","37","2724","2023-01-02"
"31346","2022","COM","2020","1114","19","1133","2023-01-02"
"31347","2022","COM","2020","166","3","169","2023-01-02"
"31348","2022","COM","2020","36","0","36","2023-01-02"
"31349","2022","COM","2020","911","17","928","2023-01-02"
"31350","2022","COM","2020","81","1","82","2023-01-02"
"31351","2022","COM","2020","5483","99","5582","2023-01-02"
"31352","2022","COM","2020","219","11","230","2023-01-02"
"31353","2022","COM","2020","84","0","84","2023-01-02"
"31354","2022","COM","2020","51","0","51","2023-01-02"
"31355","2022","COM","2020","1789","44","1833","2023-01-02"
"31356","2022","COM","2020","1897","48","1945","2023-01-02"
"31357","2022","COM","2020","310","4","314","2023-01-02"
"31358","2022","COM","2020","3616","104","3720","2023-01-02"
"31359","2022","COM","2020","66","2","68","2023-01-02"
"31360","2022","COM","2020","521","8","529","2023-01-02"
"31361","2022","COM","2020","512","5","517","2023-01-02"
"31362","2022","COM","2020","199","6","205","2023-01-02"
"31363","2022","COM","2020","215","5","220","2023-01-02"
"31364","2022","COM","2020","3099","57","3156","2023-01-02"
"31365","2022","COM","2020","506","9","515","2023-01-02"
"31366","2022","COM","2020","679","22","701","2023-01-02"
"31367","2022","COM","2020","74","5","79","2023-01-02"
"31368","2022","COM","2020","240","13","253","2023-01-02"
"31369","2022","COM","2020","36","4","40","2023-01-02"
"31370","2022","COM","2020","138","0","138","2023-01-02"
"31371","2022","COM","2020","418","15","433","2023-01-02"
"31372","2022","COM","2020","460","9","469","2023-01-02"
"31373","2022","COM","2020","177","5","182","2023-01-02"
"31374","2022","COM","2020","1025","13","1038","2023-01-02"
"31375","2022","COM","2020","3109","51","3160","2023-01-02"
"31376","2022","COM","2020","105","3","108","2023-01-02"
"31377","2022","COM","2020","695","9","704","2023-01-02"
"31378","2022","COM","2020","77","4","81","2023-01-02"
"31379","2022","COM","2020","169","2","171","2023-01-02"
"31380","2022","COM","2020","525","8","533","2023-01-02"
"31381","2022","COM","2020","2561","62","2623","2023-01-02"
"31382","2022","COM","2020","111","2","113","2023-01-02"
"31383","2022","COM","2020","1299","26","1325","2023-01-02"
"31384","2022","COM","2020","1791","36","1827","2023-01-02"
"31385","2022","COM","2020","197","5","202","2023-01-02"
"31386","2022","COM","2020","217","6","223","2023-01-02"
"31387","2022","COM","2020","129","0","129","2023-01-02"
"31388","2022","COM","2020","371","12","383","2023-01-02"
"31389","2022","COM","2020","4099","77","4176","2023-01-02"
"31390","2022","COM","2020","2726","32","2758","2023-01-02"
"31391","2022","COM","2020","454","31","485","2023-01-02"
"31392","2022","COM","2020","80","4","84","2023-01-02"
"31393","2022","COM","2020","166","5","171","2023-01-02"
"31394","2022","COM","2020","126","3","129","2023-01-02"
"31395","2022","COM","2020","24762","574","25336","2023-01-02"
"31396","2022","COM","2020","3955","64","4019","2023-01-02"
"31397","2022","COM","2020","52","1","53","2023-01-02"
"31398","2022","COM","2020","96","1","97","2023-01-02"
"31399","2022","COM","2020","2938","63","3001","2023-01-02"
"31400","2022","COM","2020","93","0","93","2023-01-02"
"31401","2022","COM","2020","389","6","395","2023-01-02"
"31402","2022","COM","2020","908","31","939","2023-01-02"
"31403","2022","COM","2020","775","133","908","2023-01-02"
"31404","2022","COM","2020","102","4","106","2023-01-02"
"31405","2022","COM","2020","121","3","124","2023-01-02"
"31406","2022","COM","2020","814","10","824","2023-01-02"
"31407","2022","COM","2020","1241","29","1270","2023-01-02"
"31408","2022","COM","2020","86","0","86","2023-01-02"
"31409","2022","COM","2020","2363","55","2418","2023-01-02"
"31410","2022","COM","2020","4624","90","4714","2023-01-02"
"31411","2022","COM","2020","996","24","1020","2023-01-02"
"31412","2022","COM","2020","263","8","271","2023-01-02"
"31413","2022","COM","2020","520","18","538","2023-01-02"
"31414","2022","COM","2020","77","2","79","2023-01-02"
"31415","2022","COM","2020","80","2","82","2023-01-02"
"31416","2022","COM","2020","619","8","627","2023-01-02"
"31417","2022","COM","2020","8523","253","8776","2023-01-02"
"31418","2022","COM","2020","954","33","987","2023-01-02"
"31419","2022","COM","2020","172","4","176","2023-01-02"
"31420","2022","COM","2020","2829","37","2866","2023-01-02"
"31421","2022","COM","2020","4335","76","4411","2023-01-02"
"31422","2022","COM","2020","94","0","94","2023-01-02"
"31423","2022","COM","2020","318","3","321","2023-01-02"
"31424","2022","COM","2020","19462","442","19904","2023-01-02"
"31425","2022","COM","2020","439","10","449","2023-01-02"
"31426","2022","COM","2020","857","12","869","2023-01-02"
"31427","2022","COM","2020","934","19","953","2023-01-02"
"31428","2022","COM","2020","53","2","55","2023-01-02"
"31429","2022","COM","2020","2298","35","2333","2023-01-02"
"31430","2022","COM","2020","600","16","616","2023-01-02"
"31431","2022","COM","2020","59","1","60","2023-01-02"
"31432","2022","COM","2020","39","3","42","2023-01-02"
"31433","2022","COM","2020","9832","123","9955","2023-01-02"
"31434","2022","COM","2020","79","4","83","2023-01-02"
"31435","2022","COM","2020","956","14","970","2023-01-02"
"31436","2022","COM","2020","419","5","424","2023-01-02"
"31437","2022","COM","2020","83","4","87","2023-01-02"
"31439","2022","COM","2020","723","17","740","2023-01-02"
"31440","2022","COM","2020","69","1","70","2023-01-02"
"31441","2022","COM","2020","149","4","153","2023-01-02"
"31442","2022","COM","2020","555","10","565","2023-01-02"
"31443","2022","COM","2020","297","7","304","2023-01-02"
"31444","2022","COM","2020","135","4","139","2023-01-02"
"31445","2022","COM","2020","5950","88","6038","2023-01-02"
"31446","2022","COM","2020","14730","287","15017","2023-01-02"
"31447","2022","COM","2020","34","1","35","2023-01-02"
"31448","2022","COM","2020","475","25","500","2023-01-02"
"31449","2022","COM","2020","137","4","141","2023-01-02"
"31450","2022","COM","2020","543","13","556","2023-01-02"
"31451","2022","COM","2020","9652","295","9947","2023-01-02"
"31452","2022","COM","2020","58","0","58","2023-01-02"
"31453","2022","COM","2020","137","5","142","2023-01-02"
"31454","2022","COM","2020","3659","87","3746","2023-01-02"
"31455","2022","COM","2020","2627","57","2684","2023-01-02"
"31456","2022","COM","2020","52","1","53","2023-01-02"
"31457","2022","COM","2020","794","13","807","2023-01-02"
"31458","2022","COM","2020","4939","54","4993","2023-01-02"
"31459","2022","COM","2020","763","19","782","2023-01-02"
"31460","2022","COM","2020","4294","71","4365","2023-01-02"
"31461","2022","COM","2020","288","3","291","2023-01-02"
"31462","2022","COM","2020","1989","42","2031","2023-01-02"
"31463","2022","COM","2020","250","4","254","2023-01-02"
"31464","2022","COM","2020","327","9","336","2023-01-02"
"31465","2022","COM","2020","20","0","20","2023-01-02"
"31466","2022","COM","2020","807","17","824","2023-01-02"
"31467","2022","COM","2020","6269","50","6319","2023-01-02"
"31468","2022","COM","2020","237","8","245","2023-01-02"
"31469","2022","COM","2020","129","3","132","2023-01-02"
"31470","2022","COM","2020","62","4","66","2023-01-02"
"31471","2022","COM","2020","383","3","386","2023-01-02"
"31472","2022","COM","2020","237","5","242","2023-01-02"
"31473","2022","COM","2020","436","1","437","2023-01-02"
"31474","2022","COM","2020","237","5","242","2023-01-02"
"31475","2022","COM","2020","1495","31","1526","2023-01-02"
"31476","2022","COM","2020","921","21","942","2023-01-02"
"31477","2022","COM","2020","43","0","43","2023-01-02"
"31478","2022","COM","2020","1261","36","1297","2023-01-02"
"31479","2022","COM","2020","61","1","62","2023-01-02"
"31480","2022","COM","2020","2312","69","2381","2023-01-02"
"31481","2022","COM","2020","2101","48","2149","2023-01-02"
"31482","2022","COM","2020","214","2","216","2023-01-02"
"31483","2022","COM","2020","11664","540","12204","2023-01-02"
"31484","2022","COM","2020","2512","59","2571","2023-01-02"
"31485","2022","COM","2020","118","2","120","2023-01-02"
"31486","2022","COM","2020","1571","25","1596","2023-01-02"
"31487","2022","COM","2020","229","5","234","2023-01-02"
"31488","2022","COM","2020","11114","145","11259","2023-01-02"
"31489","2022","COM","2020","394","12","406","2023-01-02"
"31490","2022","COM","2020","6777","76","6853","2023-01-02"
"31491","2022","COM","2020","413","11","424","2023-01-02"
"31492","2022","COM","2020","551","7","558","2023-01-02"
"31493","2022","COM","2020","127","6","133","2023-01-02"
"31494","2022","COM","2020","178","1","179","2023-01-02"
"31495","2022","COM","2020","1300","13","1313","2023-01-02"
"31496","2022","COM","2020","258","13","271","2023-01-02"
"31497","2022","COM","2020","2315","48","2363","2023-01-02"
"31498","2022","COM","2020","38","0","38","2023-01-02"
"31499","2022","COM","2020","9555","182","9737","2023-01-02"
"31500","2022","COM","2020","554","18","572","2023-01-02"
"31501","2022","COM","2020","439","7","446","2023-01-02"
"31502","2022","COM","2020","362","9","371","2023-01-02"
"31503","2022","COM","2020","1056","11","1067","2023-01-02"
"31504","2022","COM","2020","224","16","240","2023-01-02"
"31505","2022","COM","2020","316","6","322","2023-01-02"
"31506","2022","COM","2020","13163","238","13401","2023-01-02"
"31507","2022","COM","2020","1615","25","1640","2023-01-02"
"31508","2022","COM","2020","34","2","36","2023-01-02"
"31509","2022","COM","2020","159","3","162","2023-01-02"
"31510","2022","COM","2020","143","0","143","2023-01-02"
"31511","2022","COM","2020","247","8","255","2023-01-02"
"31512","2022","COM","2020","896","27","923","2023-01-02"
"31513","2022","COM","2020","393","8","401","2023-01-02"
"31514","2022","COM","2020","59","1","60","2023-01-02"
"31515","2022","COM","2020","431","9","440","2023-01-02"
"31516","2022","COM","2020","1940","34","1974","2023-01-02"
"31517","2022","COM","2020","2293","61","2354","2023-01-02"
"31518","2022","COM","2020","592","16","608","2023-01-02"
"31519","2022","COM","2020","206","8","214","2023-01-02"
"31520","2022","COM","2020","116","2","118","2023-01-02"
"31521","2022","COM","2020","338","15","353","2023-01-02"
"31522","2022","COM","2020","60","2","62","2023-01-02"
"31523","2022","COM","2020","1755","105","1860","2023-01-02"
"31524","2022","COM","2020","127","2","129","2023-01-02"
"31525","2022","COM","2020","592","14","606","2023-01-02"
"31526","2022","COM","2020","8497","197","8694","2023-01-02"
"31527","2022","COM","2020","151","3","154","2023-01-02"
"31528","2022","COM","2020","130","1","131","2023-01-02"
"31529","2022","COM","2020","111","2","113","2023-01-02"
"31530","2022","COM","2020","245","5","250","2023-01-02"
"31531","2022","COM","2020","78","0","78","2023-01-02"
"31532","2022","COM","2020","91","0","91","2023-01-02"
"31533","2022","COM","2020","2324","53","2377","2023-01-02"
"31534","2022","COM","2020","211","0","211","2023-01-02"
"31535","2022","COM","2020","706","18","724","2023-01-02"
"31536","2022","COM","2020","249","8","257","2023-01-02"
"31537","2022","COM","2020","185","4","189","2023-01-02"
"31538","2022","COM","2020","222","4","226","2023-01-02"
"31539","2022","COM","2020","63","3","66","2023-01-02"
"31540","2022","COM","2020","331","8","339","2023-01-02"
"31541","2022","COM","2020","3287","74","3361","2023-01-02"
"31542","2022","COM","2020","209","7","216","2023-01-02"
"31543","2022","COM","2020","118","2","120","2023-01-02"
"31544","2022","COM","2020","219","2","221","2023-01-02"
"31545","2022","COM","2020","207","4","211","2023-01-02"
"31546","2022","COM","2020","128","2","130","2023-01-02"
"31547","2022","COM","2020","9725","129","9854","2023-01-02"
"31548","2022","COM","2020","47","0","47","2023-01-02"
"31549","2022","COM","2020","21","0","21","2023-01-02"
"31550","2022","COM","2020","520","15","535","2023-01-02"
"31551","2022","COM","2020","579","18","597","2023-01-02"
"31552","2022","COM","2020","139","4","143","2023-01-02"
"31553","2022","COM","2020","1141","25","1166","2023-01-02"
"31554","2022","COM","2020","241","6","247","2023-01-02"
"31555","2022","COM","2020","498003","5017","503020","2023-01-02"
"31556","2022","COM","2020","377","9","386","2023-01-02"
"31557","2022","COM","2020","28763","642","29405","2023-01-02"
"31558","2022","COM","2020","402","7","409","2023-01-02"
"31559","2022","COM","2020","7","0","7","2023-01-02"
"31560","2022","COM","2020","470","8","478","2023-01-02"
"31561","2022","COM","2020","12339","172","12511","2023-01-02"
"31562","2022","COM","2020","118","1","119","2023-01-02"
"31563","2022","COM","2020","1334","36","1370","2023-01-02"
"31564","2022","COM","2020","144","3","147","2023-01-02"
"31565","2022","COM","2020","878","14","892","2023-01-02"
"31566","2022","COM","2020","517","4","521","2023-01-02"
"31567","2022","COM","2020","441","6","447","2023-01-02"
"31568","2022","COM","2020","267","7","274","2023-01-02"
"31569","2022","COM","2020","384","10","394","2023-01-02"
"31570","2022","COM","2020","308","5","313","2023-01-02"
"31571","2022","COM","2020","290","4","294","2023-01-02"
"31572","2022","COM","2020","2747","89","2836","2023-01-02"
"31573","2022","COM","2020","3727","65","3792","2023-01-02"
"31574","2022","COM","2020","3138","37","3175","2023-01-02"
"31575","2022","COM","2020","1211","39","1250","2023-01-02"
"31576","2022","COM","2020","358","7","365","2023-01-02"
"31577","2022","COM","2020","146","0","146","2023-01-02"
"31578","2022","COM","2020","967","32","999","2023-01-02"
"31579","2022","COM","2020","796","13","809","2023-01-02"
"31580","2022","COM","2020","1094","23","1117","2023-01-02"
"31581","2022","COM","2020","1599","32","1631","2023-01-02"
"31582","2022","COM","2020","4848","68","4916","2023-01-02"
"31583","2022","COM","2020","1090","25","1115","2023-01-02"
"31584","2022","COM","2020","6105","79","6184","2023-01-02"
"31585","2022","COM","2020","1756","30","1786","2023-01-02"
"31586","2022","COM","2020","562","4","566","2023-01-02"
"31587","2022","COM","2020","1629","11","1640","2023-01-02"
"31588","2022","COM","2020","10112","126","10238","2023-01-02"
"31589","2022","COM","2020","1438","19","1457","2023-01-02"
"31590","2022","COM","2020","45","0","45","2023-01-02"
"31591","2022","COM","2020","79","1","80","2023-01-02"
"31592","2022","COM","2020","2114","38","2152","2023-01-02"
"31593","2022","COM","2020","85","0","85","2023-01-02"
"32001","2022","COM","2020","722","47","769","2023-01-02"
"32002","2022","COM","2020","77","5","82","2023-01-02"
"32003","2022","COM","2020","44","3","47","2023-01-02"
"32004","2022","COM","2020","133","3","136","2023-01-02"
"32005","2022","COM","2020","328","6","334","2023-01-02"
"32007","2022","COM","2020","221","5","226","2023-01-02"
"32008","2022","COM","2020","73","0","73","2023-01-02"
"32009","2022","COM","2020","92","1","93","2023-01-02"
"32010","2022","COM","2020","89","0","89","2023-01-02"
"32012","2022","COM","2020","1119","28","1147","2023-01-02"
"32013","2022","COM","2020","22518","1106","23624","2023-01-02"
"32014","2022","COM","2020","114","5","119","2023-01-02"
"32015","2022","COM","2020","90","1","91","2023-01-02"
"32016","2022","COM","2020","673","16","689","2023-01-02"
"32017","2022","COM","2020","133","5","138","2023-01-02"
"32018","2022","COM","2020","214","3","217","2023-01-02"
"32019","2022","COM","2020","521","16","537","2023-01-02"
"32020","2022","COM","2020","275","9","284","2023-01-02"
"32021","2022","COM","2020","75","1","76","2023-01-02"
"32022","2022","COM","2020","176","7","183","2023-01-02"
"32023","2022","COM","2020","104","1","105","2023-01-02"
"32024","2022","COM","2020","159","3","162","2023-01-02"
"32025","2022","COM","2020","160","2","162","2023-01-02"
"32026","2022","COM","2020","111","0","111","2023-01-02"
"32027","2022","COM","2020","1367","39","1406","2023-01-02"
"32028","2022","COM","2020","104","3","107","2023-01-02"
"32029","2022","COM","2020","664","20","684","2023-01-02"
"32030","2022","COM","2020","129","3","132","2023-01-02"
"32031","2022","COM","2020","172","2","174","2023-01-02"
"32032","2022","COM","2020","323","10","333","2023-01-02"
"32033","2022","COM","2020","109","0","109","2023-01-02"
"32034","2022","COM","2020","56","0","56","2023-01-02"
"32035","2022","COM","2020","239","3","242","2023-01-02"
"32036","2022","COM","2020","657","40","697","2023-01-02"
"32037","2022","COM","2020","128","7","135","2023-01-02"
"32038","2022","COM","2020","208","8","216","2023-01-02"
"32039","2022","COM","2020","120","3","123","2023-01-02"
"32040","2022","COM","2020","137","1","138","2023-01-02"
"32041","2022","COM","2020","165","4","169","2023-01-02"
"32042","2022","COM","2020","139","4","143","2023-01-02"
"32043","2022","COM","2020","151","4","155","2023-01-02"
"32044","2022","COM","2020","302","8","310","2023-01-02"
"32045","2022","COM","2020","416","19","435","2023-01-02"
"32046","2022","COM","2020","199","6","205","2023-01-02"
"32047","2022","COM","2020","112","1","113","2023-01-02"
"32048","2022","COM","2020","90","0","90","2023-01-02"
"32049","2022","COM","2020","73","3","76","2023-01-02"
"32050","2022","COM","2020","95","5","100","2023-01-02"
"32051","2022","COM","2020","122","7","129","2023-01-02"
"32052","2022","COM","2020","138","4","142","2023-01-02"
"32053","2022","COM","2020","192","0","192","2023-01-02"
"32054","2022","COM","2020","381","9","390","2023-01-02"
"32055","2022","COM","2020","134","2","136","2023-01-02"
"32056","2022","COM","2020","45","4","49","2023-01-02"
"32057","2022","COM","2020","130","2","132","2023-01-02"
"32058","2022","COM","2020","39","2","41","2023-01-02"
"32059","2022","COM","2020","136","2","138","2023-01-02"
"32060","2022","COM","2020","215","3","218","2023-01-02"
"32061","2022","COM","2020","187","3","190","2023-01-02"
"32062","2022","COM","2020","166","4","170","2023-01-02"
"32063","2022","COM","2020","165","8","173","2023-01-02"
"32064","2022","COM","2020","397","11","408","2023-01-02"
"32065","2022","COM","2020","244","6","250","2023-01-02"
"32066","2022","COM","2020","253","2","255","2023-01-02"
"32067","2022","COM","2020","50","1","51","2023-01-02"
"32068","2022","COM","2020","136","3","139","2023-01-02"
"32069","2022","COM","2020","68","3","71","2023-01-02"
"32070","2022","COM","2020","207","3","210","2023-01-02"
"32071","2022","COM","2020","178","9","187","2023-01-02"
"32072","2022","COM","2020","50","1","51","2023-01-02"
"32073","2022","COM","2020","214","4","218","2023-01-02"
"32075","2022","COM","2020","232","4","236","2023-01-02"
"32076","2022","COM","2020","547","10","557","2023-01-02"
"32077","2022","COM","2020","86","2","88","2023-01-02"
"32078","2022","COM","2020","231","9","240","2023-01-02"
"32079","2022","COM","2020","1197","20","1217","2023-01-02"
"32080","2022","COM","2020","145","2","147","2023-01-02"
"32081","2022","COM","2020","131","2","133","2023-01-02"
"32082","2022","COM","2020","354","6","360","2023-01-02"
"32083","2022","COM","2020","1015","23","1038","2023-01-02"
"32084","2022","COM","2020","52","2","54","2023-01-02"
"32085","2022","COM","2020","173","7","180","2023-01-02"
"32086","2022","COM","2020","77","2","79","2023-01-02"
"32087","2022","COM","2020","127","4","131","2023-01-02"
"32088","2022","COM","2020","324","0","324","2023-01-02"
"32089","2022","COM","2020","240","5","245","2023-01-02"
"32090","2022","COM","2020","339","8","347","2023-01-02"
"32091","2022","COM","2020","361","17","378","2023-01-02"
"32092","2022","COM","2020","96","1","97","2023-01-02"
"32093","2022","COM","2020","103","7","110","2023-01-02"
"32094","2022","COM","2020","435","11","446","2023-01-02"
"32095","2022","COM","2020","592","13","605","2023-01-02"
"32096","2022","COM","2020","1670","35","1705","2023-01-02"
"32097","2022","COM","2020","114","5","119","2023-01-02"
"32098","2022","COM","2020","328","5","333","2023-01-02"
"32099","2022","COM","2020","72","2","74","2023-01-02"
"32100","2022","COM","2020","162","4","166","2023-01-02"
"32101","2022","COM","2020","229","3","232","2023-01-02"
"32102","2022","COM","2020","219","4","223","2023-01-02"
"32103","2022","COM","2020","168","8","176","2023-01-02"
"32104","2022","COM","2020","160","3","163","2023-01-02"
"32105","2022","COM","2020","414","11","425","2023-01-02"
"32106","2022","COM","2020","928","69","997","2023-01-02"
"32107","2022","COM","2020","6478","192","6670","2023-01-02"
"32108","2022","COM","2020","154","10","164","2023-01-02"
"32109","2022","COM","2020","196","5","201","2023-01-02"
"32110","2022","COM","2020","397","5","402","2023-01-02"
"32111","2022","COM","2020","49","0","49","2023-01-02"
"32112","2022","COM","2020","255","4","259","2023-01-02"
"32113","2022","COM","2020","89","2","91","2023-01-02"
"32114","2022","COM","2020","124","3","127","2023-01-02"
"32115","2022","COM","2020","325","3","328","2023-01-02"
"32116","2022","COM","2020","150","4","154","2023-01-02"
"32117","2022","COM","2020","854","28","882","2023-01-02"
"32118","2022","COM","2020","137","4","141","2023-01-02"
"32119","2022","COM","2020","3998","71","4069","2023-01-02"
"32120","2022","COM","2020","431","7","438","2023-01-02"
"32121","2022","COM","2020","505","16","521","2023-01-02"
"32122","2022","COM","2020","346","11","357","2023-01-02"
"32123","2022","COM","2020","566","12","578","2023-01-02"
"32124","2022","COM","2020","186","0","186","2023-01-02"
"32125","2022","COM","2020","125","1","126","2023-01-02"
"32126","2022","COM","2020","162","1","163","2023-01-02"
"32127","2022","COM","2020","665","13","678","2023-01-02"
"32128","2022","COM","2020","207","12","219","2023-01-02"
"32129","2022","COM","2020","140","0","140","2023-01-02"
"32130","2022","COM","2020","218","1","219","2023-01-02"
"32131","2022","COM","2020","150","2","152","2023-01-02"
"32132","2022","COM","2020","5890","111","6001","2023-01-02"
"32133","2022","COM","2020","262","2","264","2023-01-02"
"32134","2022","COM","2020","339","7","346","2023-01-02"
"32135","2022","COM","2020","135","5","140","2023-01-02"
"32136","2022","COM","2020","177","5","182","2023-01-02"
"32138","2022","COM","2020","152","4","156","2023-01-02"
"32139","2022","COM","2020","110","1","111","2023-01-02"
"32140","2022","COM","2020","72","0","72","2023-01-02"
"32141","2022","COM","2020","114","0","114","2023-01-02"
"32142","2022","COM","2020","139","3","142","2023-01-02"
"32143","2022","COM","2020","264","11","275","2023-01-02"
"32144","2022","COM","2020","72","0","72","2023-01-02"
"32145","2022","COM","2020","46","2","48","2023-01-02"
"32146","2022","COM","2020","272","4","276","2023-01-02"
"32147","2022","COM","2020","3008","70","3078","2023-01-02"
"32148","2022","COM","2020","104","0","104","2023-01-02"
"32149","2022","COM","2020","1201","32","1233","2023-01-02"
"32150","2022","COM","2020","213","6","219","2023-01-02"
"32151","2022","COM","2020","62","1","63","2023-01-02"
"32152","2022","COM","2020","332","11","343","2023-01-02"
"32153","2022","COM","2020","163","6","169","2023-01-02"
"32154","2022","COM","2020","110","1","111","2023-01-02"
"32155","2022","COM","2020","1158","51","1209","2023-01-02"
"32156","2022","COM","2020","215","5","220","2023-01-02"
"32157","2022","COM","2020","193","3","196","2023-01-02"
"32158","2022","COM","2020","241","10","251","2023-01-02"
"32159","2022","COM","2020","552","14","566","2023-01-02"
"32160","2022","COM","2020","9227","227","9454","2023-01-02"
"32161","2022","COM","2020","89","4","93","2023-01-02"
"32162","2022","COM","2020","1164","46","1210","2023-01-02"
"32163","2022","COM","2020","291","10","301","2023-01-02"
"32164","2022","COM","2020","117","2","119","2023-01-02"
"32165","2022","COM","2020","222","4","226","2023-01-02"
"32166","2022","COM","2020","116","5","121","2023-01-02"
"32167","2022","COM","2020","312","5","317","2023-01-02"
"32169","2022","COM","2020","148","4","152","2023-01-02"
"32170","2022","COM","2020","141","3","144","2023-01-02"
"32171","2022","COM","2020","180","2","182","2023-01-02"
"32172","2022","COM","2020","294","16","310","2023-01-02"
"32173","2022","COM","2020","215","8","223","2023-01-02"
"32174","2022","COM","2020","220","4","224","2023-01-02"
"32175","2022","COM","2020","217","7","224","2023-01-02"
"32176","2022","COM","2020","122","5","127","2023-01-02"
"32177","2022","COM","2020","167","5","172","2023-01-02"
"32178","2022","COM","2020","77","2","79","2023-01-02"
"32180","2022","COM","2020","555","10","565","2023-01-02"
"32181","2022","COM","2020","246","2","248","2023-01-02"
"32182","2022","COM","2020","180","6","186","2023-01-02"
"32183","2022","COM","2020","228","11","239","2023-01-02"
"32184","2022","COM","2020","130","3","133","2023-01-02"
"32185","2022","COM","2020","150","4","154","2023-01-02"
"32186","2022","COM","2020","80","0","80","2023-01-02"
"32187","2022","COM","2020","123","2","125","2023-01-02"
"32188","2022","COM","2020","80","3","83","2023-01-02"
"32189","2022","COM","2020","106","3","109","2023-01-02"
"32190","2022","COM","2020","512","7","519","2023-01-02"
"32191","2022","COM","2020","145","0","145","2023-01-02"
"32192","2022","COM","2020","229","7","236","2023-01-02"
"32193","2022","COM","2020","238","3","241","2023-01-02"
"32194","2022","COM","2020","210","5","215","2023-01-02"
"32195","2022","COM","2020","45","1","46","2023-01-02"
"32196","2022","COM","2020","164","2","166","2023-01-02"
"32197","2022","COM","2020","221","6","227","2023-01-02"
"32198","2022","COM","2020","198","4","202","2023-01-02"
"32199","2022","COM","2020","187","9","196","2023-01-02"
"32200","2022","COM","2020","366","11","377","2023-01-02"
"32201","2022","COM","2020","338","15","353","2023-01-02"
"32202","2022","COM","2020","282","15","297","2023-01-02"
"32203","2022","COM","2020","253","3","256","2023-01-02"
"32204","2022","COM","2020","368","11","379","2023-01-02"
"32205","2022","COM","2020","105","1","106","2023-01-02"
"32206","2022","COM","2020","219","2","221","2023-01-02"
"32207","2022","COM","2020","340","17","357","2023-01-02"
"32208","2022","COM","2020","3687","362","4049","2023-01-02"
"32209","2022","COM","2020","280","7","287","2023-01-02"
"32210","2022","COM","2020","744","15","759","2023-01-02"
"32211","2022","COM","2020","197","3","200","2023-01-02"
"32212","2022","COM","2020","212","4","216","2023-01-02"
"32213","2022","COM","2020","2152","37","2189","2023-01-02"
"32214","2022","COM","2020","98","4","102","2023-01-02"
"32215","2022","COM","2020","151","7","158","2023-01-02"
"32216","2022","COM","2020","168","1","169","2023-01-02"
"32217","2022","COM","2020","58","2","60","2023-01-02"
"32218","2022","COM","2020","66","1","67","2023-01-02"
"32219","2022","COM","2020","311","11","322","2023-01-02"
"32220","2022","COM","2020","138","3","141","2023-01-02"
"32221","2022","COM","2020","236","3","239","2023-01-02"
"32222","2022","COM","2020","233","7","240","2023-01-02"
"32223","2022","COM","2020","60","31","91","2023-01-02"
"32224","2022","COM","2020","228","2","230","2023-01-02"
"32225","2022","COM","2020","101","5","106","2023-01-02"
"32226","2022","COM","2020","82","5","87","2023-01-02"
"32227","2022","COM","2020","789","18","807","2023-01-02"
"32228","2022","COM","2020","91","1","92","2023-01-02"
"32229","2022","COM","2020","63","8","71","2023-01-02"
"32230","2022","COM","2020","45","4","49","2023-01-02"
"32231","2022","COM","2020","433","14","447","2023-01-02"
"32232","2022","COM","2020","39","0","39","2023-01-02"
"32233","2022","COM","2020","1203","85","1288","2023-01-02"
"32234","2022","COM","2020","332","7","339","2023-01-02"
"32235","2022","COM","2020","157","9","166","2023-01-02"
"32236","2022","COM","2020","60","3","63","2023-01-02"
"32237","2022","COM","2020","477","9","486","2023-01-02"
"32238","2022","COM","2020","85","3","88","2023-01-02"
"32239","2022","COM","2020","448","11","459","2023-01-02"
"32240","2022","COM","2020","63","4","67","2023-01-02"
"32241","2022","COM","2020","170","6","176","2023-01-02"
"32242","2022","COM","2020","1501","396","1897","2023-01-02"
"32243","2022","COM","2020","266","3","269","2023-01-02"
"32244","2022","COM","2020","161","3","164","2023-01-02"
"32245","2022","COM","2020","145","7","152","2023-01-02"
"32246","2022","COM","2020","199","2","201","2023-01-02"
"32247","2022","COM","2020","308","15","323","2023-01-02"
"32248","2022","COM","2020","143","4","147","2023-01-02"
"32249","2022","COM","2020","2237","50","2287","2023-01-02"
"32250","2022","COM","2020","77","3","80","2023-01-02"
"32251","2022","COM","2020","69","0","69","2023-01-02"
"32252","2022","COM","2020","1117","18","1135","2023-01-02"
"32253","2022","COM","2020","537","12","549","2023-01-02"
"32254","2022","COM","2020","347","8","355","2023-01-02"
"32255","2022","COM","2020","151","5","156","2023-01-02"
"32256","2022","COM","2020","3445","288","3733","2023-01-02"
"32257","2022","COM","2020","59","4","63","2023-01-02"
"32258","2022","COM","2020","232","5","237","2023-01-02"
"32260","2022","COM","2020","73","4","77","2023-01-02"
"32261","2022","COM","2020","379","7","386","2023-01-02"
"32262","2022","COM","2020","404","14","418","2023-01-02"
"32263","2022","COM","2020","126","3","129","2023-01-02"
"32264","2022","COM","2020","218","4","222","2023-01-02"
"32265","2022","COM","2020","109","2","111","2023-01-02"
"32266","2022","COM","2020","144","1","145","2023-01-02"
"32267","2022","COM","2020","111","2","113","2023-01-02"
"32268","2022","COM","2020","825","28","853","2023-01-02"
"32269","2022","COM","2020","504","7","511","2023-01-02"
"32270","2022","COM","2020","88","1","89","2023-01-02"
"32271","2022","COM","2020","292","10","302","2023-01-02"
"32272","2022","COM","2020","164","3","167","2023-01-02"
"32273","2022","COM","2020","171","12","183","2023-01-02"
"32274","2022","COM","2020","199","0","199","2023-01-02"
"32275","2022","COM","2020","44","1","45","2023-01-02"
"32276","2022","COM","2020","69","1","70","2023-01-02"
"32277","2022","COM","2020","114","3","117","2023-01-02"
"32278","2022","COM","2020","120","2","122","2023-01-02"
"32279","2022","COM","2020","711","18","729","2023-01-02"
"32280","2022","COM","2020","93","2","95","2023-01-02"
"32281","2022","COM","2020","105","5","110","2023-01-02"
"32282","2022","COM","2020","645","18","663","2023-01-02"
"32283","2022","COM","2020","282","7","289","2023-01-02"
"32284","2022","COM","2020","65","1","66","2023-01-02"
"32285","2022","COM","2020","571","18","589","2023-01-02"
"32286","2022","COM","2020","701","16","717","2023-01-02"
"32287","2022","COM","2020","79","1","80","2023-01-02"
"32288","2022","COM","2020","143","1","144","2023-01-02"
"32289","2022","COM","2020","240","3","243","2023-01-02"
"32290","2022","COM","2020","1178","35","1213","2023-01-02"
"32291","2022","COM","2020","116","3","119","2023-01-02"
"32292","2022","COM","2020","393","9","402","2023-01-02"
"32293","2022","COM","2020","73","2","75","2023-01-02"
"32294","2022","COM","2020","73","3","76","2023-01-02"
"32295","2022","COM","2020","137","8","145","2023-01-02"
"32296","2022","COM","2020","2097","141","2238","2023-01-02"
"32297","2022","COM","2020","383","11","394","2023-01-02"
"32298","2022","COM","2020","376","8","384","2023-01-02"
"32299","2022","COM","2020","101","0","101","2023-01-02"
"32300","2022","COM","2020","286","4","290","2023-01-02"
"32301","2022","COM","2020","884","24","908","2023-01-02"
"32302","2022","COM","2020","219","7","226","2023-01-02"
"32303","2022","COM","2020","63","2","65","2023-01-02"
"32304","2022","COM","2020","289","8","297","2023-01-02"
"32305","2022","COM","2020","418","8","426","2023-01-02"
"32306","2022","COM","2020","610","48","658","2023-01-02"
"32307","2022","COM","2020","2513","119","2632","2023-01-02"
"32308","2022","COM","2020","109","2","111","2023-01-02"
"32309","2022","COM","2020","115","5","120","2023-01-02"
"32310","2022","COM","2020","117","2","119","2023-01-02"
"32311","2022","COM","2020","336","6","342","2023-01-02"
"32312","2022","COM","2020","672","15","687","2023-01-02"
"32313","2022","COM","2020","139","4","143","2023-01-02"
"32314","2022","COM","2020","73","5","78","2023-01-02"
"32315","2022","COM","2020","151","2","153","2023-01-02"
"32316","2022","COM","2020","109","3","112","2023-01-02"
"32317","2022","COM","2020","65","2","67","2023-01-02"
"32318","2022","COM","2020","106","2","108","2023-01-02"
"32319","2022","COM","2020","1416","30","1446","2023-01-02"
"32320","2022","COM","2020","153","10","163","2023-01-02"
"32321","2022","COM","2020","273","6","279","2023-01-02"
"32322","2022","COM","2020","210","3","213","2023-01-02"
"32323","2022","COM","2020","104","5","109","2023-01-02"
"32324","2022","COM","2020","78","2","80","2023-01-02"
"32325","2022","COM","2020","129","3","132","2023-01-02"
"32326","2022","COM","2020","147","3","150","2023-01-02"
"32327","2022","COM","2020","85","1","86","2023-01-02"
"32328","2022","COM","2020","118","5","123","2023-01-02"
"32329","2022","COM","2020","161","3","164","2023-01-02"
"32330","2022","COM","2020","194","5","199","2023-01-02"
"32331","2022","COM","2020","1237","35","1272","2023-01-02"
"32332","2022","COM","2020","121","1","122","2023-01-02"
"32333","2022","COM","2020","182","0","182","2023-01-02"
"32334","2022","COM","2020","1616","41","1657","2023-01-02"
"32335","2022","COM","2020","444","10","454","2023-01-02"
"32336","2022","COM","2020","160","8","168","2023-01-02"
"32337","2022","COM","2020","73","3","76","2023-01-02"
"32338","2022","COM","2020","173","4","177","2023-01-02"
"32339","2022","COM","2020","251","8","259","2023-01-02"
"32340","2022","COM","2020","283","2","285","2023-01-02"
"32341","2022","COM","2020","247","4","251","2023-01-02"
"32342","2022","COM","2020","52","2","54","2023-01-02"
"32343","2022","COM","2020","171","7","178","2023-01-02"
"32344","2022","COM","2020","1761","122","1883","2023-01-02"
"32345","2022","COM","2020","562","14","576","2023-01-02"
"32346","2022","COM","2020","211","6","217","2023-01-02"
"32347","2022","COM","2020","276","7","283","2023-01-02"
"32348","2022","COM","2020","571","23","594","2023-01-02"
"32349","2022","COM","2020","102","4","106","2023-01-02"
"32350","2022","COM","2020","31","2","33","2023-01-02"
"32351","2022","COM","2020","110","1","111","2023-01-02"
"32352","2022","COM","2020","110","4","114","2023-01-02"
"32353","2022","COM","2020","148","3","151","2023-01-02"
"32354","2022","COM","2020","134","4","138","2023-01-02"
"32355","2022","COM","2020","85","1","86","2023-01-02"
"32356","2022","COM","2020","129","1","130","2023-01-02"
"32357","2022","COM","2020","127","6","133","2023-01-02"
"32358","2022","COM","2020","188","4","192","2023-01-02"
"32359","2022","COM","2020","154","5","159","2023-01-02"
"32360","2022","COM","2020","141","3","144","2023-01-02"
"32361","2022","COM","2020","132","8","140","2023-01-02"
"32362","2022","COM","2020","143","2","145","2023-01-02"
"32363","2022","COM","2020","92","3","95","2023-01-02"
"32364","2022","COM","2020","93","3","96","2023-01-02"
"32365","2022","COM","2020","332","6","338","2023-01-02"
"32366","2022","COM","2020","73","1","74","2023-01-02"
"32367","2022","COM","2020","62","2","64","2023-01-02"
"32368","2022","COM","2020","546","11","557","2023-01-02"
"32369","2022","COM","2020","374","13","387","2023-01-02"
"32370","2022","COM","2020","1049","66","1115","2023-01-02"
"32371","2022","COM","2020","83","4","87","2023-01-02"
"32372","2022","COM","2020","285","5","290","2023-01-02"
"32373","2022","COM","2020","212","4","216","2023-01-02"
"32374","2022","COM","2020","183","6","189","2023-01-02"
"32375","2022","COM","2020","89","4","93","2023-01-02"
"32376","2022","COM","2020","113","3","116","2023-01-02"
"32377","2022","COM","2020","184","7","191","2023-01-02"
"32378","2022","COM","2020","498","7","505","2023-01-02"
"32379","2022","COM","2020","210","4","214","2023-01-02"
"32380","2022","COM","2020","140","9","149","2023-01-02"
"32381","2022","COM","2020","403","10","413","2023-01-02"
"32382","2022","COM","2020","312","14","326","2023-01-02"
"32383","2022","COM","2020","126","6","132","2023-01-02"
"32384","2022","COM","2020","278","6","284","2023-01-02"
"32385","2022","COM","2020","187","1","188","2023-01-02"
"32386","2022","COM","2020","146","1","147","2023-01-02"
"32387","2022","COM","2020","103","2","105","2023-01-02"
"32388","2022","COM","2020","423","10","433","2023-01-02"
"32389","2022","COM","2020","458","20","478","2023-01-02"
"32390","2022","COM","2020","237","4","241","2023-01-02"
"32391","2022","COM","2020","119","7","126","2023-01-02"
"32392","2022","COM","2020","87","1","88","2023-01-02"
"32393","2022","COM","2020","136","5","141","2023-01-02"
"32394","2022","COM","2020","343","5","348","2023-01-02"
"32395","2022","COM","2020","209","4","213","2023-01-02"
"32396","2022","COM","2020","239","3","242","2023-01-02"
"32397","2022","COM","2020","244","16","260","2023-01-02"
"32398","2022","COM","2020","310","10","320","2023-01-02"
"32399","2022","COM","2020","84","3","87","2023-01-02"
"32400","2022","COM","2020","212","9","221","2023-01-02"
"32401","2022","COM","2020","87","1","88","2023-01-02"
"32402","2022","COM","2020","107","3","110","2023-01-02"
"32403","2022","COM","2020","60","1","61","2023-01-02"
"32404","2022","COM","2020","588","14","602","2023-01-02"
"32405","2022","COM","2020","176","6","182","2023-01-02"
"32406","2022","COM","2020","351","10","361","2023-01-02"
"32407","2022","COM","2020","162","3","165","2023-01-02"
"32408","2022","COM","2020","136","5","141","2023-01-02"
"32409","2022","COM","2020","86","5","91","2023-01-02"
"32410","2022","COM","2020","2380","104","2484","2023-01-02"
"32411","2022","COM","2020","99","3","102","2023-01-02"
"32412","2022","COM","2020","853","13","866","2023-01-02"
"32413","2022","COM","2020","82","2","84","2023-01-02"
"32414","2022","COM","2020","228","6","234","2023-01-02"
"32415","2022","COM","2020","89","1","90","2023-01-02"
"32416","2022","COM","2020","361","10","371","2023-01-02"
"32417","2022","COM","2020","408","13","421","2023-01-02"
"32418","2022","COM","2020","291","29","320","2023-01-02"
"32419","2022","COM","2020","107","2","109","2023-01-02"
"32420","2022","COM","2020","67","2","69","2023-01-02"
"32421","2022","COM","2020","144","0","144","2023-01-02"
"32422","2022","COM","2020","42","1","43","2023-01-02"
"32423","2022","COM","2020","63","3","66","2023-01-02"
"32424","2022","COM","2020","224","8","232","2023-01-02"
"32425","2022","COM","2020","1160","27","1187","2023-01-02"
"32426","2022","COM","2020","1097","11","1108","2023-01-02"
"32427","2022","COM","2020","59","1","60","2023-01-02"
"32428","2022","COM","2020","62","2","64","2023-01-02"
"32429","2022","COM","2020","294","6","300","2023-01-02"
"32430","2022","COM","2020","79","0","79","2023-01-02"
"32431","2022","COM","2020","42","4","46","2023-01-02"
"32432","2022","COM","2020","246","2","248","2023-01-02"
"32433","2022","COM","2020","707","17","724","2023-01-02"
"32434","2022","COM","2020","97","3","100","2023-01-02"
"32435","2022","COM","2020","164","9","173","2023-01-02"
"32436","2022","COM","2020","488","8","496","2023-01-02"
"32437","2022","COM","2020","219","1","220","2023-01-02"
"32438","2022","COM","2020","106","0","106","2023-01-02"
"32439","2022","COM","2020","165","2","167","2023-01-02"
"32440","2022","COM","2020","248","6","254","2023-01-02"
"32441","2022","COM","2020","61","0","61","2023-01-02"
"32442","2022","COM","2020","378","4","382","2023-01-02"
"32443","2022","COM","2020","182","4","186","2023-01-02"
"32444","2022","COM","2020","259","7","266","2023-01-02"
"32445","2022","COM","2020","153","5","158","2023-01-02"
"32446","2022","COM","2020","283","8","291","2023-01-02"
"32447","2022","COM","2020","92","1","93","2023-01-02"
"32448","2022","COM","2020","503","16","519","2023-01-02"
"32449","2022","COM","2020","282","3","285","2023-01-02"
"32450","2022","COM","2020","131","4","135","2023-01-02"
"32451","2022","COM","2020","181","3","184","2023-01-02"
"32452","2022","COM","2020","260","8","268","2023-01-02"
"32453","2022","COM","2020","110","6","116","2023-01-02"
"32454","2022","COM","2020","70","2","72","2023-01-02"
"32455","2022","COM","2020","176","11","187","2023-01-02"
"32456","2022","COM","2020","54","0","54","2023-01-02"
"32457","2022","COM","2020","277","13","290","2023-01-02"
"32458","2022","COM","2020","234","5","239","2023-01-02"
"32459","2022","COM","2020","1118","23","1141","2023-01-02"
"32460","2022","COM","2020","307","8","315","2023-01-02"
"32461","2022","COM","2020","118","3","121","2023-01-02"
"32462","2022","COM","2020","3583","57","3640","2023-01-02"
"32463","2022","COM","2020","509","12","521","2023-01-02"
"32464","2022","COM","2020","837","20","857","2023-01-02"
"32465","2022","COM","2020","138","0","138","2023-01-02"
"32466","2022","COM","2020","107","1","108","2023-01-02"
"32467","2022","COM","2020","143","4","147","2023-01-02"
"32468","2022","COM","2020","77","0","77","2023-01-02"
"33001","2022","COM","2020","1998","25","2023","2023-01-02"
"33002","2022","COM","2020","840","14","854","2023-01-02"
"33003","2022","COM","2020","16591","162","16753","2023-01-02"
"33004","2022","COM","2020","3123","21","3144","2023-01-02"
"33005","2022","COM","2020","12284","285","12569","2023-01-02"
"33006","2022","COM","2020","915","13","928","2023-01-02"
"33007","2022","COM","2020","1359","8","1367","2023-01-02"
"33008","2022","COM","2020","494","8","502","2023-01-02"
"33009","2022","COM","2020","11076","315","11391","2023-01-02"
"33010","2022","COM","2020","548","7","555","2023-01-02"
"33011","2022","COM","2020","6413","123","6536","2023-01-02"
"33012","2022","COM","2020","3873","50","3923","2023-01-02"
"33013","2022","COM","2020","8663","77","8740","2023-01-02"
"33014","2022","COM","2020","1111","22","1133","2023-01-02"
"33015","2022","COM","2020","2000","37","2037","2023-01-02"
"33016","2022","COM","2020","439","9","448","2023-01-02"
"33017","2022","COM","2020","278","11","289","2023-01-02"
"33018","2022","COM","2020","3701","43","3744","2023-01-02"
"33019","2022","COM","2020","9136","131","9267","2023-01-02"
"33020","2022","COM","2020","141","5","146","2023-01-02"
"33021","2022","COM","2020","1048","23","1071","2023-01-02"
"33022","2022","COM","2020","3049","42","3091","2023-01-02"
"33023","2022","COM","2020","1357","15","1372","2023-01-02"
"33024","2022","COM","2020","297","5","302","2023-01-02"
"33025","2022","COM","2020","447","6","453","2023-01-02"
"33026","2022","COM","2020","505","7","512","2023-01-02"
"33027","2022","COM","2020","285","9","294","2023-01-02"
"33028","2022","COM","2020","1181","16","1197","2023-01-02"
"33029","2022","COM","2020","5625","81","5706","2023-01-02"
"33030","2022","COM","2020","2069","23","2092","2023-01-02"
"33031","2022","COM","2020","131","2","133","2023-01-02"
"33032","2022","COM","2020","7425","61","7486","2023-01-02"
"33033","2022","COM","2020","939","7","946","2023-01-02"
"33034","2022","COM","2020","461","4","465","2023-01-02"
"33035","2022","COM","2020","729","2","731","2023-01-02"
"33036","2022","COM","2020","4806","258","5064","2023-01-02"
"33037","2022","COM","2020","2404","40","2444","2023-01-02"
"33038","2022","COM","2020","906","8","914","2023-01-02"
"33039","2022","COM","2020","30543","347","30890","2023-01-02"
"33040","2022","COM","2020","1206","13","1219","2023-01-02"
"33042","2022","COM","2020","5831","98","5929","2023-01-02"
"33043","2022","COM","2020","295","1","296","2023-01-02"
"33044","2022","COM","2020","217","6","223","2023-01-02"
"33045","2022","COM","2020","334","7","341","2023-01-02"
"33046","2022","COM","2020","1135","30","1165","2023-01-02"
"33047","2022","COM","2020","1808","30","1838","2023-01-02"
"33048","2022","COM","2020","272","7","279","2023-01-02"
"33049","2022","COM","2020","2554","27","2581","2023-01-02"
"33050","2022","COM","2020","648","9","657","2023-01-02"
"33051","2022","COM","2020","11065","121","11186","2023-01-02"
"33052","2022","COM","2020","1164","36","1200","2023-01-02"
"33053","2022","COM","2020","229","1","230","2023-01-02"
"33054","2022","COM","2020","290","5","295","2023-01-02"
"33055","2022","COM","2020","459","10","469","2023-01-02"
"33056","2022","COM","2020","15276","586","15862","2023-01-02"
"33057","2022","COM","2020","924","19","943","2023-01-02"
"33058","2022","COM","2020","4897","117","5014","2023-01-02"
"33059","2022","COM","2020","309","6","315","2023-01-02"
"33060","2022","COM","2020","439","67","506","2023-01-02"
"33061","2022","COM","2020","1011","19","1030","2023-01-02"
"33062","2022","COM","2020","759","12","771","2023-01-02"
"33063","2022","COM","2020","259809","3438","263247","2023-01-02"
"33064","2022","COM","2020","38","0","38","2023-01-02"
"33065","2022","COM","2020","3741","77","3818","2023-01-02"
"33066","2022","COM","2020","93","1","94","2023-01-02"
"33067","2022","COM","2020","2303","39","2342","2023-01-02"
"33068","2022","COM","2020","95","3","98","2023-01-02"
"33069","2022","COM","2020","24006","282","24288","2023-01-02"
"33070","2022","COM","2020","817","13","830","2023-01-02"
"33071","2022","COM","2020","1317","16","1333","2023-01-02"
"33072","2022","COM","2020","239","4","243","2023-01-02"
"33073","2022","COM","2020","1500","28","1528","2023-01-02"
"33074","2022","COM","2020","206","8","214","2023-01-02"
"33075","2022","COM","2020","19863","203","20066","2023-01-02"
"33076","2022","COM","2020","812","15","827","2023-01-02"
"33077","2022","COM","2020","2409","39","2448","2023-01-02"
"33078","2022","COM","2020","503","12","515","2023-01-02"
"33079","2022","COM","2020","355","7","362","2023-01-02"
"33080","2022","COM","2020","6623","72","6695","2023-01-02"
"33081","2022","COM","2020","2846","31","2877","2023-01-02"
"33082","2022","COM","2020","1350","16","1366","2023-01-02"
"33083","2022","COM","2020","1025","14","1039","2023-01-02"
"33084","2022","COM","2020","1766","17","1783","2023-01-02"
"33085","2022","COM","2020","3040","140","3180","2023-01-02"
"33086","2022","COM","2020","360","5","365","2023-01-02"
"33087","2022","COM","2020","415","3","418","2023-01-02"
"33088","2022","COM","2020","605","10","615","2023-01-02"
"33089","2022","COM","2020","504","6","510","2023-01-02"
"33090","2022","COM","2020","5997","77","6074","2023-01-02"
"33093","2022","COM","2020","771","17","788","2023-01-02"
"33094","2022","COM","2020","227","4","231","2023-01-02"
"33095","2022","COM","2020","1344","20","1364","2023-01-02"
"33096","2022","COM","2020","8272","83","8355","2023-01-02"
"33097","2022","COM","2020","2420","35","2455","2023-01-02"
"33098","2022","COM","2020","514","5","519","2023-01-02"
"33099","2022","COM","2020","4161","46","4207","2023-01-02"
"33100","2022","COM","2020","1213","21","1234","2023-01-02"
"33101","2022","COM","2020","1254","23","1277","2023-01-02"
"33102","2022","COM","2020","376","5","381","2023-01-02"
"33103","2022","COM","2020","53","0","53","2023-01-02"
"33104","2022","COM","2020","4820","65","4885","2023-01-02"
"33105","2022","COM","2020","214","8","222","2023-01-02"
"33106","2022","COM","2020","1487","32","1519","2023-01-02"
"33108","2022","COM","2020","3238","27","3265","2023-01-02"
"33109","2022","COM","2020","2462","34","2496","2023-01-02"
"33111","2022","COM","2020","1111","15","1126","2023-01-02"
"33112","2022","COM","2020","140","2","142","2023-01-02"
"33113","2022","COM","2020","147","3","150","2023-01-02"
"33114","2022","COM","2020","2292","16","2308","2023-01-02"
"33115","2022","COM","2020","239","1","240","2023-01-02"
"33116","2022","COM","2020","400","5","405","2023-01-02"
"33117","2022","COM","2020","217","3","220","2023-01-02"
"33118","2022","COM","2020","2118","35","2153","2023-01-02"
"33119","2022","COM","2020","26047","231","26278","2023-01-02"
"33120","2022","COM","2020","2133","42","2175","2023-01-02"
"33121","2022","COM","2020","193","2","195","2023-01-02"
"33122","2022","COM","2020","16932","287","17219","2023-01-02"
"33123","2022","COM","2020","2678","33","2711","2023-01-02"
"33124","2022","COM","2020","724","15","739","2023-01-02"
"33125","2022","COM","2020","2213","29","2242","2023-01-02"
"33126","2022","COM","2020","845","18","863","2023-01-02"
"33127","2022","COM","2020","222","5","227","2023-01-02"
"33128","2022","COM","2020","642","14","656","2023-01-02"
"33129","2022","COM","2020","153","0","153","2023-01-02"
"33130","2022","COM","2020","1057","27","1084","2023-01-02"
"33131","2022","COM","2020","212","2","214","2023-01-02"
"33132","2022","COM","2020","553","8","561","2023-01-02"
"33133","2022","COM","2020","71","0","71","2023-01-02"
"33134","2022","COM","2020","269","7","276","2023-01-02"
"33135","2022","COM","2020","126","0","126","2023-01-02"
"33136","2022","COM","2020","269","3","272","2023-01-02"
"33137","2022","COM","2020","218","4","222","2023-01-02"
"33138","2022","COM","2020","8623","123","8746","2023-01-02"
"33139","2022","COM","2020","97","2","99","2023-01-02"
"33140","2022","COM","2020","4899","99","4998","2023-01-02"
"33141","2022","COM","2020","715","9","724","2023-01-02"
"33142","2022","COM","2020","1726","17","1743","2023-01-02"
"33143","2022","COM","2020","2531","27","2558","2023-01-02"
"33144","2022","COM","2020","789","130","919","2023-01-02"
"33145","2022","COM","2020","663","18","681","2023-01-02"
"33146","2022","COM","2020","2363","29","2392","2023-01-02"
"33147","2022","COM","2020","465","6","471","2023-01-02"
"33148","2022","COM","2020","90","5","95","2023-01-02"
"33149","2022","COM","2020","155","1","156","2023-01-02"
"33150","2022","COM","2020","338","2","340","2023-01-02"
"33151","2022","COM","2020","925","10","935","2023-01-02"
"33152","2022","COM","2020","120","5","125","2023-01-02"
"33153","2022","COM","2020","263","4","267","2023-01-02"
"33154","2022","COM","2020","2145","102","2247","2023-01-02"
"33155","2022","COM","2020","160","3","163","2023-01-02"
"33156","2022","COM","2020","283","8","291","2023-01-02"
"33157","2022","COM","2020","780","11","791","2023-01-02"
"33158","2022","COM","2020","241","7","248","2023-01-02"
"33159","2022","COM","2020","1470","14","1484","2023-01-02"
"33160","2022","COM","2020","594","16","610","2023-01-02"
"33161","2022","COM","2020","761","6","767","2023-01-02"
"33162","2022","COM","2020","24202","281","24483","2023-01-02"
"33163","2022","COM","2020","430","9","439","2023-01-02"
"33164","2022","COM","2020","1647","33","1680","2023-01-02"
"33165","2022","COM","2020","3303","28","3331","2023-01-02"
"33166","2022","COM","2020","501","4","505","2023-01-02"
"33167","2022","COM","2020","18013","117","18130","2023-01-02"
"33168","2022","COM","2020","594","9","603","2023-01-02"
"33169","2022","COM","2020","110","4","114","2023-01-02"
"33170","2022","COM","2020","769","19","788","2023-01-02"
"33171","2022","COM","2020","228","6","234","2023-01-02"
"33172","2022","COM","2020","273","11","284","2023-01-02"
"33173","2022","COM","2020","184","6","190","2023-01-02"
"33174","2022","COM","2020","1132","34","1166","2023-01-02"
"33175","2022","COM","2020","749","10","759","2023-01-02"
"33176","2022","COM","2020","356","7","363","2023-01-02"
"33177","2022","COM","2020","2355","42","2397","2023-01-02"
"33178","2022","COM","2020","372","6","378","2023-01-02"
"33179","2022","COM","2020","3030","55","3085","2023-01-02"
"33180","2022","COM","2020","192","8","200","2023-01-02"
"33181","2022","COM","2020","279","4","283","2023-01-02"
"33182","2022","COM","2020","721","16","737","2023-01-02"
"33183","2022","COM","2020","1432","16","1448","2023-01-02"
"33184","2022","COM","2020","544","15","559","2023-01-02"
"33185","2022","COM","2020","1992","36","2028","2023-01-02"
"33186","2022","COM","2020","701","13","714","2023-01-02"
"33187","2022","COM","2020","1321","24","1345","2023-01-02"
"33188","2022","COM","2020","184","3","187","2023-01-02"
"33189","2022","COM","2020","436","10","446","2023-01-02"
"33190","2022","COM","2020","86","1","87","2023-01-02"
"33191","2022","COM","2020","564","8","572","2023-01-02"
"33192","2022","COM","2020","25871","337","26208","2023-01-02"
"33193","2022","COM","2020","1543","25","1568","2023-01-02"
"33194","2022","COM","2020","691","15","706","2023-01-02"
"33195","2022","COM","2020","1192","8","1200","2023-01-02"
"33196","2022","COM","2020","158","4","162","2023-01-02"
"33197","2022","COM","2020","451","6","457","2023-01-02"
"33198","2022","COM","2020","1606","29","1635","2023-01-02"
"33199","2022","COM","2020","22036","449","22485","2023-01-02"
"33200","2022","COM","2020","11567","189","11756","2023-01-02"
"33201","2022","COM","2020","836","18","854","2023-01-02"
"33202","2022","COM","2020","1482","19","1501","2023-01-02"
"33203","2022","COM","2020","3967","70","4037","2023-01-02"
"33204","2022","COM","2020","557","7","564","2023-01-02"
"33205","2022","COM","2020","1378","21","1399","2023-01-02"
"33206","2022","COM","2020","521","3","524","2023-01-02"
"33207","2022","COM","2020","6298","67","6365","2023-01-02"
"33208","2022","COM","2020","954","9","963","2023-01-02"
"33209","2022","COM","2020","275","7","282","2023-01-02"
"33210","2022","COM","2020","225","4","229","2023-01-02"
"33211","2022","COM","2020","610","2","612","2023-01-02"
"33212","2022","COM","2020","126","1","127","2023-01-02"
"33213","2022","COM","2020","4461","494","4955","2023-01-02"
"33214","2022","COM","2020","5064","77","5141","2023-01-02"
"33215","2022","COM","2020","192","6","198","2023-01-02"
"33216","2022","COM","2020","173","3","176","2023-01-02"
"33218","2022","COM","2020","1642","24","1666","2023-01-02"
"33219","2022","COM","2020","2579","25","2604","2023-01-02"
"33220","2022","COM","2020","1340","12","1352","2023-01-02"
"33221","2022","COM","2020","1132","21","1153","2023-01-02"
"33222","2022","COM","2020","656","15","671","2023-01-02"
"33223","2022","COM","2020","222","3","225","2023-01-02"
"33224","2022","COM","2020","101","0","101","2023-01-02"
"33225","2022","COM","2020","2190","39","2229","2023-01-02"
"33226","2022","COM","2020","2172","39","2211","2023-01-02"
"33227","2022","COM","2020","7366","150","7516","2023-01-02"
"33228","2022","COM","2020","682","10","692","2023-01-02"
"33229","2022","COM","2020","7273","140","7413","2023-01-02"
"33230","2022","COM","2020","516","5","521","2023-01-02"
"33231","2022","COM","2020","291","4","295","2023-01-02"
"33232","2022","COM","2020","40","0","40","2023-01-02"
"33233","2022","COM","2020","2821","22","2843","2023-01-02"
"33234","2022","COM","2020","3578","144","3722","2023-01-02"
"33235","2022","COM","2020","230","2","232","2023-01-02"
"33236","2022","COM","2020","8334","170","8504","2023-01-02"
"33237","2022","COM","2020","843","21","864","2023-01-02"
"33238","2022","COM","2020","10641","163","10804","2023-01-02"
"33239","2022","COM","2020","476","5","481","2023-01-02"
"33240","2022","COM","2020","5826","94","5920","2023-01-02"
"33241","2022","COM","2020","578","9","587","2023-01-02"
"33242","2022","COM","2020","561","10","571","2023-01-02"
"33243","2022","COM","2020","24432","509","24941","2023-01-02"
"33244","2022","COM","2020","427","6","433","2023-01-02"
"33245","2022","COM","2020","830","15","845","2023-01-02"
"33246","2022","COM","2020","149","6","155","2023-01-02"
"33247","2022","COM","2020","163","4","167","2023-01-02"
"33248","2022","COM","2020","2790","36","2826","2023-01-02"
"33249","2022","COM","2020","22913","318","23231","2023-01-02"
"33250","2022","COM","2020","309","8","317","2023-01-02"
"33251","2022","COM","2020","725","9","734","2023-01-02"
"33252","2022","COM","2020","884","13","897","2023-01-02"
"33253","2022","COM","2020","1106","17","1123","2023-01-02"
"33254","2022","COM","2020","520","8","528","2023-01-02"
"33255","2022","COM","2020","245","3","248","2023-01-02"
"33256","2022","COM","2020","5252","46","5298","2023-01-02"
"33257","2022","COM","2020","475","12","487","2023-01-02"
"33258","2022","COM","2020","308","6","314","2023-01-02"
"33259","2022","COM","2020","1369","26","1395","2023-01-02"
"33260","2022","COM","2020","995","22","1017","2023-01-02"
"33261","2022","COM","2020","1223","10","1233","2023-01-02"
"33262","2022","COM","2020","4478","25","4503","2023-01-02"
"33263","2022","COM","2020","293","4","297","2023-01-02"
"33264","2022","COM","2020","1021","12","1033","2023-01-02"
"33266","2022","COM","2020","821","19","840","2023-01-02"
"33268","2022","COM","2020","2832","29","2861","2023-01-02"
"33269","2022","COM","2020","390","4","394","2023-01-02"
"33270","2022","COM","2020","181","8","189","2023-01-02"
"33271","2022","COM","2020","221","2","223","2023-01-02"
"33272","2022","COM","2020","1222","22","1244","2023-01-02"
"33273","2022","COM","2020","7741","131","7872","2023-01-02"
"33274","2022","COM","2020","3406","41","3447","2023-01-02"
"33275","2022","COM","2020","103","2","105","2023-01-02"
"33276","2022","COM","2020","140","5","145","2023-01-02"
"33277","2022","COM","2020","221","6","227","2023-01-02"
"33278","2022","COM","2020","232","6","238","2023-01-02"
"33279","2022","COM","2020","778","10","788","2023-01-02"
"33280","2022","COM","2020","554","4","558","2023-01-02"
"33281","2022","COM","2020","74009","766","74775","2023-01-02"
"33282","2022","COM","2020","333","6","339","2023-01-02"
"33283","2022","COM","2020","228","1","229","2023-01-02"
"33284","2022","COM","2020","11180","132","11312","2023-01-02"
"33285","2022","COM","2020","440","9","449","2023-01-02"
"33287","2022","COM","2020","599","6","605","2023-01-02"
"33288","2022","COM","2020","281","4","285","2023-01-02"
"33289","2022","COM","2020","1598","70","1668","2023-01-02"
"33290","2022","COM","2020","1519","129","1648","2023-01-02"
"33291","2022","COM","2020","177","3","180","2023-01-02"
"33292","2022","COM","2020","136","6","142","2023-01-02"
"33293","2022","COM","2020","3412","51","3463","2023-01-02"
"33294","2022","COM","2020","543","4","547","2023-01-02"
"33295","2022","COM","2020","89","9","98","2023-01-02"
"33296","2022","COM","2020","1031","15","1046","2023-01-02"
"33297","2022","COM","2020","1893","33","1926","2023-01-02"
"33298","2022","COM","2020","1020","20","1040","2023-01-02"
"33299","2022","COM","2020","383","8","391","2023-01-02"
"33300","2022","COM","2020","1080","23","1103","2023-01-02"
"33301","2022","COM","2020","617","6","623","2023-01-02"
"33302","2022","COM","2020","340","10","350","2023-01-02"
"33303","2022","COM","2020","842","8","850","2023-01-02"
"33304","2022","COM","2020","141","4","145","2023-01-02"
"33305","2022","COM","2020","503","5","508","2023-01-02"
"33306","2022","COM","2020","518","6","524","2023-01-02"
"33307","2022","COM","2020","1671","37","1708","2023-01-02"
"33308","2022","COM","2020","308","2","310","2023-01-02"
"33309","2022","COM","2020","492","6","498","2023-01-02"
"33310","2022","COM","2020","187","2","189","2023-01-02"
"33311","2022","COM","2020","1208","24","1232","2023-01-02"
"33312","2022","COM","2020","9786","92","9878","2023-01-02"
"33314","2022","COM","2020","5084","80","5164","2023-01-02"
"33315","2022","COM","2020","1634","21","1655","2023-01-02"
"33316","2022","COM","2020","903","13","916","2023-01-02"
"33317","2022","COM","2020","1192","16","1208","2023-01-02"
"33318","2022","COM","2020","65866","740","66606","2023-01-02"
"33319","2022","COM","2020","441","9","450","2023-01-02"
"33320","2022","COM","2020","725","17","742","2023-01-02"
"33321","2022","COM","2020","2161","28","2189","2023-01-02"
"33322","2022","COM","2020","6995","143","7138","2023-01-02"
"33323","2022","COM","2020","940","19","959","2023-01-02"
"33324","2022","COM","2020","4421","116","4537","2023-01-02"
"33325","2022","COM","2020","938","19","957","2023-01-02"
"33326","2022","COM","2020","218","5","223","2023-01-02"
"33327","2022","COM","2020","3258","51","3309","2023-01-02"
"33328","2022","COM","2020","589","6","595","2023-01-02"
"33329","2022","COM","2020","271","3","274","2023-01-02"
"33330","2022","COM","2020","3301","56","3357","2023-01-02"
"33331","2022","COM","2020","460","4","464","2023-01-02"
"33332","2022","COM","2020","871","10","881","2023-01-02"
"33333","2022","COM","2020","3324","47","3371","2023-01-02"
"33334","2022","COM","2020","2713","35","2748","2023-01-02"
"33335","2022","COM","2020","621","8","629","2023-01-02"
"33336","2022","COM","2020","1022","19","1041","2023-01-02"
"33337","2022","COM","2020","2172","35","2207","2023-01-02"
"33339","2022","COM","2020","1383","29","1412","2023-01-02"
"33341","2022","COM","2020","2354","34","2388","2023-01-02"
"33342","2022","COM","2020","818","21","839","2023-01-02"
"33343","2022","COM","2020","865","16","881","2023-01-02"
"33344","2022","COM","2020","526","6","532","2023-01-02"
"33345","2022","COM","2020","403","7","410","2023-01-02"
"33346","2022","COM","2020","411","11","422","2023-01-02"
"33347","2022","COM","2020","307","5","312","2023-01-02"
"33348","2022","COM","2020","1360","16","1376","2023-01-02"
"33349","2022","COM","2020","2214","23","2237","2023-01-02"
"33350","2022","COM","2020","1248","25","1273","2023-01-02"
"33351","2022","COM","2020","1613","26","1639","2023-01-02"
"33352","2022","COM","2020","4351","84","4435","2023-01-02"
"33353","2022","COM","2020","197","1","198","2023-01-02"
"33354","2022","COM","2020","197","5","202","2023-01-02"
"33355","2022","COM","2020","1509","36","1545","2023-01-02"
"33356","2022","COM","2020","425","5","430","2023-01-02"
"33357","2022","COM","2020","1760","27","1787","2023-01-02"
"33358","2022","COM","2020","471","8","479","2023-01-02"
"33359","2022","COM","2020","283","3","286","2023-01-02"
"33360","2022","COM","2020","313","3","316","2023-01-02"
"33361","2022","COM","2020","579","8","587","2023-01-02"
"33362","2022","COM","2020","1309","15","1324","2023-01-02"
"33363","2022","COM","2020","4626","72","4698","2023-01-02"
"33364","2022","COM","2020","376","7","383","2023-01-02"
"33365","2022","COM","2020","199","9","208","2023-01-02"
"33366","2022","COM","2020","12735","189","12924","2023-01-02"
"33367","2022","COM","2020","431","3","434","2023-01-02"
"33369","2022","COM","2020","669","13","682","2023-01-02"
"33370","2022","COM","2020","556","7","563","2023-01-02"
"33372","2022","COM","2020","55","2","57","2023-01-02"
"33373","2022","COM","2020","581","9","590","2023-01-02"
"33374","2022","COM","2020","846","11","857","2023-01-02"
"33375","2022","COM","2020","376","8","384","2023-01-02"
"33376","2022","COM","2020","7574","215","7789","2023-01-02"
"33377","2022","COM","2020","78","3","81","2023-01-02"
"33378","2022","COM","2020","1485","21","1506","2023-01-02"
"33379","2022","COM","2020","314","1","315","2023-01-02"
"33380","2022","COM","2020","1786","23","1809","2023-01-02"
"33381","2022","COM","2020","3419","48","3467","2023-01-02"
"33382","2022","COM","2020","1870","29","1899","2023-01-02"
"33383","2022","COM","2020","277","3","280","2023-01-02"
"33384","2022","COM","2020","406","7","413","2023-01-02"
"33385","2022","COM","2020","615","5","620","2023-01-02"
"33386","2022","COM","2020","192","6","198","2023-01-02"
"33387","2022","COM","2020","1502","24","1526","2023-01-02"
"33388","2022","COM","2020","759","16","775","2023-01-02"
"33389","2022","COM","2020","3029","42","3071","2023-01-02"
"33390","2022","COM","2020","423","8","431","2023-01-02"
"33391","2022","COM","2020","335","4","339","2023-01-02"
"33392","2022","COM","2020","848","16","864","2023-01-02"
"33393","2022","COM","2020","5791","71","5862","2023-01-02"
"33394","2022","COM","2020","1844","45","1889","2023-01-02"
"33395","2022","COM","2020","1604","37","1641","2023-01-02"
"33396","2022","COM","2020","190","4","194","2023-01-02"
"33397","2022","COM","2020","4932","85","5017","2023-01-02"
"33398","2022","COM","2020","169","2","171","2023-01-02"
"33399","2022","COM","2020","290","7","297","2023-01-02"
"33400","2022","COM","2020","340","5","345","2023-01-02"
"33401","2022","COM","2020","149","2","151","2023-01-02"
"33402","2022","COM","2020","2665","32","2697","2023-01-02"
"33403","2022","COM","2020","136","3","139","2023-01-02"
"33404","2022","COM","2020","192","3","195","2023-01-02"
"33405","2022","COM","2020","499","12","511","2023-01-02"
"33406","2022","COM","2020","373","7","380","2023-01-02"
"33407","2022","COM","2020","889","18","907","2023-01-02"
"33408","2022","COM","2020","390","17","407","2023-01-02"
"33409","2022","COM","2020","86","1","87","2023-01-02"
"33411","2022","COM","2020","152","4","156","2023-01-02"
"33412","2022","COM","2020","1286","13","1299","2023-01-02"
"33413","2022","COM","2020","2259","36","2295","2023-01-02"
"33414","2022","COM","2020","393","3","396","2023-01-02"
"33415","2022","COM","2020","1919","20","1939","2023-01-02"
"33416","2022","COM","2020","940","10","950","2023-01-02"
"33417","2022","COM","2020","2939","46","2985","2023-01-02"
"33418","2022","COM","2020","376","8","384","2023-01-02"
"33419","2022","COM","2020","81","0","81","2023-01-02"
"33420","2022","COM","2020","133","1","134","2023-01-02"
"33421","2022","COM","2020","459","5","464","2023-01-02"
"33422","2022","COM","2020","9106","165","9271","2023-01-02"
"33423","2022","COM","2020","616","0","616","2023-01-02"
"33424","2022","COM","2020","4905","91","4996","2023-01-02"
"33425","2022","COM","2020","1500","28","1528","2023-01-02"
"33426","2022","COM","2020","245","4","249","2023-01-02"
"33427","2022","COM","2020","250","5","255","2023-01-02"
"33428","2022","COM","2020","83","0","83","2023-01-02"
"33429","2022","COM","2020","323","5","328","2023-01-02"
"33431","2022","COM","2020","327","9","336","2023-01-02"
"33432","2022","COM","2020","241","2","243","2023-01-02"
"33433","2022","COM","2020","9953","106","10059","2023-01-02"
"33434","2022","COM","2020","2149","15","2164","2023-01-02"
"33435","2022","COM","2020","2035","102","2137","2023-01-02"
"33436","2022","COM","2020","1109","12","1121","2023-01-02"
"33437","2022","COM","2020","2030","26","2056","2023-01-02"
"33438","2022","COM","2020","2014","51","2065","2023-01-02"
"33439","2022","COM","2020","1619","17","1636","2023-01-02"
"33440","2022","COM","2020","238","5","243","2023-01-02"
"33441","2022","COM","2020","1160","97","1257","2023-01-02"
"33442","2022","COM","2020","551","7","558","2023-01-02"
"33443","2022","COM","2020","155","3","158","2023-01-02"
"33444","2022","COM","2020","571","10","581","2023-01-02"
"33445","2022","COM","2020","835","17","852","2023-01-02"
"33446","2022","COM","2020","164","1","165","2023-01-02"
"33447","2022","COM","2020","2386","20","2406","2023-01-02"
"33448","2022","COM","2020","3156","40","3196","2023-01-02"
"33449","2022","COM","2020","32357","509","32866","2023-01-02"
"33450","2022","COM","2020","245","3","248","2023-01-02"
"33451","2022","COM","2020","528","4","532","2023-01-02"
"33452","2022","COM","2020","864","14","878","2023-01-02"
"33453","2022","COM","2020","217","4","221","2023-01-02"
"33454","2022","COM","2020","1755","43","1798","2023-01-02"
"33456","2022","COM","2020","499","7","506","2023-01-02"
"33457","2022","COM","2020","610","9","619","2023-01-02"
"33458","2022","COM","2020","996","20","1016","2023-01-02"
"33459","2022","COM","2020","185","3","188","2023-01-02"
"33460","2022","COM","2020","603","12","615","2023-01-02"
"33461","2022","COM","2020","376","5","381","2023-01-02"
"33462","2022","COM","2020","502","9","511","2023-01-02"
"33463","2022","COM","2020","1312","20","1332","2023-01-02"
"33464","2022","COM","2020","288","7","295","2023-01-02"
"33465","2022","COM","2020","1236","21","1257","2023-01-02"
"33466","2022","COM","2020","2620","32","2652","2023-01-02"
"33467","2022","COM","2020","235","4","239","2023-01-02"
"33468","2022","COM","2020","434","9","443","2023-01-02"
"33470","2022","COM","2020","897","15","912","2023-01-02"
"33471","2022","COM","2020","1265","27","1292","2023-01-02"
"33472","2022","COM","2020","366","6","372","2023-01-02"
"33473","2022","COM","2020","3313","39","3352","2023-01-02"
"33474","2022","COM","2020","3488","48","3536","2023-01-02"
"33475","2022","COM","2020","408","6","414","2023-01-02"
"33476","2022","COM","2020","700","12","712","2023-01-02"
"33477","2022","COM","2020","766","13","779","2023-01-02"
"33478","2022","COM","2020","3134","21","3155","2023-01-02"
"33479","2022","COM","2020","249","2","251","2023-01-02"
"33480","2022","COM","2020","1304","28","1332","2023-01-02"
"33481","2022","COM","2020","233","3","236","2023-01-02"
"33482","2022","COM","2020","262","3","265","2023-01-02"
"33483","2022","COM","2020","4848","68","4916","2023-01-02"
"33484","2022","COM","2020","1819","31","1850","2023-01-02"
"33485","2022","COM","2020","1904","31","1935","2023-01-02"
"33486","2022","COM","2020","364","8","372","2023-01-02"
"33487","2022","COM","2020","978","7","985","2023-01-02"
"33488","2022","COM","2020","342","12","354","2023-01-02"
"33489","2022","COM","2020","363","5","368","2023-01-02"
"33490","2022","COM","2020","1795","24","1819","2023-01-02"
"33491","2022","COM","2020","395","5","400","2023-01-02"
"33492","2022","COM","2020","2478","30","2508","2023-01-02"
"33493","2022","COM","2020","345","24","369","2023-01-02"
"33494","2022","COM","2020","1211","11","1222","2023-01-02"
"33496","2022","COM","2020","2710","41","2751","2023-01-02"
"33498","2022","COM","2020","7646","118","7764","2023-01-02"
"33499","2022","COM","2020","327","8","335","2023-01-02"
"33500","2022","COM","2020","443","4","447","2023-01-02"
"33501","2022","COM","2020","3355","60","3415","2023-01-02"
"33502","2022","COM","2020","493","6","499","2023-01-02"
"33503","2022","COM","2020","531","8","539","2023-01-02"
"33504","2022","COM","2020","824","10","834","2023-01-02"
"33505","2022","COM","2020","1573","54","1627","2023-01-02"
"33506","2022","COM","2020","1858","19","1877","2023-01-02"
"33507","2022","COM","2020","324","11","335","2023-01-02"
"33508","2022","COM","2020","630","13","643","2023-01-02"
"33509","2022","COM","2020","535","1","536","2023-01-02"
"33510","2022","COM","2020","220","1","221","2023-01-02"
"33511","2022","COM","2020","342","6","348","2023-01-02"
"33512","2022","COM","2020","353","8","361","2023-01-02"
"33513","2022","COM","2020","121","0","121","2023-01-02"
"33514","2022","COM","2020","2833","27","2860","2023-01-02"
"33515","2022","COM","2020","419","6","425","2023-01-02"
"33516","2022","COM","2020","193","4","197","2023-01-02"
"33517","2022","COM","2020","1673","23","1696","2023-01-02"
"33518","2022","COM","2020","1082","23","1105","2023-01-02"
"33519","2022","COM","2020","10416","147","10563","2023-01-02"
"33520","2022","COM","2020","277","3","280","2023-01-02"
"33521","2022","COM","2020","761","10","771","2023-01-02"
"33522","2022","COM","2020","44359","996","45355","2023-01-02"
"33523","2022","COM","2020","2043","24","2067","2023-01-02"
"33524","2022","COM","2020","324","3","327","2023-01-02"
"33525","2022","COM","2020","1304","24","1328","2023-01-02"
"33526","2022","COM","2020","131","1","132","2023-01-02"
"33527","2022","COM","2020","8794","186","8980","2023-01-02"
"33528","2022","COM","2020","642","7","649","2023-01-02"
"33529","2022","COM","2020","26269","379","26648","2023-01-02"
"33530","2022","COM","2020","877","9","886","2023-01-02"
"33531","2022","COM","2020","356","6","362","2023-01-02"
"33532","2022","COM","2020","471","9","480","2023-01-02"
"33533","2022","COM","2020","2779","26","2805","2023-01-02"
"33534","2022","COM","2020","813","11","824","2023-01-02"
"33535","2022","COM","2020","4981","56","5037","2023-01-02"
"33536","2022","COM","2020","260","4","264","2023-01-02"
"33537","2022","COM","2020","466","10","476","2023-01-02"
"33538","2022","COM","2020","540","10","550","2023-01-02"
"33539","2022","COM","2020","4177","54","4231","2023-01-02"
"33540","2022","COM","2020","2548","35","2583","2023-01-02"
"33541","2022","COM","2020","1043","18","1061","2023-01-02"
"33542","2022","COM","2020","954","14","968","2023-01-02"
"33543","2022","COM","2020","1031","11","1042","2023-01-02"
"33544","2022","COM","2020","1323","12","1335","2023-01-02"
"33545","2022","COM","2020","1308","22","1330","2023-01-02"
"33546","2022","COM","2020","498","12","510","2023-01-02"
"33547","2022","COM","2020","1125","25","1150","2023-01-02"
"33548","2022","COM","2020","1287","25","1312","2023-01-02"
"33549","2022","COM","2020","363","6","369","2023-01-02"
"33550","2022","COM","2020","38444","252","38696","2023-01-02"
"33551","2022","COM","2020","403","6","409","2023-01-02"
"33552","2022","COM","2020","1101","14","1115","2023-01-02"
"33553","2022","COM","2020","1262","6","1268","2023-01-02"
"33554","2022","COM","2020","2860","34","2894","2023-01-02"
"33555","2022","COM","2020","5123","83","5206","2023-01-02"
"34001","2022","COM","2020","1805","24","1829","2023-01-02"
"34002","2022","COM","2020","1303","26","1329","2023-01-02"
"34003","2022","COM","2020","29201","388","29589","2023-01-02"
"34004","2022","COM","2020","244","4","248","2023-01-02"
"34005","2022","COM","2020","295","9","304","2023-01-02"
"34006","2022","COM","2020","272","7","279","2023-01-02"
"34007","2022","COM","2020","468","5","473","2023-01-02"
"34008","2022","COM","2020","610","11","621","2023-01-02"
"34009","2022","COM","2020","1764","26","1790","2023-01-02"
"34010","2022","COM","2020","2939","38","2977","2023-01-02"
"34011","2022","COM","2020","108","4","112","2023-01-02"
"34012","2022","COM","2020","970","25","995","2023-01-02"
"34013","2022","COM","2020","1670","24","1694","2023-01-02"
"34014","2022","COM","2020","1483","43","1526","2023-01-02"
"34015","2022","COM","2020","157","3","160","2023-01-02"
"34016","2022","COM","2020","552","19","571","2023-01-02"
"34017","2022","COM","2020","499","16","515","2023-01-02"
"34018","2022","COM","2020","922","15","937","2023-01-02"
"34019","2022","COM","2020","282","9","291","2023-01-02"
"34020","2022","COM","2020","358","12","370","2023-01-02"
"34021","2022","COM","2020","301","6","307","2023-01-02"
"34022","2022","COM","2020","7600","102","7702","2023-01-02"
"34023","2022","COM","2020","7115","92","7207","2023-01-02"
"34024","2022","COM","2020","2689","42","2731","2023-01-02"
"34025","2022","COM","2020","2221","31","2252","2023-01-02"
"34026","2022","COM","2020","220","2","222","2023-01-02"
"34027","2022","COM","2020","2176","49","2225","2023-01-02"
"34028","2022","COM","2020","5736","216","5952","2023-01-02"
"34029","2022","COM","2020","675","7","682","2023-01-02"
"34030","2022","COM","2020","215","0","215","2023-01-02"
"34031","2022","COM","2020","5365","80","5445","2023-01-02"
"34032","2022","COM","2020","78683","1190","79873","2023-01-02"
"34033","2022","COM","2020","2113","43","2156","2023-01-02"
"34034","2022","COM","2020","39","1","40","2023-01-02"
"34035","2022","COM","2020","1038","19","1057","2023-01-02"
"34036","2022","COM","2020","1371","24","1395","2023-01-02"
"34037","2022","COM","2020","3369","57","3426","2023-01-02"
"34038","2022","COM","2020","1584","24","1608","2023-01-02"
"34039","2022","COM","2020","1633","22","1655","2023-01-02"
"34040","2022","COM","2020","55","0","55","2023-01-02"
"34041","2022","COM","2020","961","17","978","2023-01-02"
"34042","2022","COM","2020","601","14","615","2023-01-02"
"34043","2022","COM","2020","363","5","368","2023-01-02"
"34044","2022","COM","2020","339","10","349","2023-01-02"
"34045","2022","COM","2020","549","18","567","2023-01-02"
"34046","2022","COM","2020","50","0","50","2023-01-02"
"34047","2022","COM","2020","714","10","724","2023-01-02"
"34048","2022","COM","2020","303","5","308","2023-01-02"
"34049","2022","COM","2020","227","6","233","2023-01-02"
"34050","2022","COM","2020","2003","26","2029","2023-01-02"
"34051","2022","COM","2020","3540","74","3614","2023-01-02"
"34052","2022","COM","2020","3298","58","3356","2023-01-02"
"34053","2022","COM","2020","126","0","126","2023-01-02"
"34054","2022","COM","2020","110","1","111","2023-01-02"
"34055","2022","COM","2020","218","3","221","2023-01-02"
"34056","2022","COM","2020","1231","14","1245","2023-01-02"
"34057","2022","COM","2020","23469","406","23875","2023-01-02"
"34058","2022","COM","2020","6423","106","6529","2023-01-02"
"34059","2022","COM","2020","317","6","323","2023-01-02"
"34060","2022","COM","2020","416","7","423","2023-01-02"
"34061","2022","COM","2020","627","10","637","2023-01-02"
"34062","2022","COM","2020","156","1","157","2023-01-02"
"34063","2022","COM","2020","2589","35","2624","2023-01-02"
"34064","2022","COM","2020","465","15","480","2023-01-02"
"34065","2022","COM","2020","619","11","630","2023-01-02"
"34066","2022","COM","2020","230","3","233","2023-01-02"
"34067","2022","COM","2020","1554","40","1594","2023-01-02"
"34068","2022","COM","2020","409","9","418","2023-01-02"
"34069","2022","COM","2020","5124","96","5220","2023-01-02"
"34070","2022","COM","2020","632","12","644","2023-01-02"
"34071","2022","COM","2020","302","6","308","2023-01-02"
"34072","2022","COM","2020","30","1","31","2023-01-02"
"34073","2022","COM","2020","2557","50","2607","2023-01-02"
"34074","2022","COM","2020","2358","50","2408","2023-01-02"
"34075","2022","COM","2020","420","8","428","2023-01-02"
"34076","2022","COM","2020","1378","26","1404","2023-01-02"
"34077","2022","COM","2020","5613","88","5701","2023-01-02"
"34078","2022","COM","2020","1692","38","1730","2023-01-02"
"34079","2022","COM","2020","9126","159","9285","2023-01-02"
"34080","2022","COM","2020","480","14","494","2023-01-02"
"34081","2022","COM","2020","2680","44","2724","2023-01-02"
"34082","2022","COM","2020","1869","44","1913","2023-01-02"
"34083","2022","COM","2020","322","3","325","2023-01-02"
"34084","2022","COM","2020","1694","28","1722","2023-01-02"
"34085","2022","COM","2020","359","9","368","2023-01-02"
"34086","2022","COM","2020","619","13","632","2023-01-02"
"34087","2022","COM","2020","3517","32","3549","2023-01-02"
"34088","2022","COM","2020","6490","78","6568","2023-01-02"
"34089","2022","COM","2020","1345","27","1372","2023-01-02"
"34090","2022","COM","2020","9305","135","9440","2023-01-02"
"34091","2022","COM","2020","56","0","56","2023-01-02"
"34092","2022","COM","2020","960","15","975","2023-01-02"
"34093","2022","COM","2020","147","3","150","2023-01-02"
"34094","2022","COM","2020","1147","24","1171","2023-01-02"
"34095","2022","COM","2020","7194","83","7277","2023-01-02"
"34096","2022","COM","2020","550","8","558","2023-01-02"
"34097","2022","COM","2020","484","8","492","2023-01-02"
"34098","2022","COM","2020","151","5","156","2023-01-02"
"34099","2022","COM","2020","47","1","48","2023-01-02"
"34100","2022","COM","2020","52","4","56","2023-01-02"
"34101","2022","COM","2020","5035","81","5116","2023-01-02"
"34102","2022","COM","2020","350","9","359","2023-01-02"
"34103","2022","COM","2020","1052","19","1071","2023-01-02"
"34104","2022","COM","2020","128","1","129","2023-01-02"
"34105","2022","COM","2020","251","7","258","2023-01-02"
"34106","2022","COM","2020","186","9","195","2023-01-02"
"34107","2022","COM","2020","338","3","341","2023-01-02"
"34108","2022","COM","2020","23485","220","23705","2023-01-02"
"34109","2022","COM","2020","845","18","863","2023-01-02"
"34110","2022","COM","2020","743","27","770","2023-01-02"
"34111","2022","COM","2020","4114","102","4216","2023-01-02"
"34112","2022","COM","2020","222","5","227","2023-01-02"
"34113","2022","COM","2020","6563","79","6642","2023-01-02"
"34114","2022","COM","2020","6609","116","6725","2023-01-02"
"34115","2022","COM","2020","113","0","113","2023-01-02"
"34116","2022","COM","2020","8885","96","8981","2023-01-02"
"34117","2022","COM","2020","585","10","595","2023-01-02"
"34118","2022","COM","2020","498","12","510","2023-01-02"
"34119","2022","COM","2020","1526","25","1551","2023-01-02"
"34120","2022","COM","2020","6794","102","6896","2023-01-02"
"34121","2022","COM","2020","271","14","285","2023-01-02"
"34122","2022","COM","2020","554","7","561","2023-01-02"
"34123","2022","COM","2020","12104","99","12203","2023-01-02"
"34124","2022","COM","2020","306","10","316","2023-01-02"
"34125","2022","COM","2020","111","4","115","2023-01-02"
"34126","2022","COM","2020","2483","18","2501","2023-01-02"
"34127","2022","COM","2020","3096","43","3139","2023-01-02"
"34128","2022","COM","2020","1640","32","1672","2023-01-02"
"34129","2022","COM","2020","17674","235","17909","2023-01-02"
"34130","2022","COM","2020","1776","29","1805","2023-01-02"
"34131","2022","COM","2020","632","20","652","2023-01-02"
"34132","2022","COM","2020","204","2","206","2023-01-02"
"34133","2022","COM","2020","54","0","54","2023-01-02"
"34134","2022","COM","2020","3330","52","3382","2023-01-02"
"34135","2022","COM","2020","3318","53","3371","2023-01-02"
"34136","2022","COM","2020","1567","27","1594","2023-01-02"
"34137","2022","COM","2020","149","7","156","2023-01-02"
"34138","2022","COM","2020","335","7","342","2023-01-02"
"34139","2022","COM","2020","1380","39","1419","2023-01-02"
"34140","2022","COM","2020","3221","54","3275","2023-01-02"
"34141","2022","COM","2020","521","8","529","2023-01-02"
"34142","2022","COM","2020","7382","236","7618","2023-01-02"
"34143","2022","COM","2020","2206","39","2245","2023-01-02"
"34144","2022","COM","2020","668","21","689","2023-01-02"
"34145","2022","COM","2020","26356","270","26626","2023-01-02"
"34146","2022","COM","2020","4484","46","4530","2023-01-02"
"34147","2022","COM","2020","3424","66","3490","2023-01-02"
"34148","2022","COM","2020","4650","77","4727","2023-01-02"
"34149","2022","COM","2020","724","2","726","2023-01-02"
"34150","2022","COM","2020","7692","105","7797","2023-01-02"
"34151","2022","COM","2020","6395","77","6472","2023-01-02"
"34152","2022","COM","2020","672","10","682","2023-01-02"
"34153","2022","COM","2020","2026","50","2076","2023-01-02"
"34154","2022","COM","2020","16714","198","16912","2023-01-02"
"34155","2022","COM","2020","2342","47","2389","2023-01-02"
"34156","2022","COM","2020","47","3","50","2023-01-02"
"34157","2022","COM","2020","12385","164","12549","2023-01-02"
"34158","2022","COM","2020","101","1","102","2023-01-02"
"34159","2022","COM","2020","3304","51","3355","2023-01-02"
"34160","2022","COM","2020","650","17","667","2023-01-02"
"34161","2022","COM","2020","3990","73","4063","2023-01-02"
"34162","2022","COM","2020","4318","60","4378","2023-01-02"
"34163","2022","COM","2020","4145","49","4194","2023-01-02"
"34164","2022","COM","2020","1039","12","1051","2023-01-02"
"34165","2022","COM","2020","2933","59","2992","2023-01-02"
"34166","2022","COM","2020","2868","51","2919","2023-01-02"
"34167","2022","COM","2020","249","4","253","2023-01-02"
"34168","2022","COM","2020","75","0","75","2023-01-02"
"34169","2022","COM","2020","4014","164","4178","2023-01-02"
"34170","2022","COM","2020","211","5","216","2023-01-02"
"34171","2022","COM","2020","173","4","177","2023-01-02"
"34172","2022","COM","2020","299096","3329","302425","2023-01-02"
"34173","2022","COM","2020","1374","24","1398","2023-01-02"
"34174","2022","COM","2020","861","26","887","2023-01-02"
"34175","2022","COM","2020","215","5","220","2023-01-02"
"34176","2022","COM","2020","2825","31","2856","2023-01-02"
"34177","2022","COM","2020","343","11","354","2023-01-02"
"34178","2022","COM","2020","3112","55","3167","2023-01-02"
"34179","2022","COM","2020","1856","29","1885","2023-01-02"
"34180","2022","COM","2020","1451","24","1475","2023-01-02"
"34181","2022","COM","2020","1030","25","1055","2023-01-02"
"34182","2022","COM","2020","1795","33","1828","2023-01-02"
"34183","2022","COM","2020","4020","74","4094","2023-01-02"
"34184","2022","COM","2020","669","15","684","2023-01-02"
"34185","2022","COM","2020","522","12","534","2023-01-02"
"34186","2022","COM","2020","520","12","532","2023-01-02"
"34187","2022","COM","2020","608","10","618","2023-01-02"
"34188","2022","COM","2020","187","4","191","2023-01-02"
"34189","2022","COM","2020","1684","19","1703","2023-01-02"
"34190","2022","COM","2020","250","7","257","2023-01-02"
"34191","2022","COM","2020","571","12","583","2023-01-02"
"34192","2022","COM","2020","5748","37","5785","2023-01-02"
"34193","2022","COM","2020","174","6","180","2023-01-02"
"34194","2022","COM","2020","4024","52","4076","2023-01-02"
"34195","2022","COM","2020","56","1","57","2023-01-02"
"34196","2022","COM","2020","156","4","160","2023-01-02"
"34197","2022","COM","2020","1070","16","1086","2023-01-02"
"34198","2022","COM","2020","9438","124","9562","2023-01-02"
"34199","2022","COM","2020","7857","253","8110","2023-01-02"
"34200","2022","COM","2020","234","10","244","2023-01-02"
"34201","2022","COM","2020","292","7","299","2023-01-02"
"34202","2022","COM","2020","8218","115","8333","2023-01-02"
"34203","2022","COM","2020","1987","24","2011","2023-01-02"
"34204","2022","COM","2020","1482","19","1501","2023-01-02"
"34205","2022","COM","2020","293","7","300","2023-01-02"
"34206","2022","COM","2020","537","11","548","2023-01-02"
"34207","2022","COM","2020","2151","43","2194","2023-01-02"
"34208","2022","COM","2020","356","15","371","2023-01-02"
"34209","2022","COM","2020","3090","64","3154","2023-01-02"
"34210","2022","COM","2020","2096","47","2143","2023-01-02"
"34211","2022","COM","2020","970","33","1003","2023-01-02"
"34212","2022","COM","2020","181","5","186","2023-01-02"
"34213","2022","COM","2020","6008","79","6087","2023-01-02"
"34214","2022","COM","2020","1173","18","1191","2023-01-02"
"34215","2022","COM","2020","958","13","971","2023-01-02"
"34216","2022","COM","2020","331","5","336","2023-01-02"
"34217","2022","COM","2020","6007","104","6111","2023-01-02"
"34218","2022","COM","2020","328","6","334","2023-01-02"
"34219","2022","COM","2020","499","9","508","2023-01-02"
"34220","2022","COM","2020","255","5","260","2023-01-02"
"34221","2022","COM","2020","506","11","517","2023-01-02"
"34222","2022","COM","2020","635","13","648","2023-01-02"
"34223","2022","COM","2020","1174","19","1193","2023-01-02"
"34224","2022","COM","2020","1349","19","1368","2023-01-02"
"34225","2022","COM","2020","3026","47","3073","2023-01-02"
"34226","2022","COM","2020","1804","26","1830","2023-01-02"
"34227","2022","COM","2020","2183","30","2213","2023-01-02"
"34228","2022","COM","2020","82","5","87","2023-01-02"
"34229","2022","COM","2020","725","25","750","2023-01-02"
"34230","2022","COM","2020","147","4","151","2023-01-02"
"34231","2022","COM","2020","21","2","23","2023-01-02"
"34232","2022","COM","2020","606","11","617","2023-01-02"
"34233","2022","COM","2020","210","3","213","2023-01-02"
"34234","2022","COM","2020","94","1","95","2023-01-02"
"34235","2022","COM","2020","269","6","275","2023-01-02"
"34236","2022","COM","2020","68","0","68","2023-01-02"
"34237","2022","COM","2020","2223","40","2263","2023-01-02"
"34238","2022","COM","2020","40","0","40","2023-01-02"
"34239","2022","COM","2020","6334","107","6441","2023-01-02"
"34240","2022","COM","2020","4026","35","4061","2023-01-02"
"34241","2022","COM","2020","903","14","917","2023-01-02"
"34242","2022","COM","2020","1147","27","1174","2023-01-02"
"34243","2022","COM","2020","2014","31","2045","2023-01-02"
"34244","2022","COM","2020","3293","41","3334","2023-01-02"
"34245","2022","COM","2020","1704","34","1738","2023-01-02"
"34246","2022","COM","2020","2133","37","2170","2023-01-02"
"34247","2022","COM","2020","5048","246","5294","2023-01-02"
"34248","2022","COM","2020","950","17","967","2023-01-02"
"34249","2022","COM","2020","2839","62","2901","2023-01-02"
"34250","2022","COM","2020","299","7","306","2023-01-02"
"34251","2022","COM","2020","523","14","537","2023-01-02"
"34252","2022","COM","2020","254","6","260","2023-01-02"
"34253","2022","COM","2020","33","1","34","2023-01-02"
"34254","2022","COM","2020","1156","31","1187","2023-01-02"
"34255","2022","COM","2020","10397","273","10670","2023-01-02"
"34256","2022","COM","2020","2041","34","2075","2023-01-02"
"34257","2022","COM","2020","216","2","218","2023-01-02"
"34258","2022","COM","2020","1676","28","1704","2023-01-02"
"34259","2022","COM","2020","5628","69","5697","2023-01-02"
"34260","2022","COM","2020","849","13","862","2023-01-02"
"34261","2022","COM","2020","243","8","251","2023-01-02"
"34262","2022","COM","2020","259","0","259","2023-01-02"
"34263","2022","COM","2020","439","3","442","2023-01-02"
"34264","2022","COM","2020","208","0","208","2023-01-02"
"34265","2022","COM","2020","780","15","795","2023-01-02"
"34266","2022","COM","2020","514","7","521","2023-01-02"
"34267","2022","COM","2020","1742","34","1776","2023-01-02"
"34268","2022","COM","2020","654","18","672","2023-01-02"
"34269","2022","COM","2020","141","3","144","2023-01-02"
"34270","2022","COM","2020","11843","141","11984","2023-01-02"
"34271","2022","COM","2020","216","3","219","2023-01-02"
"34272","2022","COM","2020","3290","30","3320","2023-01-02"
"34273","2022","COM","2020","129","0","129","2023-01-02"
"34274","2022","COM","2020","2791","26","2817","2023-01-02"
"34276","2022","COM","2020","4893","96","4989","2023-01-02"
"34277","2022","COM","2020","184","6","190","2023-01-02"
"34278","2022","COM","2020","57","0","57","2023-01-02"
"34279","2022","COM","2020","322","3","325","2023-01-02"
"34280","2022","COM","2020","610","8","618","2023-01-02"
"34281","2022","COM","2020","2356","37","2393","2023-01-02"
"34282","2022","COM","2020","1310","20","1330","2023-01-02"
"34283","2022","COM","2020","131","2","133","2023-01-02"
"34284","2022","COM","2020","1749","190","1939","2023-01-02"
"34285","2022","COM","2020","638","11","649","2023-01-02"
"34286","2022","COM","2020","418","14","432","2023-01-02"
"34287","2022","COM","2020","262","6","268","2023-01-02"
"34288","2022","COM","2020","973","22","995","2023-01-02"
"34289","2022","COM","2020","2875","38","2913","2023-01-02"
"34290","2022","COM","2020","742","11","753","2023-01-02"
"34291","2022","COM","2020","358","5","363","2023-01-02"
"34292","2022","COM","2020","310","6","316","2023-01-02"
"34293","2022","COM","2020","1128","20","1148","2023-01-02"
"34294","2022","COM","2020","1022","20","1042","2023-01-02"
"34295","2022","COM","2020","1640","33","1673","2023-01-02"
"34296","2022","COM","2020","989","22","1011","2023-01-02"
"34297","2022","COM","2020","428","8","436","2023-01-02"
"34298","2022","COM","2020","5483","97","5580","2023-01-02"
"34299","2022","COM","2020","7809","176","7985","2023-01-02"
"34300","2022","COM","2020","5301","94","5395","2023-01-02"
"34301","2022","COM","2020","44576","599","45175","2023-01-02"
"34302","2022","COM","2020","748","6","754","2023-01-02"
"34303","2022","COM","2020","39","1","40","2023-01-02"
"34304","2022","COM","2020","932","29","961","2023-01-02"
"34305","2022","COM","2020","124","0","124","2023-01-02"
"34306","2022","COM","2020","200","0","200","2023-01-02"
"34307","2022","COM","2020","2818","57","2875","2023-01-02"
"34308","2022","COM","2020","455","13","468","2023-01-02"
"34309","2022","COM","2020","4640","81","4721","2023-01-02"
"34310","2022","COM","2020","3040","76","3116","2023-01-02"
"34311","2022","COM","2020","1782","158","1940","2023-01-02"
"34312","2022","COM","2020","1301","24","1325","2023-01-02"
"34313","2022","COM","2020","685","24","709","2023-01-02"
"34314","2022","COM","2020","633","14","647","2023-01-02"
"34315","2022","COM","2020","437","5","442","2023-01-02"
"34316","2022","COM","2020","236","2","238","2023-01-02"
"34317","2022","COM","2020","187","7","194","2023-01-02"
"34318","2022","COM","2020","735","12","747","2023-01-02"
"34319","2022","COM","2020","148","1","149","2023-01-02"
"34320","2022","COM","2020","2609","54","2663","2023-01-02"
"34321","2022","COM","2020","2049","27","2076","2023-01-02"
"34322","2022","COM","2020","775","14","789","2023-01-02"
"34323","2022","COM","2020","46","0","46","2023-01-02"
"34324","2022","COM","2020","4188","63","4251","2023-01-02"
"34325","2022","COM","2020","1643","32","1675","2023-01-02"
"34326","2022","COM","2020","93","0","93","2023-01-02"
"34327","2022","COM","2020","6771","86","6857","2023-01-02"
"34328","2022","COM","2020","1154","25","1179","2023-01-02"
"34329","2022","COM","2020","2728","78","2806","2023-01-02"
"34331","2022","COM","2020","95","2","97","2023-01-02"
"34332","2022","COM","2020","5804","77","5881","2023-01-02"
"34333","2022","COM","2020","3429","30","3459","2023-01-02"
"34334","2022","COM","2020","270","0","270","2023-01-02"
"34335","2022","COM","2020","424","13","437","2023-01-02"
"34336","2022","COM","2020","4099","54","4153","2023-01-02"
"34337","2022","COM","2020","10463","119","10582","2023-01-02"
"34338","2022","COM","2020","68","3","71","2023-01-02"
"34339","2022","COM","2020","178","5","183","2023-01-02"
"34340","2022","COM","2020","1558","46","1604","2023-01-02"
"34341","2022","COM","2020","3909","69","3978","2023-01-02"
"34342","2022","COM","2020","212","4","216","2023-01-02"
"34343","2022","COM","2020","1242","29","1271","2023-01-02"
"34344","2022","COM","2020","8638","83","8721","2023-01-02"
"35001","2022","COM","2020","6865","164","7029","2023-01-02"
"35002","2022","COM","2020","1759","35","1794","2023-01-02"
"35003","2022","COM","2020","976","8","984","2023-01-02"
"35004","2022","COM","2020","4119","87","4206","2023-01-02"
"35005","2022","COM","2020","299","6","305","2023-01-02"
"35006","2022","COM","2020","4533","129","4662","2023-01-02"
"35007","2022","COM","2020","489","2","491","2023-01-02"
"35008","2022","COM","2020","671","18","689","2023-01-02"
"35009","2022","COM","2020","1702","26","1728","2023-01-02"
"35010","2022","COM","2020","1779","16","1795","2023-01-02"
"35012","2022","COM","2020","7435","148","7583","2023-01-02"
"35013","2022","COM","2020","3500","162","3662","2023-01-02"
"35014","2022","COM","2020","2466","32","2498","2023-01-02"
"35015","2022","COM","2020","2224","48","2272","2023-01-02"
"35016","2022","COM","2020","2191","60","2251","2023-01-02"
"35017","2022","COM","2020","675","9","684","2023-01-02"
"35018","2022","COM","2020","1067","21","1088","2023-01-02"
"35019","2022","COM","2020","1860","32","1892","2023-01-02"
"35021","2022","COM","2020","1355","35","1390","2023-01-02"
"35022","2022","COM","2020","698","16","714","2023-01-02"
"35023","2022","COM","2020","4460","73","4533","2023-01-02"
"35024","2022","COM","2020","12637","298","12935","2023-01-02"
"35025","2022","COM","2020","1057","16","1073","2023-01-02"
"35026","2022","COM","2020","101","6","107","2023-01-02"
"35027","2022","COM","2020","1734","35","1769","2023-01-02"
"35028","2022","COM","2020","722","14","736","2023-01-02"
"35029","2022","COM","2020","1526","25","1551","2023-01-02"
"35030","2022","COM","2020","690","17","707","2023-01-02"
"35031","2022","COM","2020","4546","105","4651","2023-01-02"
"35032","2022","COM","2020","4579","65","4644","2023-01-02"
"35033","2022","COM","2020","3327","63","3390","2023-01-02"
"35034","2022","COM","2020","1215","22","1237","2023-01-02"
"35035","2022","COM","2020","595","10","605","2023-01-02"
"35037","2022","COM","2020","6506","83","6589","2023-01-02"
"35038","2022","COM","2020","626","21","647","2023-01-02"
"35039","2022","COM","2020","2040","43","2083","2023-01-02"
"35040","2022","COM","2020","3632","79","3711","2023-01-02"
"35041","2022","COM","2020","1010","20","1030","2023-01-02"
"35042","2022","COM","2020","666","30","696","2023-01-02"
"35044","2022","COM","2020","391","5","396","2023-01-02"
"35045","2022","COM","2020","862","16","878","2023-01-02"
"35046","2022","COM","2020","534","8","542","2023-01-02"
"35047","2022","COM","2020","19090","471","19561","2023-01-02"
"35049","2022","COM","2020","5313","92","5405","2023-01-02"
"35050","2022","COM","2020","602","9","611","2023-01-02"
"35051","2022","COM","2020","17316","483","17799","2023-01-02"
"35052","2022","COM","2020","511","11","522","2023-01-02"
"35054","2022","COM","2020","1847","47","1894","2023-01-02"
"35055","2022","COM","2020","10236","175","10411","2023-01-02"
"35056","2022","COM","2020","818","22","840","2023-01-02"
"35057","2022","COM","2020","1505","25","1530","2023-01-02"
"35058","2022","COM","2020","1302","15","1317","2023-01-02"
"35059","2022","COM","2020","4628","94","4722","2023-01-02"
"35060","2022","COM","2020","1017","19","1036","2023-01-02"
"35061","2022","COM","2020","722","16","738","2023-01-02"
"35062","2022","COM","2020","1483","27","1510","2023-01-02"
"35063","2022","COM","2020","455","7","462","2023-01-02"
"35064","2022","COM","2020","1023","13","1036","2023-01-02"
"35065","2022","COM","2020","2244","43","2287","2023-01-02"
"35066","2022","COM","2020","8190","137","8327","2023-01-02"
"35067","2022","COM","2020","1628","28","1656","2023-01-02"
"35068","2022","COM","2020","7516","157","7673","2023-01-02"
"35069","2022","COM","2020","10541","267","10808","2023-01-02"
"35070","2022","COM","2020","1704","25","1729","2023-01-02"
"35071","2022","COM","2020","433","10","443","2023-01-02"
"35072","2022","COM","2020","1664","36","1700","2023-01-02"
"35075","2022","COM","2020","807","23","830","2023-01-02"
"35076","2022","COM","2020","4268","82","4350","2023-01-02"
"35077","2022","COM","2020","346","10","356","2023-01-02"
"35078","2022","COM","2020","1089","22","1111","2023-01-02"
"35079","2022","COM","2020","2355","53","2408","2023-01-02"
"35080","2022","COM","2020","2476","64","2540","2023-01-02"
"35081","2022","COM","2020","910","30","940","2023-01-02"
"35082","2022","COM","2020","1456","35","1491","2023-01-02"
"35084","2022","COM","2020","689","10","699","2023-01-02"
"35085","2022","COM","2020","6082","124","6206","2023-01-02"
"35086","2022","COM","2020","612","9","621","2023-01-02"
"35087","2022","COM","2020","969","32","1001","2023-01-02"
"35088","2022","COM","2020","3526","55","3581","2023-01-02"
"35089","2022","COM","2020","453","11","464","2023-01-02"
"35090","2022","COM","2020","2838","53","2891","2023-01-02"
"35091","2022","COM","2020","595","7","602","2023-01-02"
"35092","2022","COM","2020","832","14","846","2023-01-02"
"35093","2022","COM","2020","10235","520","10755","2023-01-02"
"35094","2022","COM","2020","1660","28","1688","2023-01-02"
"35095","2022","COM","2020","5761","349","6110","2023-01-02"
"35096","2022","COM","2020","2422","55","2477","2023-01-02"
"35097","2022","COM","2020","2020","50","2070","2023-01-02"
"35098","2022","COM","2020","1397","30","1427","2023-01-02"
"35099","2022","COM","2020","3756","67","3823","2023-01-02"
"35101","2022","COM","2020","1212","22","1234","2023-01-02"
"35102","2022","COM","2020","505","10","515","2023-01-02"
"35103","2022","COM","2020","428","10","438","2023-01-02"
"35104","2022","COM","2020","1426","27","1453","2023-01-02"
"35105","2022","COM","2020","1734","54","1788","2023-01-02"
"35106","2022","COM","2020","1532","21","1553","2023-01-02"
"35107","2022","COM","2020","1965","36","2001","2023-01-02"
"35108","2022","COM","2020","1050","21","1071","2023-01-02"
"35109","2022","COM","2020","2610","67","2677","2023-01-02"
"35110","2022","COM","2020","1026","20","1046","2023-01-02"
"35111","2022","COM","2020","722","6","728","2023-01-02"
"35112","2022","COM","2020","927","26","953","2023-01-02"
"35114","2022","COM","2020","259","6","265","2023-01-02"
"35115","2022","COM","2020","20505","616","21121","2023-01-02"
"35116","2022","COM","2020","2546","51","2597","2023-01-02"
"35117","2022","COM","2020","1620","22","1642","2023-01-02"
"35118","2022","COM","2020","1524","35","1559","2023-01-02"
"35119","2022","COM","2020","943","20","963","2023-01-02"
"35120","2022","COM","2020","5685","111","5796","2023-01-02"
"35121","2022","COM","2020","2025","36","2061","2023-01-02"
"35122","2022","COM","2020","1968","47","2015","2023-01-02"
"35123","2022","COM","2020","4323","87","4410","2023-01-02"
"35124","2022","COM","2020","2455","38","2493","2023-01-02"
"35125","2022","COM","2020","4245","147","4392","2023-01-02"
"35126","2022","COM","2020","8763","205","8968","2023-01-02"
"35127","2022","COM","2020","4027","93","4120","2023-01-02"
"35128","2022","COM","2020","1714","40","1754","2023-01-02"
"35130","2022","COM","2020","2283","52","2335","2023-01-02"
"35131","2022","COM","2020","4647","79","4726","2023-01-02"
"35132","2022","COM","2020","1391","34","1425","2023-01-02"
"35133","2022","COM","2020","4567","100","4667","2023-01-02"
"35134","2022","COM","2020","273","12","285","2023-01-02"
"35135","2022","COM","2020","2263","37","2300","2023-01-02"
"35136","2022","COM","2020","8523","164","8687","2023-01-02"
"35137","2022","COM","2020","2116","71","2187","2023-01-02"
"35138","2022","COM","2020","1190","30","1220","2023-01-02"
"35139","2022","COM","2020","5162","149","5311","2023-01-02"
"35140","2022","COM","2020","557","8","565","2023-01-02"
"35141","2022","COM","2020","691","21","712","2023-01-02"
"35142","2022","COM","2020","1176","22","1198","2023-01-02"
"35143","2022","COM","2020","924","29","953","2023-01-02"
"35144","2022","COM","2020","1064","20","1084","2023-01-02"
"35145","2022","COM","2020","1372","25","1397","2023-01-02"
"35146","2022","COM","2020","610","2","612","2023-01-02"
"35148","2022","COM","2020","159","0","159","2023-01-02"
"35149","2022","COM","2020","1772","40","1812","2023-01-02"
"35150","2022","COM","2020","3279","99","3378","2023-01-02"
"35151","2022","COM","2020","787","19","806","2023-01-02"
"35152","2022","COM","2020","8129","136","8265","2023-01-02"
"35153","2022","COM","2020","370","11","381","2023-01-02"
"35154","2022","COM","2020","1723","42","1765","2023-01-02"
"35155","2022","COM","2020","665","11","676","2023-01-02"
"35156","2022","COM","2020","610","10","620","2023-01-02"
"35157","2022","COM","2020","635","22","657","2023-01-02"
"35159","2022","COM","2020","324","3","327","2023-01-02"
"35160","2022","COM","2020","243","5","248","2023-01-02"
"35161","2022","COM","2020","1900","39","1939","2023-01-02"
"35162","2022","COM","2020","3335","62","3397","2023-01-02"
"35163","2022","COM","2020","1818","30","1848","2023-01-02"
"35164","2022","COM","2020","735","14","749","2023-01-02"
"35165","2022","COM","2020","947","23","970","2023-01-02"
"35166","2022","COM","2020","1022","27","1049","2023-01-02"
"35167","2022","COM","2020","2604","55","2659","2023-01-02"
"35168","2022","COM","2020","3943","82","4025","2023-01-02"
"35169","2022","COM","2020","1467","17","1484","2023-01-02"
"35170","2022","COM","2020","606","14","620","2023-01-02"
"35171","2022","COM","2020","1822","48","1870","2023-01-02"
"35172","2022","COM","2020","1936","23","1959","2023-01-02"
"35173","2022","COM","2020","7111","107","7218","2023-01-02"
"35174","2022","COM","2020","649","12","661","2023-01-02"
"35175","2022","COM","2020","1006","15","1021","2023-01-02"
"35176","2022","COM","2020","7181","142","7323","2023-01-02"
"35177","2022","COM","2020","4935","120","5055","2023-01-02"
"35178","2022","COM","2020","1778","16","1794","2023-01-02"
"35179","2022","COM","2020","4257","83","4340","2023-01-02"
"35180","2022","COM","2020","795","17","812","2023-01-02"
"35181","2022","COM","2020","1488","36","1524","2023-01-02"
"35183","2022","COM","2020","817","21","838","2023-01-02"
"35184","2022","COM","2020","6246","241","6487","2023-01-02"
"35185","2022","COM","2020","267","0","267","2023-01-02"
"35186","2022","COM","2020","1082","30","1112","2023-01-02"
"35187","2022","COM","2020","1334","45","1379","2023-01-02"
"35188","2022","COM","2020","6743","174","6917","2023-01-02"
"35189","2022","COM","2020","3564","66","3630","2023-01-02"
"35190","2022","COM","2020","248","8","256","2023-01-02"
"35191","2022","COM","2020","2283","46","2329","2023-01-02"
"35192","2022","COM","2020","233","5","238","2023-01-02"
"35193","2022","COM","2020","1983","42","2025","2023-01-02"
"35194","2022","COM","2020","1018","46","1064","2023-01-02"
"35195","2022","COM","2020","2419","34","2453","2023-01-02"
"35196","2022","COM","2020","7485","127","7612","2023-01-02"
"35197","2022","COM","2020","1761","19","1780","2023-01-02"
"35198","2022","COM","2020","713","26","739","2023-01-02"
"35199","2022","COM","2020","344","9","353","2023-01-02"
"35200","2022","COM","2020","914","29","943","2023-01-02"
"35201","2022","COM","2020","884","7","891","2023-01-02"
"35202","2022","COM","2020","1017","20","1037","2023-01-02"
"35203","2022","COM","2020","353","5","358","2023-01-02"
"35204","2022","COM","2020","3378","62","3440","2023-01-02"
"35205","2022","COM","2020","376","8","384","2023-01-02"
"35206","2022","COM","2020","7318","135","7453","2023-01-02"
"35207","2022","COM","2020","6131","150","6281","2023-01-02"
"35208","2022","COM","2020","5341","130","5471","2023-01-02"
"35210","2022","COM","2020","12004","354","12358","2023-01-02"
"35211","2022","COM","2020","1784","43","1827","2023-01-02"
"35212","2022","COM","2020","1196","31","1227","2023-01-02"
"35214","2022","COM","2020","650","5","655","2023-01-02"
"35215","2022","COM","2020","1328","43","1371","2023-01-02"
"35216","2022","COM","2020","1794","27","1821","2023-01-02"
"35217","2022","COM","2020","1377","28","1405","2023-01-02"
"35218","2022","COM","2020","885","18","903","2023-01-02"
"35219","2022","COM","2020","3847","76","3923","2023-01-02"
"35220","2022","COM","2020","3096","56","3152","2023-01-02"
"35221","2022","COM","2020","2780","53","2833","2023-01-02"
"35222","2022","COM","2020","1971","30","2001","2023-01-02"
"35223","2022","COM","2020","4030","86","4116","2023-01-02"
"35224","2022","COM","2020","2826","54","2880","2023-01-02"
"35225","2022","COM","2020","780","15","795","2023-01-02"
"35226","2022","COM","2020","1972","38","2010","2023-01-02"
"35227","2022","COM","2020","3499","63","3562","2023-01-02"
"35228","2022","COM","2020","6959","126","7085","2023-01-02"
"35229","2022","COM","2020","1324","53","1377","2023-01-02"
"35230","2022","COM","2020","370","4","374","2023-01-02"
"35231","2022","COM","2020","1212","32","1244","2023-01-02"
"35232","2022","COM","2020","397","6","403","2023-01-02"
"35233","2022","COM","2020","1581","38","1619","2023-01-02"
"35234","2022","COM","2020","1218","25","1243","2023-01-02"
"35235","2022","COM","2020","1073","46","1119","2023-01-02"
"35236","2022","COM","2020","9315","745","10060","2023-01-02"
"35237","2022","COM","2020","1040","23","1063","2023-01-02"
"35238","2022","COM","2020","222485","4169","226654","2023-01-02"
"35239","2022","COM","2020","4503","96","4599","2023-01-02"
"35240","2022","COM","2020","9247","235","9482","2023-01-02"
"35241","2022","COM","2020","2476","88","2564","2023-01-02"
"35242","2022","COM","2020","347","4","351","2023-01-02"
"35243","2022","COM","2020","2446","59","2505","2023-01-02"
"35244","2022","COM","2020","257","5","262","2023-01-02"
"35245","2022","COM","2020","4085","72","4157","2023-01-02"
"35246","2022","COM","2020","1368","29","1397","2023-01-02"
"35247","2022","COM","2020","1000","12","1012","2023-01-02"
"35248","2022","COM","2020","458","8","466","2023-01-02"
"35249","2022","COM","2020","1034","17","1051","2023-01-02"
"35250","2022","COM","2020","2219","40","2259","2023-01-02"
"35251","2022","COM","2020","4085","81","4166","2023-01-02"
"35252","2022","COM","2020","910","34","944","2023-01-02"
"35253","2022","COM","2020","4052","188","4240","2023-01-02"
"35255","2022","COM","2020","972","35","1007","2023-01-02"
"35256","2022","COM","2020","2205","64","2269","2023-01-02"
"35257","2022","COM","2020","5033","93","5126","2023-01-02"
"35258","2022","COM","2020","328","9","337","2023-01-02"
"35259","2022","COM","2020","1143","20","1163","2023-01-02"
"35260","2022","COM","2020","560","6","566","2023-01-02"
"35261","2022","COM","2020","235","2","237","2023-01-02"
"35262","2022","COM","2020","356","5","361","2023-01-02"
"35263","2022","COM","2020","2870","82","2952","2023-01-02"
"35264","2022","COM","2020","2025","45","2070","2023-01-02"
"35265","2022","COM","2020","2553","47","2600","2023-01-02"
"35266","2022","COM","2020","3428","76","3504","2023-01-02"
"35268","2022","COM","2020","424","11","435","2023-01-02"
"35270","2022","COM","2020","371","5","376","2023-01-02"
"35271","2022","COM","2020","1487","25","1512","2023-01-02"
"35272","2022","COM","2020","969","22","991","2023-01-02"
"35273","2022","COM","2020","2071","31","2102","2023-01-02"
"35274","2022","COM","2020","982","17","999","2023-01-02"
"35275","2022","COM","2020","5312","88","5400","2023-01-02"
"35276","2022","COM","2020","586","10","596","2023-01-02"
"35277","2022","COM","2020","377","6","383","2023-01-02"
"35278","2022","COM","2020","9881","371","10252","2023-01-02"
"35279","2022","COM","2020","1206","27","1233","2023-01-02"
"35280","2022","COM","2020","1030","21","1051","2023-01-02"
"35281","2022","COM","2020","13955","149","14104","2023-01-02"
"35282","2022","COM","2020","2909","50","2959","2023-01-02"
"35283","2022","COM","2020","1368","24","1392","2023-01-02"
"35284","2022","COM","2020","2759","72","2831","2023-01-02"
"35285","2022","COM","2020","1070","21","1091","2023-01-02"
"35286","2022","COM","2020","289","10","299","2023-01-02"
"35287","2022","COM","2020","2500","89","2589","2023-01-02"
"35288","2022","COM","2020","46995","1333","48328","2023-01-02"
"35289","2022","COM","2020","1072","18","1090","2023-01-02"
"35290","2022","COM","2020","589","9","598","2023-01-02"
"35291","2022","COM","2020","436","9","445","2023-01-02"
"35292","2022","COM","2020","1605","43","1648","2023-01-02"
"35294","2022","COM","2020","2273","65","2338","2023-01-02"
"35295","2022","COM","2020","533","11","544","2023-01-02"
"35296","2022","COM","2020","1312","23","1335","2023-01-02"
"35297","2022","COM","2020","4576","156","4732","2023-01-02"
"35299","2022","COM","2020","4444","111","4555","2023-01-02"
"35300","2022","COM","2020","1357","40","1397","2023-01-02"
"35302","2022","COM","2020","1113","25","1138","2023-01-02"
"35304","2022","COM","2020","1321","29","1350","2023-01-02"
"35305","2022","COM","2020","418","8","426","2023-01-02"
"35306","2022","COM","2020","2346","164","2510","2023-01-02"
"35307","2022","COM","2020","1042","19","1061","2023-01-02"
"35308","2022","COM","2020","4387","76","4463","2023-01-02"
"35309","2022","COM","2020","815","12","827","2023-01-02"
"35310","2022","COM","2020","1543","27","1570","2023-01-02"
"35311","2022","COM","2020","587","3","590","2023-01-02"
"35312","2022","COM","2020","1824","49","1873","2023-01-02"
"35314","2022","COM","2020","961","51","1012","2023-01-02"
"35315","2022","COM","2020","1440","39","1479","2023-01-02"
"35316","2022","COM","2020","842","7","849","2023-01-02"
"35317","2022","COM","2020","587","61","648","2023-01-02"
"35318","2022","COM","2020","973","23","996","2023-01-02"
"35319","2022","COM","2020","2128","42","2170","2023-01-02"
"35320","2022","COM","2020","531","9","540","2023-01-02"
"35321","2022","COM","2020","791","9","800","2023-01-02"
"35322","2022","COM","2020","1110","30","1140","2023-01-02"
"35324","2022","COM","2020","617","16","633","2023-01-02"
"35325","2022","COM","2020","152","6","158","2023-01-02"
"35326","2022","COM","2020","2598","45","2643","2023-01-02"
"35327","2022","COM","2020","3823","86","3909","2023-01-02"
"35328","2022","COM","2020","2144","44","2188","2023-01-02"
"35329","2022","COM","2020","537","10","547","2023-01-02"
"35330","2022","COM","2020","1008","22","1030","2023-01-02"
"35331","2022","COM","2020","2503","65","2568","2023-01-02"
"35332","2022","COM","2020","1075","10","1085","2023-01-02"
"35333","2022","COM","2020","1718","33","1751","2023-01-02"
"35334","2022","COM","2020","8584","212","8796","2023-01-02"
"35335","2022","COM","2020","854","23","877","2023-01-02"
"35336","2022","COM","2020","186","4","190","2023-01-02"
"35337","2022","COM","2020","3774","193","3967","2023-01-02"
"35338","2022","COM","2020","1241","29","1270","2023-01-02"
"35339","2022","COM","2020","606","11","617","2023-01-02"
"35340","2022","COM","2020","1314","29","1343","2023-01-02"
"35342","2022","COM","2020","346","12","358","2023-01-02"
"35343","2022","COM","2020","1238","19","1257","2023-01-02"
"35345","2022","COM","2020","903","13","916","2023-01-02"
"35346","2022","COM","2020","206","4","210","2023-01-02"
"35347","2022","COM","2020","2576","57","2633","2023-01-02"
"35350","2022","COM","2020","805","18","823","2023-01-02"
"35351","2022","COM","2020","1435","24","1459","2023-01-02"
"35352","2022","COM","2020","8289","153","8442","2023-01-02"
"35353","2022","COM","2020","6234","73","6307","2023-01-02"
"35354","2022","COM","2020","320","2","322","2023-01-02"
"35355","2022","COM","2020","1267","9","1276","2023-01-02"
"35356","2022","COM","2020","2115","34","2149","2023-01-02"
"35357","2022","COM","2020","300","6","306","2023-01-02"
"35358","2022","COM","2020","1221","31","1252","2023-01-02"
"35359","2022","COM","2020","841","17","858","2023-01-02"
"35360","2022","COM","2020","18603","568","19171","2023-01-02"
"35361","2022","COM","2020","1063","8","1071","2023-01-02"
"35362","2022","COM","2020","1193","10","1203","2023-01-02"
"35363","2022","COM","2020","4389","106","4495","2023-01-02"
"36001","2022","COM","2020","1390","22","1412","2023-01-02"
"36002","2022","COM","2020","116","2","118","2023-01-02"
"36003","2022","COM","2020","890","19","909","2023-01-02"
"36004","2022","COM","2020","318","9","327","2023-01-02"
"36005","2022","COM","2020","3825","80","3905","2023-01-02"
"36006","2022","COM","2020","4865","212","5077","2023-01-02"
"36007","2022","COM","2020","604","9","613","2023-01-02"
"36008","2022","COM","2020","228","6","234","2023-01-02"
"36009","2022","COM","2020","1221","42","1263","2023-01-02"
"36010","2022","COM","2020","870","19","889","2023-01-02"
"36011","2022","COM","2020","174","2","176","2023-01-02"
"36012","2022","COM","2020","366","0","366","2023-01-02"
"36013","2022","COM","2020","419","8","427","2023-01-02"
"36014","2022","COM","2020","198","6","204","2023-01-02"
"36015","2022","COM","2020","53","1","54","2023-01-02"
"36016","2022","COM","2020","934","19","953","2023-01-02"
"36017","2022","COM","2020","367","6","373","2023-01-02"
"36018","2022","COM","2020","6229","220","6449","2023-01-02"
"36019","2022","COM","2020","312","5","317","2023-01-02"
"36020","2022","COM","2020","74","0","74","2023-01-02"
"36021","2022","COM","2020","888","20","908","2023-01-02"
"36022","2022","COM","2020","396","8","404","2023-01-02"
"36023","2022","COM","2020","261","5","266","2023-01-02"
"36024","2022","COM","2020","127","1","128","2023-01-02"
"36025","2022","COM","2020","611","11","622","2023-01-02"
"36026","2022","COM","2020","604","10","614","2023-01-02"
"36027","2022","COM","2020","245","6","251","2023-01-02"
"36028","2022","COM","2020","117","3","120","2023-01-02"
"36029","2022","COM","2020","234","3","237","2023-01-02"
"36030","2022","COM","2020","242","2","244","2023-01-02"
"36031","2022","COM","2020","4507","72","4579","2023-01-02"
"36032","2022","COM","2020","707","18","725","2023-01-02"
"36033","2022","COM","2020","394","4","398","2023-01-02"
"36034","2022","COM","2020","2762","44","2806","2023-01-02"
"36035","2022","COM","2020","1068","16","1084","2023-01-02"
"36036","2022","COM","2020","153","1","154","2023-01-02"
"36037","2022","COM","2020","291","6","297","2023-01-02"
"36038","2022","COM","2020","133","2","135","2023-01-02"
"36040","2022","COM","2020","98","0","98","2023-01-02"
"36041","2022","COM","2020","136","1","137","2023-01-02"
"36042","2022","COM","2020","701","10","711","2023-01-02"
"36043","2022","COM","2020","561","16","577","2023-01-02"
"36044","2022","COM","2020","43331","1559","44890","2023-01-02"
"36045","2022","COM","2020","2326","33","2359","2023-01-02"
"36046","2022","COM","2020","4048","117","4165","2023-01-02"
"36047","2022","COM","2020","501","8","509","2023-01-02"
"36048","2022","COM","2020","269","9","278","2023-01-02"
"36049","2022","COM","2020","124","2","126","2023-01-02"
"36050","2022","COM","2020","448","10","458","2023-01-02"
"36051","2022","COM","2020","181","2","183","2023-01-02"
"36052","2022","COM","2020","155","2","157","2023-01-02"
"36053","2022","COM","2020","528","12","540","2023-01-02"
"36054","2022","COM","2020","233","8","241","2023-01-02"
"36055","2022","COM","2020","996","18","1014","2023-01-02"
"36056","2022","COM","2020","981","17","998","2023-01-02"
"36057","2022","COM","2020","878","24","902","2023-01-02"
"36058","2022","COM","2020","628","16","644","2023-01-02"
"36059","2022","COM","2020","230","7","237","2023-01-02"
"36060","2022","COM","2020","704","16","720","2023-01-02"
"36061","2022","COM","2020","330","9","339","2023-01-02"
"36062","2022","COM","2020","452","8","460","2023-01-02"
"36063","2022","COM","2020","7659","149","7808","2023-01-02"
"36064","2022","COM","2020","749","17","766","2023-01-02"
"36065","2022","COM","2020","260","5","265","2023-01-02"
"36066","2022","COM","2020","452","13","465","2023-01-02"
"36067","2022","COM","2020","103","3","106","2023-01-02"
"36068","2022","COM","2020","422","7","429","2023-01-02"
"36069","2022","COM","2020","1202","22","1224","2023-01-02"
"36070","2022","COM","2020","1325","37","1362","2023-01-02"
"36071","2022","COM","2020","1015","19","1034","2023-01-02"
"36073","2022","COM","2020","211","5","216","2023-01-02"
"36074","2022","COM","2020","537","10","547","2023-01-02"
"36075","2022","COM","2020","90","1","91","2023-01-02"
"36076","2022","COM","2020","250","3","253","2023-01-02"
"36077","2022","COM","2020","248","3","251","2023-01-02"
"36078","2022","COM","2020","355","10","365","2023-01-02"
"36079","2022","COM","2020","77","1","78","2023-01-02"
"36080","2022","COM","2020","73","0","73","2023-01-02"
"36081","2022","COM","2020","276","8","284","2023-01-02"
"36082","2022","COM","2020","250","4","254","2023-01-02"
"36083","2022","COM","2020","118","3","121","2023-01-02"
"36084","2022","COM","2020","284","2","286","2023-01-02"
"36085","2022","COM","2020","249","7","256","2023-01-02"
"36086","2022","COM","2020","389","8","397","2023-01-02"
"36087","2022","COM","2020","309","4","313","2023-01-02"
"36088","2022","COM","2020","11314","264","11578","2023-01-02"
"36089","2022","COM","2020","408","6","414","2023-01-02"
"36090","2022","COM","2020","118","2","120","2023-01-02"
"36091","2022","COM","2020","657","18","675","2023-01-02"
"36092","2022","COM","2020","266","7","273","2023-01-02"
"36093","2022","COM","2020","2883","28","2911","2023-01-02"
"36094","2022","COM","2020","452","15","467","2023-01-02"
"36095","2022","COM","2020","108","2","110","2023-01-02"
"36096","2022","COM","2020","206","3","209","2023-01-02"
"36097","2022","COM","2020","323","8","331","2023-01-02"
"36098","2022","COM","2020","86","2","88","2023-01-02"
"36099","2022","COM","2020","299","5","304","2023-01-02"
"36100","2022","COM","2020","257","7","264","2023-01-02"
"36101","2022","COM","2020","1544","41","1585","2023-01-02"
"36102","2022","COM","2020","103","2","105","2023-01-02"
"36103","2022","COM","2020","1324","20","1344","2023-01-02"
"36104","2022","COM","2020","226","2","228","2023-01-02"
"36105","2022","COM","2020","263","1","264","2023-01-02"
"36106","2022","COM","2020","155","1","156","2023-01-02"
"36107","2022","COM","2020","740","11","751","2023-01-02"
"36108","2022","COM","2020","210","2","212","2023-01-02"
"36109","2022","COM","2020","1038","20","1058","2023-01-02"
"36110","2022","COM","2020","260","6","266","2023-01-02"
"36111","2022","COM","2020","193","3","196","2023-01-02"
"36112","2022","COM","2020","743","19","762","2023-01-02"
"36113","2022","COM","2020","935","20","955","2023-01-02"
"36114","2022","COM","2020","299","3","302","2023-01-02"
"36115","2022","COM","2020","130","2","132","2023-01-02"
"36116","2022","COM","2020","118","4","122","2023-01-02"
"36117","2022","COM","2020","424","8","432","2023-01-02"
"36118","2022","COM","2020","380","3","383","2023-01-02"
"36119","2022","COM","2020","541","13","554","2023-01-02"
"36120","2022","COM","2020","667","16","683","2023-01-02"
"36121","2022","COM","2020","171","7","178","2023-01-02"
"36122","2022","COM","2020","196","2","198","2023-01-02"
"36123","2022","COM","2020","985","21","1006","2023-01-02"
"36124","2022","COM","2020","259","5","264","2023-01-02"
"36125","2022","COM","2020","115","5","120","2023-01-02"
"36126","2022","COM","2020","446","6","452","2023-01-02"
"36127","2022","COM","2020","1554","30","1584","2023-01-02"
"36128","2022","COM","2020","1665","173","1838","2023-01-02"
"36129","2022","COM","2020","575","13","588","2023-01-02"
"36130","2022","COM","2020","104","2","106","2023-01-02"
"36131","2022","COM","2020","470","7","477","2023-01-02"
"36132","2022","COM","2020","69","3","72","2023-01-02"
"36133","2022","COM","2020","210","6","216","2023-01-02"
"36134","2022","COM","2020","396","11","407","2023-01-02"
"36135","2022","COM","2020","289","4","293","2023-01-02"
"36136","2022","COM","2020","129","3","132","2023-01-02"
"36137","2022","COM","2020","362","16","378","2023-01-02"
"36138","2022","COM","2020","187","4","191","2023-01-02"
"36139","2022","COM","2020","659","17","676","2023-01-02"
"36140","2022","COM","2020","1167","18","1185","2023-01-02"
"36141","2022","COM","2020","1651","37","1688","2023-01-02"
"36142","2022","COM","2020","1529","33","1562","2023-01-02"
"36143","2022","COM","2020","448","14","462","2023-01-02"
"36144","2022","COM","2020","291","7","298","2023-01-02"
"36145","2022","COM","2020","193","4","197","2023-01-02"
"36146","2022","COM","2020","713","10","723","2023-01-02"
"36147","2022","COM","2020","138","3","141","2023-01-02"
"36148","2022","COM","2020","410","3","413","2023-01-02"
"36149","2022","COM","2020","798","12","810","2023-01-02"
"36150","2022","COM","2020","501","8","509","2023-01-02"
"36152","2022","COM","2020","437","2","439","2023-01-02"
"36153","2022","COM","2020","347","8","355","2023-01-02"
"36154","2022","COM","2020","1854","38","1892","2023-01-02"
"36155","2022","COM","2020","797","56","853","2023-01-02"
"36156","2022","COM","2020","385","3","388","2023-01-02"
"36157","2022","COM","2020","451","13","464","2023-01-02"
"36158","2022","COM","2020","771","8","779","2023-01-02"
"36159","2022","COM","2020","5836","177","6013","2023-01-02"
"36160","2022","COM","2020","210","5","215","2023-01-02"
"36161","2022","COM","2020","944","10","954","2023-01-02"
"36162","2022","COM","2020","817","19","836","2023-01-02"
"36163","2022","COM","2020","643","11","654","2023-01-02"
"36164","2022","COM","2020","227","3","230","2023-01-02"
"36165","2022","COM","2020","1031","29","1060","2023-01-02"
"36166","2022","COM","2020","168","6","174","2023-01-02"
"36167","2022","COM","2020","154","3","157","2023-01-02"
"36168","2022","COM","2020","582","16","598","2023-01-02"
"36169","2022","COM","2020","506","11","517","2023-01-02"
"36170","2022","COM","2020","101","0","101","2023-01-02"
"36171","2022","COM","2020","2003","31","2034","2023-01-02"
"36172","2022","COM","2020","509","11","520","2023-01-02"
"36173","2022","COM","2020","519","13","532","2023-01-02"
"36174","2022","COM","2020","358","6","364","2023-01-02"
"36175","2022","COM","2020","273","1","274","2023-01-02"
"36176","2022","COM","2020","580","7","587","2023-01-02"
"36177","2022","COM","2020","319","6","325","2023-01-02"
"36178","2022","COM","2020","274","12","286","2023-01-02"
"36179","2022","COM","2020","234","1","235","2023-01-02"
"36180","2022","COM","2020","821","18","839","2023-01-02"
"36181","2022","COM","2020","161","3","164","2023-01-02"
"36182","2022","COM","2020","554","7","561","2023-01-02"
"36184","2022","COM","2020","485","5","490","2023-01-02"
"36185","2022","COM","2020","357","3","360","2023-01-02"
"36186","2022","COM","2020","249","2","251","2023-01-02"
"36187","2022","COM","2020","134","1","135","2023-01-02"
"36188","2022","COM","2020","171","144","315","2023-01-02"
"36189","2022","COM","2020","966","13","979","2023-01-02"
"36190","2022","COM","2020","266","2","268","2023-01-02"
"36191","2022","COM","2020","529","8","537","2023-01-02"
"36192","2022","COM","2020","1734","21","1755","2023-01-02"
"36193","2022","COM","2020","254","7","261","2023-01-02"
"36194","2022","COM","2020","944","17","961","2023-01-02"
"36195","2022","COM","2020","572","13","585","2023-01-02"
"36196","2022","COM","2020","95","3","98","2023-01-02"
"36197","2022","COM","2020","299","3","302","2023-01-02"
"36198","2022","COM","2020","403","15","418","2023-01-02"
"36199","2022","COM","2020","1132","23","1155","2023-01-02"
"36200","2022","COM","2020","1505","24","1529","2023-01-02"
"36202","2022","COM","2020","3694","77","3771","2023-01-02"
"36203","2022","COM","2020","54","0","54","2023-01-02"
"36204","2022","COM","2020","322","6","328","2023-01-02"
"36205","2022","COM","2020","102","3","105","2023-01-02"
"36207","2022","COM","2020","606","13","619","2023-01-02"
"36208","2022","COM","2020","774","5","779","2023-01-02"
"36209","2022","COM","2020","263","12","275","2023-01-02"
"36210","2022","COM","2020","299","11","310","2023-01-02"
"36211","2022","COM","2020","454","8","462","2023-01-02"
"36212","2022","COM","2020","158","5","163","2023-01-02"
"36213","2022","COM","2020","255","5","260","2023-01-02"
"36214","2022","COM","2020","300","10","310","2023-01-02"
"36215","2022","COM","2020","492","12","504","2023-01-02"
"36216","2022","COM","2020","63","0","63","2023-01-02"
"36217","2022","COM","2020","98","3","101","2023-01-02"
"36218","2022","COM","2020","147","5","152","2023-01-02"
"36219","2022","COM","2020","650","17","667","2023-01-02"
"36220","2022","COM","2020","889","18","907","2023-01-02"
"36221","2022","COM","2020","386","10","396","2023-01-02"
"36222","2022","COM","2020","235","6","241","2023-01-02"
"36223","2022","COM","2020","141","4","145","2023-01-02"
"36224","2022","COM","2020","1127","25","1152","2023-01-02"
"36225","2022","COM","2020","184","1","185","2023-01-02"
"36226","2022","COM","2020","351","11","362","2023-01-02"
"36227","2022","COM","2020","246","3","249","2023-01-02"
"36228","2022","COM","2020","2303","80","2383","2023-01-02"
"36229","2022","COM","2020","951","16","967","2023-01-02"
"36230","2022","COM","2020","1935","41","1976","2023-01-02"
"36231","2022","COM","2020","969","20","989","2023-01-02"
"36232","2022","COM","2020","1066","23","1089","2023-01-02"
"36233","2022","COM","2020","760","11","771","2023-01-02"
"36234","2022","COM","2020","335","6","341","2023-01-02"
"36235","2022","COM","2020","377","8","385","2023-01-02"
"36236","2022","COM","2020","315","5","320","2023-01-02"
"36237","2022","COM","2020","704","20","724","2023-01-02"
"36238","2022","COM","2020","99","1","100","2023-01-02"
"36239","2022","COM","2020","464","5","469","2023-01-02"
"36240","2022","COM","2020","291","4","295","2023-01-02"
"36241","2022","COM","2020","2679","46","2725","2023-01-02"
"36242","2022","COM","2020","106","1","107","2023-01-02"
"36243","2022","COM","2020","313","4","317","2023-01-02"
"36244","2022","COM","2020","873","6","879","2023-01-02"
"36246","2022","COM","2020","168","2","170","2023-01-02"
"36247","2022","COM","2020","1234","27","1261","2023-01-02"
"36248","2022","COM","2020","229","3","232","2023-01-02"
"37001","2022","COM","2020","1140","16","1156","2023-01-02"
"37002","2022","COM","2020","1753","28","1781","2023-01-02"
"37003","2022","COM","2020","12569","367","12936","2023-01-02"
"37004","2022","COM","2020","426","11","437","2023-01-02"
"37005","2022","COM","2020","507","5","512","2023-01-02"
"37006","2022","COM","2020","2660","53","2713","2023-01-02"
"37007","2022","COM","2020","166","4","170","2023-01-02"
"37008","2022","COM","2020","2760","34","2794","2023-01-02"
"37009","2022","COM","2020","430","10","440","2023-01-02"
"37010","2022","COM","2020","2209","64","2273","2023-01-02"
"37011","2022","COM","2020","1933","39","1972","2023-01-02"
"37012","2022","COM","2020","549","8","557","2023-01-02"
"37013","2022","COM","2020","469","10","479","2023-01-02"
"37014","2022","COM","2020","3468","106","3574","2023-01-02"
"37015","2022","COM","2020","3089","69","3158","2023-01-02"
"37016","2022","COM","2020","358","14","372","2023-01-02"
"37018","2022","COM","2020","8083","142","8225","2023-01-02"
"37019","2022","COM","2020","458","12","470","2023-01-02"
"37020","2022","COM","2020","1754","33","1787","2023-01-02"
"37021","2022","COM","2020","1742","31","1773","2023-01-02"
"37022","2022","COM","2020","2685","85","2770","2023-01-02"
"37023","2022","COM","2020","242","5","247","2023-01-02"
"37024","2022","COM","2020","917","17","934","2023-01-02"
"37025","2022","COM","2020","684","6","690","2023-01-02"
"37026","2022","COM","2020","519","4","523","2023-01-02"
"37027","2022","COM","2020","5264","65","5329","2023-01-02"
"37028","2022","COM","2020","733","23","756","2023-01-02"
"37029","2022","COM","2020","327","5","332","2023-01-02"
"37030","2022","COM","2020","796","8","804","2023-01-02"
"37031","2022","COM","2020","3808","89","3897","2023-01-02"
"37032","2022","COM","2020","274","7","281","2023-01-02"
"37033","2022","COM","2020","204","4","208","2023-01-02"
"37034","2022","COM","2020","306","9","315","2023-01-02"
"37035","2022","COM","2020","287","10","297","2023-01-02"
"37036","2022","COM","2020","198","1","199","2023-01-02"
"37037","2022","COM","2020","210","5","215","2023-01-02"
"37038","2022","COM","2020","738","8","746","2023-01-02"
"37039","2022","COM","2020","484","13","497","2023-01-02"
"37040","2022","COM","2020","256","9","265","2023-01-02"
"37041","2022","COM","2020","325","4","329","2023-01-02"
"37042","2022","COM","2020","185","3","188","2023-01-02"
"37043","2022","COM","2020","1043","25","1068","2023-01-02"
"37044","2022","COM","2020","369","5","374","2023-01-02"
"37045","2022","COM","2020","1050","14","1064","2023-01-02"
"37046","2022","COM","2020","426","8","434","2023-01-02"
"37047","2022","COM","2020","1237","27","1264","2023-01-02"
"37048","2022","COM","2020","322","6","328","2023-01-02"
"37049","2022","COM","2020","1248","25","1273","2023-01-02"
"37050","2022","COM","2020","11956","265","12221","2023-01-02"
"37051","2022","COM","2020","818","8","826","2023-01-02"
"37052","2022","COM","2020","1131","26","1157","2023-01-02"
"37053","2022","COM","2020","117","7","124","2023-01-02"
"37054","2022","COM","2020","3529","47","3576","2023-01-02"
"37055","2022","COM","2020","806","17","823","2023-01-02"
"37056","2022","COM","2020","567","11","578","2023-01-02"
"37057","2022","COM","2020","681","14","695","2023-01-02"
"37058","2022","COM","2020","1448","26","1474","2023-01-02"
"37059","2022","COM","2020","1318","31","1349","2023-01-02"
"37060","2022","COM","2020","1330","19","1349","2023-01-02"
"37061","2022","COM","2020","490","15","505","2023-01-02"
"37062","2022","COM","2020","1720","18","1738","2023-01-02"
"37063","2022","COM","2020","4895","82","4977","2023-01-02"
"37064","2022","COM","2020","219","9","228","2023-01-02"
"37065","2022","COM","2020","551","6","557","2023-01-02"
"37066","2022","COM","2020","559","5","564","2023-01-02"
"37067","2022","COM","2020","1812","22","1834","2023-01-02"
"37068","2022","COM","2020","722","15","737","2023-01-02"
"37069","2022","COM","2020","232","8","240","2023-01-02"
"37070","2022","COM","2020","345","14","359","2023-01-02"
"37071","2022","COM","2020","131","1","132","2023-01-02"
"37072","2022","COM","2020","8063","298","8361","2023-01-02"
"37073","2022","COM","2020","580","14","594","2023-01-02"
"37074","2022","COM","2020","2085","23","2108","2023-01-02"
"37075","2022","COM","2020","467","6","473","2023-01-02"
"37076","2022","COM","2020","386","10","396","2023-01-02"
"37077","2022","COM","2020","3822","52","3874","2023-01-02"
"37078","2022","COM","2020","417","11","428","2023-01-02"
"37079","2022","COM","2020","1782","57","1839","2023-01-02"
"37080","2022","COM","2020","204","4","208","2023-01-02"
"37081","2022","COM","2020","1398","20","1418","2023-01-02"
"37082","2022","COM","2020","458","3","461","2023-01-02"
"37083","2022","COM","2020","1800","26","1826","2023-01-02"
"37084","2022","COM","2020","545","7","552","2023-01-02"
"37085","2022","COM","2020","798","21","819","2023-01-02"
"37086","2022","COM","2020","491","10","501","2023-01-02"
"37087","2022","COM","2020","244","9","253","2023-01-02"
"37088","2022","COM","2020","108","1","109","2023-01-02"
"37089","2022","COM","2020","642","18","660","2023-01-02"
"37090","2022","COM","2020","110","2","112","2023-01-02"
"37091","2022","COM","2020","2410","59","2469","2023-01-02"
"37092","2022","COM","2020","653","15","668","2023-01-02"
"37093","2022","COM","2020","529","5","534","2023-01-02"
"37094","2022","COM","2020","563","10","573","2023-01-02"
"37095","2022","COM","2020","345","7","352","2023-01-02"
"37096","2022","COM","2020","628","10","638","2023-01-02"
"37097","2022","COM","2020","670","23","693","2023-01-02"
"37098","2022","COM","2020","734","18","752","2023-01-02"
"37099","2022","COM","2020","967","12","979","2023-01-02"
"37100","2022","COM","2020","403","4","407","2023-01-02"
"37101","2022","COM","2020","152","1","153","2023-01-02"
"37103","2022","COM","2020","144","2","146","2023-01-02"
"37104","2022","COM","2020","6161","110","6271","2023-01-02"
"37105","2022","COM","2020","259","6","265","2023-01-02"
"37106","2022","COM","2020","323","4","327","2023-01-02"
"37107","2022","COM","2020","234","5","239","2023-01-02"
"37108","2022","COM","2020","707","14","721","2023-01-02"
"37109","2022","COM","2020","10585","518","11103","2023-01-02"
"37110","2022","COM","2020","1386","33","1419","2023-01-02"
"37111","2022","COM","2020","1496","35","1531","2023-01-02"
"37112","2022","COM","2020","376","7","383","2023-01-02"
"37113","2022","COM","2020","871","20","891","2023-01-02"
"37114","2022","COM","2020","174","6","180","2023-01-02"
"37115","2022","COM","2020","3331","55","3386","2023-01-02"
"37116","2022","COM","2020","553","17","570","2023-01-02"
"37117","2022","COM","2020","869","9","878","2023-01-02"
"37118","2022","COM","2020","1411","35","1446","2023-01-02"
"37119","2022","COM","2020","1517","39","1556","2023-01-02"
"37121","2022","COM","2020","249","5","254","2023-01-02"
"37122","2022","COM","2020","38750","393","39143","2023-01-02"
"37123","2022","COM","2020","4349","62","4411","2023-01-02"
"37124","2022","COM","2020","2501","40","2541","2023-01-02"
"37125","2022","COM","2020","492","6","498","2023-01-02"
"37126","2022","COM","2020","340","8","348","2023-01-02"
"37127","2022","COM","2020","326","8","334","2023-01-02"
"37128","2022","COM","2020","1306","25","1331","2023-01-02"
"37129","2022","COM","2020","1060","21","1081","2023-01-02"
"37130","2022","COM","2020","2115","32","2147","2023-01-02"
"37131","2022","COM","2020","1263","22","1285","2023-01-02"
"37132","2022","COM","2020","6165","526","6691","2023-01-02"
"37133","2022","COM","2020","466","9","475","2023-01-02"
"37134","2022","COM","2020","678","14","692","2023-01-02"
"37136","2022","COM","2020","527","3","530","2023-01-02"
"37137","2022","COM","2020","138","3","141","2023-01-02"
"37138","2022","COM","2020","859","17","876","2023-01-02"
"37139","2022","COM","2020","5093","143","5236","2023-01-02"
"37140","2022","COM","2020","251","5","256","2023-01-02"
"37141","2022","COM","2020","957","18","975","2023-01-02"
"37142","2022","COM","2020","563","6","569","2023-01-02"
"37143","2022","COM","2020","1358","26","1384","2023-01-02"
"37144","2022","COM","2020","531","6","537","2023-01-02"
"37145","2022","COM","2020","241","2","243","2023-01-02"
"37146","2022","COM","2020","218","3","221","2023-01-02"
"37147","2022","COM","2020","563","13","576","2023-01-02"
"37148","2022","COM","2020","613","6","619","2023-01-02"
"37149","2022","COM","2020","479","8","487","2023-01-02"
"37150","2022","COM","2020","1416","13","1429","2023-01-02"
"37151","2022","COM","2020","3294","62","3356","2023-01-02"
"37152","2022","COM","2020","2057","66","2123","2023-01-02"
"37153","2022","COM","2020","4678","54","4732","2023-01-02"
"37154","2022","COM","2020","4602","92","4694","2023-01-02"
"37155","2022","COM","2020","642","8","650","2023-01-02"
"37156","2022","COM","2020","10895","167","11062","2023-01-02"
"37157","2022","COM","2020","316","4","320","2023-01-02"
"37158","2022","COM","2020","766","11","777","2023-01-02"
"37159","2022","COM","2020","7896","144","8040","2023-01-02"
"37160","2022","COM","2020","349","6","355","2023-01-02"
"37161","2022","COM","2020","809","16","825","2023-01-02"
"37162","2022","COM","2020","466","12","478","2023-01-02"
"37163","2022","COM","2020","3525","59","3584","2023-01-02"
"37165","2022","COM","2020","436","5","441","2023-01-02"
"37166","2022","COM","2020","784","7","791","2023-01-02"
"37167","2022","COM","2020","2127","23","2150","2023-01-02"
"37168","2022","COM","2020","287","9","296","2023-01-02"
"37169","2022","COM","2020","927","28","955","2023-01-02"
"37170","2022","COM","2020","1077","68","1145","2023-01-02"
"37171","2022","COM","2020","1131","22","1153","2023-01-02"
"37172","2022","COM","2020","4221","81","4302","2023-01-02"
"37173","2022","COM","2020","714","9","723","2023-01-02"
"37174","2022","COM","2020","809","16","825","2023-01-02"
"37175","2022","COM","2020","1239","31","1270","2023-01-02"
"37176","2022","COM","2020","1179","49","1228","2023-01-02"
"37177","2022","COM","2020","712","16","728","2023-01-02"
"37178","2022","COM","2020","620","4","624","2023-01-02"
"37179","2022","COM","2020","2530","34","2564","2023-01-02"
"37180","2022","COM","2020","632","6","638","2023-01-02"
"37181","2022","COM","2020","235","2","237","2023-01-02"
"37182","2022","COM","2020","1451","15","1466","2023-01-02"
"37183","2022","COM","2020","1452","27","1479","2023-01-02"
"37184","2022","COM","2020","328","6","334","2023-01-02"
"37185","2022","COM","2020","1692","73","1765","2023-01-02"
"37186","2022","COM","2020","1215","13","1228","2023-01-02"
"37187","2022","COM","2020","359","7","366","2023-01-02"
"37188","2022","COM","2020","900","7","907","2023-01-02"
"37189","2022","COM","2020","1008","19","1027","2023-01-02"
"37190","2022","COM","2020","164","2","166","2023-01-02"
"37191","2022","COM","2020","228","7","235","2023-01-02"
"37192","2022","COM","2020","1302","18","1320","2023-01-02"
"37193","2022","COM","2020","1141","26","1167","2023-01-02"
"37194","2022","COM","2020","1755","33","1788","2023-01-02"
"37195","2022","COM","2020","10372","97","10469","2023-01-02"
"37196","2022","COM","2020","1653","18","1671","2023-01-02"
"37197","2022","COM","2020","511","13","524","2023-01-02"
"37198","2022","COM","2020","315","2","317","2023-01-02"
"37199","2022","COM","2020","462","8","470","2023-01-02"
"37200","2022","COM","2020","984","16","1000","2023-01-02"
"37201","2022","COM","2020","695","19","714","2023-01-02"
"37202","2022","COM","2020","530","11","541","2023-01-02"
"37203","2022","COM","2020","3162","93","3255","2023-01-02"
"37204","2022","COM","2020","1343","24","1367","2023-01-02"
"37205","2022","COM","2020","1411","16","1427","2023-01-02"
"37206","2022","COM","2020","1766","37","1803","2023-01-02"
"37207","2022","COM","2020","341","2","343","2023-01-02"
"37208","2022","COM","2020","15075","334","15409","2023-01-02"
"37210","2022","COM","2020","847","17","864","2023-01-02"
"37211","2022","COM","2020","2628","34","2662","2023-01-02"
"37212","2022","COM","2020","785","11","796","2023-01-02"
"37213","2022","COM","2020","1092","23","1115","2023-01-02"
"37214","2022","COM","2020","16884","402","17286","2023-01-02"
"37216","2022","COM","2020","1543","33","1576","2023-01-02"
"37217","2022","COM","2020","1634","23","1657","2023-01-02"
"37218","2022","COM","2020","574","12","586","2023-01-02"
"37219","2022","COM","2020","1029","15","1044","2023-01-02"
"37220","2022","COM","2020","360","4","364","2023-01-02"
"37221","2022","COM","2020","618","7","625","2023-01-02"
"37222","2022","COM","2020","752","17","769","2023-01-02"
"37223","2022","COM","2020","327","7","334","2023-01-02"
"37224","2022","COM","2020","920","22","942","2023-01-02"
"37225","2022","COM","2020","3169","49","3218","2023-01-02"
"37226","2022","COM","2020","4147","52","4199","2023-01-02"
"37228","2022","COM","2020","1101","24","1125","2023-01-02"
"37229","2022","COM","2020","243","8","251","2023-01-02"
"37230","2022","COM","2020","982","19","1001","2023-01-02"
"37231","2022","COM","2020","1650","25","1675","2023-01-02"
"37232","2022","COM","2020","1887","39","1926","2023-01-02"
"37233","2022","COM","2020","15898","253","16151","2023-01-02"
"37234","2022","COM","2020","491","15","506","2023-01-02"
"37236","2022","COM","2020","610","11","621","2023-01-02"
"37237","2022","COM","2020","1281","28","1309","2023-01-02"
"37238","2022","COM","2020","526","8","534","2023-01-02"
"37240","2022","COM","2020","687","12","699","2023-01-02"
"37241","2022","COM","2020","1328","20","1348","2023-01-02"
"37242","2022","COM","2020","1560","32","1592","2023-01-02"
"37243","2022","COM","2020","3252","77","3329","2023-01-02"
"37244","2022","COM","2020","256","4","260","2023-01-02"
"37245","2022","COM","2020","2162","44","2206","2023-01-02"
"37246","2022","COM","2020","207","5","212","2023-01-02"
"37247","2022","COM","2020","609","10","619","2023-01-02"
"37248","2022","COM","2020","378","22","400","2023-01-02"
"37249","2022","COM","2020","1409","24","1433","2023-01-02"
"37250","2022","COM","2020","2785","77","2862","2023-01-02"
"37251","2022","COM","2020","897","8","905","2023-01-02"
"37252","2022","COM","2020","394","6","400","2023-01-02"
"37253","2022","COM","2020","180","6","186","2023-01-02"
"37254","2022","COM","2020","1703","36","1739","2023-01-02"
"37255","2022","COM","2020","264","2","266","2023-01-02"
"37256","2022","COM","2020","290","3","293","2023-01-02"
"37257","2022","COM","2020","1786","24","1810","2023-01-02"
"37258","2022","COM","2020","291","3","294","2023-01-02"
"37259","2022","COM","2020","459","10","469","2023-01-02"
"37260","2022","COM","2020","514","11","525","2023-01-02"
"37261","2022","COM","2020","137850","2624","140474","2023-01-02"
"37262","2022","COM","2020","291","4","295","2023-01-02"
"37263","2022","COM","2020","2443","35","2478","2023-01-02"
"37264","2022","COM","2020","1318","20","1338","2023-01-02"
"37265","2022","COM","2020","237","5","242","2023-01-02"
"37266","2022","COM","2020","6511","122","6633","2023-01-02"
"37267","2022","COM","2020","4590","81","4671","2023-01-02"
"37268","2022","COM","2020","127","0","127","2023-01-02"
"37269","2022","COM","2020","472","12","484","2023-01-02"
"37270","2022","COM","2020","2769","52","2821","2023-01-02"
"37271","2022","COM","2020","1039","9","1048","2023-01-02"
"37272","2022","COM","2020","1136","34","1170","2023-01-02"
"37273","2022","COM","2020","5593","77","5670","2023-01-02"
"37274","2022","COM","2020","306","4","310","2023-01-02"
"37275","2022","COM","2020","121","2","123","2023-01-02"
"37276","2022","COM","2020","1321","31","1352","2023-01-02"
"37277","2022","COM","2020","583","3","586","2023-01-02"
"37278","2022","COM","2020","1077","7","1084","2023-01-02"
"37279","2022","COM","2020","752","7","759","2023-01-02"
"37280","2022","COM","2020","238","6","244","2023-01-02"
"37281","2022","COM","2020","3294","62","3356","2023-01-02"
"37282","2022","COM","2020","1337","25","1362","2023-01-02"
"38001","2022","COM","2020","6439","105","6544","2023-01-02"
"38002","2022","COM","2020","1063","31","1094","2023-01-02"
"38003","2022","COM","2020","1170","22","1192","2023-01-02"
"38004","2022","COM","2020","1285","26","1311","2023-01-02"
"38005","2022","COM","2020","942","17","959","2023-01-02"
"38006","2022","COM","2020","3999","107","4106","2023-01-02"
"38008","2022","COM","2020","27","0","27","2023-01-02"
"38009","2022","COM","2020","1036","14","1050","2023-01-02"
"38010","2022","COM","2020","710","18","728","2023-01-02"
"38011","2022","COM","2020","1130","14","1144","2023-01-02"
"38012","2022","COM","2020","2880","52","2932","2023-01-02"
"38013","2022","COM","2020","3475","87","3562","2023-01-02"
"38015","2022","COM","2020","1828","39","1867","2023-01-02"
"38017","2022","COM","2020","1643","36","1679","2023-01-02"
"38018","2022","COM","2020","367","11","378","2023-01-02"
"38019","2022","COM","2020","1476","28","1504","2023-01-02"
"38020","2022","COM","2020","181","3","184","2023-01-02"
"38022","2022","COM","2020","7777","161","7938","2023-01-02"
"38023","2022","COM","2020","204","5","209","2023-01-02"
"38026","2022","COM","2020","1119","18","1137","2023-01-02"
"38027","2022","COM","2020","1983","59","2042","2023-01-02"
"38029","2022","COM","2020","1969","46","2015","2023-01-02"
"38030","2022","COM","2020","1871","29","1900","2023-01-02"
"38031","2022","COM","2020","21","0","21","2023-01-02"
"38032","2022","COM","2020","583","12","595","2023-01-02"
"38033","2022","COM","2020","633","18","651","2023-01-02"
"38034","2022","COM","2020","5005","83","5088","2023-01-02"
"38035","2022","COM","2020","1111","15","1126","2023-01-02"
"38036","2022","COM","2020","96","1","97","2023-01-02"
"38037","2022","COM","2020","1000","14","1014","2023-01-02"
"38038","2022","COM","2020","599","14","613","2023-01-02"
"38039","2022","COM","2020","3022","105","3127","2023-01-02"
"38040","2022","COM","2020","148","1","149","2023-01-02"
"38041","2022","COM","2020","104","3","107","2023-01-02"
"38042","2022","COM","2020","1031","22","1053","2023-01-02"
"38043","2022","COM","2020","1585","42","1627","2023-01-02"
"38044","2022","COM","2020","1488","42","1530","2023-01-02"
"38045","2022","COM","2020","2304","90","2394","2023-01-02"
"38046","2022","COM","2020","1005","15","1020","2023-01-02"
"38047","2022","COM","2020","152","3","155","2023-01-02"
"38048","2022","COM","2020","1102","19","1121","2023-01-02"
"38049","2022","COM","2020","313","2","315","2023-01-02"
"38050","2022","COM","2020","634","10","644","2023-01-02"
"38051","2022","COM","2020","1381","29","1410","2023-01-02"
"38052","2022","COM","2020","3285","101","3386","2023-01-02"
"38053","2022","COM","2020","29389","622","30011","2023-01-02"
"38054","2022","COM","2020","1525","26","1551","2023-01-02"
"38055","2022","COM","2020","633","8","641","2023-01-02"
"38056","2022","COM","2020","92","2","94","2023-01-02"
"38057","2022","COM","2020","664","12","676","2023-01-02"
"38058","2022","COM","2020","2212","39","2251","2023-01-02"
"38059","2022","COM","2020","2533","46","2579","2023-01-02"
"38060","2022","COM","2020","145","4","149","2023-01-02"
"38061","2022","COM","2020","3323","77","3400","2023-01-02"
"38062","2022","COM","2020","763","13","776","2023-01-02"
"38063","2022","COM","2020","446","12","458","2023-01-02"
"38064","2022","COM","2020","3172","71","3243","2023-01-02"
"38065","2022","COM","2020","2157","51","2208","2023-01-02"
"38066","2022","COM","2020","173","4","177","2023-01-02"
"38067","2022","COM","2020","1731","34","1765","2023-01-02"
"38068","2022","COM","2020","1306","29","1335","2023-01-02"
"38069","2022","COM","2020","1452","25","1477","2023-01-02"
"38070","2022","COM","2020","1231","15","1246","2023-01-02"
"38071","2022","COM","2020","3255","33","3288","2023-01-02"
"38072","2022","COM","2020","2699","33","2732","2023-01-02"
"38073","2022","COM","2020","200","3","203","2023-01-02"
"38074","2022","COM","2020","365","6","371","2023-01-02"
"38075","2022","COM","2020","2975","106","3081","2023-01-02"
"38076","2022","COM","2020","1905","66","1971","2023-01-02"
"38077","2022","COM","2020","763","16","779","2023-01-02"
"38078","2022","COM","2020","568","14","582","2023-01-02"
"38080","2022","COM","2020","769","20","789","2023-01-02"
"38081","2022","COM","2020","1990","47","2037","2023-01-02"
"38082","2022","COM","2020","1950","43","1993","2023-01-02"
"38083","2022","COM","2020","444","16","460","2023-01-02"
"38084","2022","COM","2020","1407","25","1432","2023-01-02"
"38085","2022","COM","2020","10194","84","10278","2023-01-02"
"38086","2022","COM","2020","400","8","408","2023-01-02"
"38087","2022","COM","2020","6338","52","6390","2023-01-02"
"38089","2022","COM","2020","222","5","227","2023-01-02"
"38090","2022","COM","2020","268","5","273","2023-01-02"
"38091","2022","COM","2020","750","17","767","2023-01-02"
"38092","2022","COM","2020","95","3","98","2023-01-02"
"38093","2022","COM","2020","437","6","443","2023-01-02"
"38094","2022","COM","2020","2006","42","2048","2023-01-02"
"38095","2022","COM","2020","2461","144","2605","2023-01-02"
"38097","2022","COM","2020","4961","66","5027","2023-01-02"
"38098","2022","COM","2020","729","17","746","2023-01-02"
"38099","2022","COM","2020","735","22","757","2023-01-02"
"38100","2022","COM","2020","2476","48","2524","2023-01-02"
"38101","2022","COM","2020","1036","16","1052","2023-01-02"
"38102","2022","COM","2020","641","21","662","2023-01-02"
"38103","2022","COM","2020","304","2","306","2023-01-02"
"38104","2022","COM","2020","1404","30","1434","2023-01-02"
"38105","2022","COM","2020","2428","50","2478","2023-01-02"
"38106","2022","COM","2020","354","9","363","2023-01-02"
"38107","2022","COM","2020","1687","51","1738","2023-01-02"
"38108","2022","COM","2020","126","0","126","2023-01-02"
"38109","2022","COM","2020","1034","36","1070","2023-01-02"
"38110","2022","COM","2020","2300","45","2345","2023-01-02"
"38111","2022","COM","2020","7927","215","8142","2023-01-02"
"38112","2022","COM","2020","98","1","99","2023-01-02"
"38113","2022","COM","2020","535","6","541","2023-01-02"
"38114","2022","COM","2020","1496","37","1533","2023-01-02"
"38115","2022","COM","2020","736","19","755","2023-01-02"
"38116","2022","COM","2020","39","0","39","2023-01-02"
"38117","2022","COM","2020","628","15","643","2023-01-02"
"38118","2022","COM","2020","1635","41","1676","2023-01-02"
"38120","2022","COM","2020","710","17","727","2023-01-02"
"38124","2022","COM","2020","2281","42","2323","2023-01-02"
"38126","2022","COM","2020","4101","131","4232","2023-01-02"
"38127","2022","COM","2020","162","5","167","2023-01-02"
"38128","2022","COM","2020","431","5","436","2023-01-02"
"38129","2022","COM","2020","362","18","380","2023-01-02"
"38130","2022","COM","2020","4817","280","5097","2023-01-02"
"38131","2022","COM","2020","2023","76","2099","2023-01-02"
"38132","2022","COM","2020","72","0","72","2023-01-02"
"38133","2022","COM","2020","5318","405","5723","2023-01-02"
"38134","2022","COM","2020","927","20","947","2023-01-02"
"38135","2022","COM","2020","1287","19","1306","2023-01-02"
"38136","2022","COM","2020","568","16","584","2023-01-02"
"38137","2022","COM","2020","431","13","444","2023-01-02"
"38138","2022","COM","2020","3437","62","3499","2023-01-02"
"38139","2022","COM","2020","1501","20","1521","2023-01-02"
"38140","2022","COM","2020","8193","255","8448","2023-01-02"
"38141","2022","COM","2020","761","14","775","2023-01-02"
"38144","2022","COM","2020","2837","44","2881","2023-01-02"
"38146","2022","COM","2020","820","26","846","2023-01-02"
"38147","2022","COM","2020","881","26","907","2023-01-02"
"38148","2022","COM","2020","3218","74","3292","2023-01-02"
"38149","2022","COM","2020","1690","36","1726","2023-01-02"
"38150","2022","COM","2020","6670","71","6741","2023-01-02"
"38151","2022","COM","2020","36970","211","37181","2023-01-02"
"38152","2022","COM","2020","1464","32","1496","2023-01-02"
"38153","2022","COM","2020","441","21","462","2023-01-02"
"38154","2022","COM","2020","223","3","226","2023-01-02"
"38155","2022","COM","2020","1877","31","1908","2023-01-02"
"38156","2022","COM","2020","968","31","999","2023-01-02"
"38157","2022","COM","2020","3620","74","3694","2023-01-02"
"38158","2022","COM","2020","10112","119","10231","2023-01-02"
"38159","2022","COM","2020","540","8","548","2023-01-02"
"38160","2022","COM","2020","2337","116","2453","2023-01-02"
"38161","2022","COM","2020","1096","19","1115","2023-01-02"
"38162","2022","COM","2020","1471","39","1510","2023-01-02"
"38163","2022","COM","2020","411","9","420","2023-01-02"
"38166","2022","COM","2020","454","10","464","2023-01-02"
"38167","2022","COM","2020","546","4","550","2023-01-02"
"38169","2022","COM","2020","23049","246","23295","2023-01-02"
"38170","2022","COM","2020","3404","35","3439","2023-01-02"
"38171","2022","COM","2020","332","4","336","2023-01-02"
"38172","2022","COM","2020","1641","34","1675","2023-01-02"
"38173","2022","COM","2020","245","7","252","2023-01-02"
"38174","2022","COM","2020","1093","24","1117","2023-01-02"
"38175","2022","COM","2020","3360","58","3418","2023-01-02"
"38176","2022","COM","2020","2120","55","2175","2023-01-02"
"38177","2022","COM","2020","101","0","101","2023-01-02"
"38179","2022","COM","2020","7140","87","7227","2023-01-02"
"38180","2022","COM","2020","1013","38","1051","2023-01-02"
"38181","2022","COM","2020","2488","34","2522","2023-01-02"
"38182","2022","COM","2020","3084","53","3137","2023-01-02"
"38183","2022","COM","2020","510","9","519","2023-01-02"
"38184","2022","COM","2020","1626","20","1646","2023-01-02"
"38185","2022","COM","2020","158240","2243","160483","2023-01-02"
"38186","2022","COM","2020","368","12","380","2023-01-02"
"38187","2022","COM","2020","1794","25","1819","2023-01-02"
"38188","2022","COM","2020","1370","23","1393","2023-01-02"
"38189","2022","COM","2020","4708","66","4774","2023-01-02"
"38190","2022","COM","2020","1161","26","1187","2023-01-02"
"38191","2022","COM","2020","1298","32","1330","2023-01-02"
"38192","2022","COM","2020","208","6","214","2023-01-02"
"38193","2022","COM","2020","16717","268","16985","2023-01-02"
"38194","2022","COM","2020","2148","36","2184","2023-01-02"
"38195","2022","COM","2020","751","9","760","2023-01-02"
"38197","2022","COM","2020","1815","20","1835","2023-01-02"
"38198","2022","COM","2020","1086","23","1109","2023-01-02"
"38199","2022","COM","2020","2171","56","2227","2023-01-02"
"38200","2022","COM","2020","3797","70","3867","2023-01-02"
"38203","2022","COM","2020","467","8","475","2023-01-02"
"38204","2022","COM","2020","192","5","197","2023-01-02"
"38205","2022","COM","2020","2673","121","2794","2023-01-02"
"38206","2022","COM","2020","989","37","1026","2023-01-02"
"38207","2022","COM","2020","152","3","155","2023-01-02"
"38208","2022","COM","2020","148","3","151","2023-01-02"
"38209","2022","COM","2020","239","7","246","2023-01-02"
"38210","2022","COM","2020","898","15","913","2023-01-02"
"38211","2022","COM","2020","351","6","357","2023-01-02"
"38212","2022","COM","2020","1269","10","1279","2023-01-02"
"38213","2022","COM","2020","592","11","603","2023-01-02"
"38214","2022","COM","2020","2178","76","2254","2023-01-02"
"38215","2022","COM","2020","2355","52","2407","2023-01-02"
"38216","2022","COM","2020","55","2","57","2023-01-02"
"38217","2022","COM","2020","71","2","73","2023-01-02"
"38218","2022","COM","2020","1175","21","1196","2023-01-02"
"38219","2022","COM","2020","633","15","648","2023-01-02"
"38221","2022","COM","2020","138","4","142","2023-01-02"
"38222","2022","COM","2020","746","17","763","2023-01-02"
"38223","2022","COM","2020","1872","68","1940","2023-01-02"
"38224","2022","COM","2020","88","3","91","2023-01-02"
"38225","2022","COM","2020","3068","104","3172","2023-01-02"
"38226","2022","COM","2020","1406","66","1472","2023-01-02"
"38228","2022","COM","2020","476","18","494","2023-01-02"
"38229","2022","COM","2020","18221","357","18578","2023-01-02"
"38230","2022","COM","2020","1047","31","1078","2023-01-02"
"38231","2022","COM","2020","1027","28","1055","2023-01-02"
"38232","2022","COM","2020","639","12","651","2023-01-02"
"38235","2022","COM","2020","454","7","461","2023-01-02"
"38236","2022","COM","2020","1743","40","1783","2023-01-02"
"38237","2022","COM","2020","190","4","194","2023-01-02"
"38238","2022","COM","2020","1968","43","2011","2023-01-02"
"38239","2022","COM","2020","7495","152","7647","2023-01-02"
"38240","2022","COM","2020","737","15","752","2023-01-02"
"38241","2022","COM","2020","15","0","15","2023-01-02"
"38242","2022","COM","2020","1449","33","1482","2023-01-02"
"38243","2022","COM","2020","247","6","253","2023-01-02"
"38244","2022","COM","2020","797","19","816","2023-01-02"
"38245","2022","COM","2020","272","4","276","2023-01-02"
"38246","2022","COM","2020","1155","18","1173","2023-01-02"
"38247","2022","COM","2020","3516","54","3570","2023-01-02"
"38248","2022","COM","2020","520","21","541","2023-01-02"
"38249","2022","COM","2020","5457","561","6018","2023-01-02"
"38250","2022","COM","2020","588","18","606","2023-01-02"
"38252","2022","COM","2020","337","9","346","2023-01-02"
"38253","2022","COM","2020","1942","37","1979","2023-01-02"
"38254","2022","COM","2020","496","13","509","2023-01-02"
"38255","2022","COM","2020","140","0","140","2023-01-02"
"38256","2022","COM","2020","1843","24","1867","2023-01-02"
"38257","2022","COM","2020","447","12","459","2023-01-02"
"38258","2022","COM","2020","83","0","83","2023-01-02"
"38259","2022","COM","2020","999","17","1016","2023-01-02"
"38260","2022","COM","2020","523","18","541","2023-01-02"
"38261","2022","COM","2020","4492","114","4606","2023-01-02"
"38263","2022","COM","2020","373","5","378","2023-01-02"
"38264","2022","COM","2020","138","0","138","2023-01-02"
"38265","2022","COM","2020","1707","32","1739","2023-01-02"
"38266","2022","COM","2020","451","11","462","2023-01-02"
"38267","2022","COM","2020","790","15","805","2023-01-02"
"38268","2022","COM","2020","261","6","267","2023-01-02"
"38269","2022","COM","2020","4899","210","5109","2023-01-02"
"38270","2022","COM","2020","1856","70","1926","2023-01-02"
"38271","2022","COM","2020","859","11","870","2023-01-02"
"38272","2022","COM","2020","403","4","407","2023-01-02"
"38273","2022","COM","2020","465","19","484","2023-01-02"
"38275","2022","COM","2020","310","41","351","2023-01-02"
"38276","2022","COM","2020","2648","70","2718","2023-01-02"
"38277","2022","COM","2020","543","6","549","2023-01-02"
"38278","2022","COM","2020","499","9","508","2023-01-02"
"38279","2022","COM","2020","1121","13","1134","2023-01-02"
"38280","2022","COM","2020","524","21","545","2023-01-02"
"38281","2022","COM","2020","2242","77","2319","2023-01-02"
"38282","2022","COM","2020","884","27","911","2023-01-02"
"38283","2022","COM","2020","106","2","108","2023-01-02"
"38284","2022","COM","2020","859","22","881","2023-01-02"
"38285","2022","COM","2020","160","4","164","2023-01-02"
"38286","2022","COM","2020","9","0","9","2023-01-02"
"38287","2022","COM","2020","1063","19","1082","2023-01-02"
"38288","2022","COM","2020","1684","32","1716","2023-01-02"
"38289","2022","COM","2020","213","4","217","2023-01-02"
"38290","2022","COM","2020","858","18","876","2023-01-02"
"38291","2022","COM","2020","1119","19","1138","2023-01-02"
"38292","2022","COM","2020","2526","58","2584","2023-01-02"
"38294","2022","COM","2020","653","17","670","2023-01-02"
"38295","2022","COM","2020","726","17","743","2023-01-02"
"38296","2022","COM","2020","918","39","957","2023-01-02"
"38297","2022","COM","2020","1873","43","1916","2023-01-02"
"38298","2022","COM","2020","6444","55","6499","2023-01-02"
"38299","2022","COM","2020","136","3","139","2023-01-02"
"38300","2022","COM","2020","368","8","376","2023-01-02"
"38301","2022","COM","2020","172","1","173","2023-01-02"
"38303","2022","COM","2020","584","5","589","2023-01-02"
"38304","2022","COM","2020","1506","37","1543","2023-01-02"
"38307","2022","COM","2020","523","9","532","2023-01-02"
"38308","2022","COM","2020","279","2","281","2023-01-02"
"38309","2022","COM","2020","2120","27","2147","2023-01-02"
"38310","2022","COM","2020","1180","25","1205","2023-01-02"
"38311","2022","COM","2020","717","21","738","2023-01-02"
"38313","2022","COM","2020","294","8","302","2023-01-02"
"38314","2022","COM","2020","7349","170","7519","2023-01-02"
"38315","2022","COM","2020","3546","143","3689","2023-01-02"
"38316","2022","COM","2020","6028","42","6070","2023-01-02"
"38317","2022","COM","2020","10879","69","10948","2023-01-02"
"38318","2022","COM","2020","5329","51","5380","2023-01-02"
"38319","2022","COM","2020","795","28","823","2023-01-02"
"38320","2022","COM","2020","1790","40","1830","2023-01-02"
"38321","2022","COM","2020","168","4","172","2023-01-02"
"38322","2022","COM","2020","95","2","97","2023-01-02"
"38323","2022","COM","2020","1156","24","1180","2023-01-02"
"38324","2022","COM","2020","711","18","729","2023-01-02"
"38325","2022","COM","2020","513","9","522","2023-01-02"
"38326","2022","COM","2020","373","12","385","2023-01-02"
"38328","2022","COM","2020","901","33","934","2023-01-02"
"38329","2022","COM","2020","72","0","72","2023-01-02"
"38330","2022","COM","2020","102","1","103","2023-01-02"
"38331","2022","COM","2020","1008","31","1039","2023-01-02"
"38332","2022","COM","2020","3388","49","3437","2023-01-02"
"38333","2022","COM","2020","331","6","337","2023-01-02"
"38334","2022","COM","2020","1314","43","1357","2023-01-02"
"38335","2022","COM","2020","1050","26","1076","2023-01-02"
"38336","2022","COM","2020","2006","35","2041","2023-01-02"
"38337","2022","COM","2020","6645","82","6727","2023-01-02"
"38338","2022","COM","2020","734","9","743","2023-01-02"
"38339","2022","COM","2020","2150","57","2207","2023-01-02"
"38340","2022","COM","2020","1970","38","2008","2023-01-02"
"38341","2022","COM","2020","1094","37","1131","2023-01-02"
"38342","2022","COM","2020","316","7","323","2023-01-02"
"38343","2022","COM","2020","1636","35","1671","2023-01-02"
"38344","2022","COM","2020","8460","118","8578","2023-01-02"
"38345","2022","COM","2020","608","10","618","2023-01-02"
"38346","2022","COM","2020","394","7","401","2023-01-02"
"38347","2022","COM","2020","1123","29","1152","2023-01-02"
"38348","2022","COM","2020","4732","109","4841","2023-01-02"
"38349","2022","COM","2020","2274","42","2316","2023-01-02"
"38350","2022","COM","2020","557","18","575","2023-01-02"
"38351","2022","COM","2020","1110","21","1131","2023-01-02"
"38352","2022","COM","2020","2131","60","2191","2023-01-02"
"38353","2022","COM","2020","880","9","889","2023-01-02"
"38354","2022","COM","2020","414","6","420","2023-01-02"
"38355","2022","COM","2020","123","6","129","2023-01-02"
"38356","2022","COM","2020","321","6","327","2023-01-02"
"38357","2022","COM","2020","2761","141","2902","2023-01-02"
"38358","2022","COM","2020","730","14","744","2023-01-02"
"38359","2022","COM","2020","1197","22","1219","2023-01-02"
"38360","2022","COM","2020","418","8","426","2023-01-02"
"38361","2022","COM","2020","77","2","79","2023-01-02"
"38362","2022","COM","2020","1173","52","1225","2023-01-02"
"38363","2022","COM","2020","920","55","975","2023-01-02"
"38364","2022","COM","2020","428","6","434","2023-01-02"
"38365","2022","COM","2020","828","19","847","2023-01-02"
"38366","2022","COM","2020","259","8","267","2023-01-02"
"38368","2022","COM","2020","1084","25","1109","2023-01-02"
"38369","2022","COM","2020","983","38","1021","2023-01-02"
"38370","2022","COM","2020","656","18","674","2023-01-02"
"38372","2022","COM","2020","718","8","726","2023-01-02"
"38373","2022","COM","2020","1143","42","1185","2023-01-02"
"38374","2022","COM","2020","3731","93","3824","2023-01-02"
"38375","2022","COM","2020","106","0","106","2023-01-02"
"38376","2022","COM","2020","813","9","822","2023-01-02"
"38377","2022","COM","2020","3446","58","3504","2023-01-02"
"38378","2022","COM","2020","3680","85","3765","2023-01-02"
"38379","2022","COM","2020","263","8","271","2023-01-02"
"38380","2022","COM","2020","311","5","316","2023-01-02"
"38381","2022","COM","2020","2124","55","2179","2023-01-02"
"38382","2022","COM","2020","16015","206","16221","2023-01-02"
"38383","2022","COM","2020","2572","109","2681","2023-01-02"
"38384","2022","COM","2020","3207","39","3246","2023-01-02"
"38386","2022","COM","2020","2390","41","2431","2023-01-02"
"38387","2022","COM","2020","497","11","508","2023-01-02"
"38388","2022","COM","2020","2592","33","2625","2023-01-02"
"38389","2022","COM","2020","3466","70","3536","2023-01-02"
"38390","2022","COM","2020","536","9","545","2023-01-02"
"38391","2022","COM","2020","241","5","246","2023-01-02"
"38392","2022","COM","2020","604","20","624","2023-01-02"
"38393","2022","COM","2020","1575","34","1609","2023-01-02"
"38394","2022","COM","2020","1874","32","1906","2023-01-02"
"38395","2022","COM","2020","2397","73","2470","2023-01-02"
"38396","2022","COM","2020","812","25","837","2023-01-02"
"38397","2022","COM","2020","7046","314","7360","2023-01-02"
"38398","2022","COM","2020","981","16","997","2023-01-02"
"38399","2022","COM","2020","4655","104","4759","2023-01-02"
"38400","2022","COM","2020","3563","78","3641","2023-01-02"
"38401","2022","COM","2020","1661","40","1701","2023-01-02"
"38402","2022","COM","2020","530","19","549","2023-01-02"
"38403","2022","COM","2020","289","5","294","2023-01-02"
"38404","2022","COM","2020","292","9","301","2023-01-02"
"38405","2022","COM","2020","1237","30","1267","2023-01-02"
"38406","2022","COM","2020","156","2","158","2023-01-02"
"38407","2022","COM","2020","988","29","1017","2023-01-02"
"38408","2022","COM","2020","2682","62","2744","2023-01-02"
"38409","2022","COM","2020","1361","34","1395","2023-01-02"
"38410","2022","COM","2020","1418","25","1443","2023-01-02"
"38412","2022","COM","2020","4499","102","4601","2023-01-02"
"38413","2022","COM","2020","425","9","434","2023-01-02"
"38414","2022","COM","2020","40","2","42","2023-01-02"
"38415","2022","COM","2020","1437","39","1476","2023-01-02"
"38416","2022","COM","2020","7731","183","7914","2023-01-02"
"38417","2022","COM","2020","481","17","498","2023-01-02"
"38418","2022","COM","2020","235","2","237","2023-01-02"
"38419","2022","COM","2020","183","2","185","2023-01-02"
"38420","2022","COM","2020","247","5","252","2023-01-02"
"38421","2022","COM","2020","38188","267","38455","2023-01-02"
"38422","2022","COM","2020","5529","178","5707","2023-01-02"
"38423","2022","COM","2020","5851","63","5914","2023-01-02"
"38424","2022","COM","2020","174","3","177","2023-01-02"
"38425","2022","COM","2020","6413","93","6506","2023-01-02"
"38426","2022","COM","2020","658","17","675","2023-01-02"
"38427","2022","COM","2020","295","4","299","2023-01-02"
"38428","2022","COM","2020","31","0","31","2023-01-02"
"38429","2022","COM","2020","287","7","294","2023-01-02"
"38430","2022","COM","2020","320","7","327","2023-01-02"
"38431","2022","COM","2020","2978","87","3065","2023-01-02"
"38432","2022","COM","2020","966","23","989","2023-01-02"
"38433","2022","COM","2020","1103","32","1135","2023-01-02"
"38434","2022","COM","2020","650","6","656","2023-01-02"
"38436","2022","COM","2020","2235","47","2282","2023-01-02"
"38437","2022","COM","2020","295","4","299","2023-01-02"
"38438","2022","COM","2020","274","1","275","2023-01-02"
"38439","2022","COM","2020","3380","57","3437","2023-01-02"
"38440","2022","COM","2020","763","16","779","2023-01-02"
"38442","2022","COM","2020","950","26","976","2023-01-02"
"38443","2022","COM","2020","466","16","482","2023-01-02"
"38444","2022","COM","2020","112","5","117","2023-01-02"
"38445","2022","COM","2020","784","6","790","2023-01-02"
"38446","2022","COM","2020","567","14","581","2023-01-02"
"38448","2022","COM","2020","1406","31","1437","2023-01-02"
"38449","2022","COM","2020","6076","46","6122","2023-01-02"
"38450","2022","COM","2020","1483","21","1504","2023-01-02"
"38451","2022","COM","2020","3403","42","3445","2023-01-02"
"38452","2022","COM","2020","401","4","405","2023-01-02"
"38453","2022","COM","2020","1791","40","1831","2023-01-02"
"38454","2022","COM","2020","2111","47","2158","2023-01-02"
"38455","2022","COM","2020","4232","96","4328","2023-01-02"
"38456","2022","COM","2020","491","10","501","2023-01-02"
"38457","2022","COM","2020","2952","64","3016","2023-01-02"
"38458","2022","COM","2020","610","16","626","2023-01-02"
"38459","2022","COM","2020","942","23","965","2023-01-02"
"38460","2022","COM","2020","431","12","443","2023-01-02"
"38462","2022","COM","2020","563","12","575","2023-01-02"
"38463","2022","COM","2020","1717","39","1756","2023-01-02"
"38464","2022","COM","2020","2224","41","2265","2023-01-02"
"38465","2022","COM","2020","1088","23","1111","2023-01-02"
"38466","2022","COM","2020","1495","48","1543","2023-01-02"
"38467","2022","COM","2020","1463","38","1501","2023-01-02"
"38468","2022","COM","2020","4505","71","4576","2023-01-02"
"38469","2022","COM","2020","73","0","73","2023-01-02"
"38470","2022","COM","2020","342","8","350","2023-01-02"
"38471","2022","COM","2020","1133","30","1163","2023-01-02"
"38472","2022","COM","2020","227","4","231","2023-01-02"
"38473","2022","COM","2020","1163","21","1184","2023-01-02"
"38474","2022","COM","2020","11339","206","11545","2023-01-02"
"38475","2022","COM","2020","2500","33","2533","2023-01-02"
"38476","2022","COM","2020","892","12","904","2023-01-02"
"38478","2022","COM","2020","1043","12","1055","2023-01-02"
"38479","2022","COM","2020","2046","56","2102","2023-01-02"
"38480","2022","COM","2020","2088","41","2129","2023-01-02"
"38481","2022","COM","2020","1130","32","1162","2023-01-02"
"38483","2022","COM","2020","1654","51","1705","2023-01-02"
"38484","2022","COM","2020","2116","31","2147","2023-01-02"
"38485","2022","COM","2020","11792","131","11923","2023-01-02"
"38486","2022","COM","2020","7907","116","8023","2023-01-02"
"38487","2022","COM","2020","2063","53","2116","2023-01-02"
"38488","2022","COM","2020","586","17","603","2023-01-02"
"38489","2022","COM","2020","132","1","133","2023-01-02"
"38490","2022","COM","2020","1934","46","1980","2023-01-02"
"38492","2022","COM","2020","711","20","731","2023-01-02"
"38494","2022","COM","2020","810","19","829","2023-01-02"
"38495","2022","COM","2020","594","4","598","2023-01-02"
"38496","2022","COM","2020","1278","26","1304","2023-01-02"
"38497","2022","COM","2020","145","0","145","2023-01-02"
"38498","2022","COM","2020","748","11","759","2023-01-02"
"38499","2022","COM","2020","1173","19","1192","2023-01-02"
"38500","2022","COM","2020","582","11","593","2023-01-02"
"38501","2022","COM","2020","2153","25","2178","2023-01-02"
"38503","2022","COM","2020","2495","124","2619","2023-01-02"
"38504","2022","COM","2020","2011","92","2103","2023-01-02"
"38505","2022","COM","2020","786","15","801","2023-01-02"
"38507","2022","COM","2020","7685","121","7806","2023-01-02"
"38508","2022","COM","2020","821","25","846","2023-01-02"
"38509","2022","COM","2020","8148","205","8353","2023-01-02"
"38511","2022","COM","2020","3166","103","3269","2023-01-02"
"38512","2022","COM","2020","786","25","811","2023-01-02"
"38513","2022","COM","2020","286","11","297","2023-01-02"
"38514","2022","COM","2020","185","5","190","2023-01-02"
"38515","2022","COM","2020","2174","46","2220","2023-01-02"
"38516","2022","COM","2020","6559","141","6700","2023-01-02"
"38517","2022","COM","2020","7755","128","7883","2023-01-02"
"38518","2022","COM","2020","512","13","525","2023-01-02"
"38519","2022","COM","2020","2885","52","2937","2023-01-02"
"38520","2022","COM","2020","692","9","701","2023-01-02"
"38521","2022","COM","2020","65","2","67","2023-01-02"
"38522","2022","COM","2020","142","2","144","2023-01-02"
"38523","2022","COM","2020","845","20","865","2023-01-02"
"38524","2022","COM","2020","8329","154","8483","2023-01-02"
"38525","2022","COM","2020","461","8","469","2023-01-02"
"38526","2022","COM","2020","358","11","369","2023-01-02"
"38527","2022","COM","2020","346","4","350","2023-01-02"
"38528","2022","COM","2020","1341","30","1371","2023-01-02"
"38529","2022","COM","2020","3983","80","4063","2023-01-02"
"38530","2022","COM","2020","2528","50","2578","2023-01-02"
"38531","2022","COM","2020","562","8","570","2023-01-02"
"38532","2022","COM","2020","973","12","985","2023-01-02"
"38533","2022","COM","2020","767","16","783","2023-01-02"
"38535","2022","COM","2020","263","7","270","2023-01-02"
"38536","2022","COM","2020","1439","25","1464","2023-01-02"
"38537","2022","COM","2020","7354","87","7441","2023-01-02"
"38538","2022","COM","2020","4991","66","5057","2023-01-02"
"38539","2022","COM","2020","612","20","632","2023-01-02"
"38540","2022","COM","2020","1420","27","1447","2023-01-02"
"38542","2022","COM","2020","327","15","342","2023-01-02"
"38543","2022","COM","2020","2170","36","2206","2023-01-02"
"38544","2022","COM","2020","30059","342","30401","2023-01-02"
"38545","2022","COM","2020","8614","126","8740","2023-01-02"
"38546","2022","COM","2020","959","27","986","2023-01-02"
"38547","2022","COM","2020","7324","107","7431","2023-01-02"
"38548","2022","COM","2020","4279","213","4492","2023-01-02"
"38549","2022","COM","2020","28","3","31","2023-01-02"
"38550","2022","COM","2020","58","0","58","2023-01-02"
"38551","2022","COM","2020","39","1","40","2023-01-02"
"38552","2022","COM","2020","401","9","410","2023-01-02"
"38553","2022","COM","2020","18891","240","19131","2023-01-02"
"38554","2022","COM","2020","1824","70","1894","2023-01-02"
"38555","2022","COM","2020","1166","30","1196","2023-01-02"
"38556","2022","COM","2020","1182","19","1201","2023-01-02"
"38557","2022","COM","2020","5183","91","5274","2023-01-02"
"38558","2022","COM","2020","1926","31","1957","2023-01-02"
"38559","2022","COM","2020","4405","73","4478","2023-01-02"
"38560","2022","COM","2020","1536","26","1562","2023-01-02"
"38561","2022","COM","2020","1681","35","1716","2023-01-02"
"38562","2022","COM","2020","7305","169","7474","2023-01-02"
"38563","2022","COM","2020","20332","521","20853","2023-01-02"
"38564","2022","COM","2020","238","10","248","2023-01-02"
"38565","2022","COM","2020","9514","374","9888","2023-01-02"
"38566","2022","COM","2020","1697","49","1746","2023-01-02"
"38567","2022","COM","2020","411","5","416","2023-01-02"
"39001","2022","COM","2020","850","24","874","2023-01-02"
"39002","2022","COM","2020","61","1","62","2023-01-02"
"39003","2022","COM","2020","50","0","50","2023-01-02"
"39004","2022","COM","2020","53","3","56","2023-01-02"
"39006","2022","COM","2020","441","16","457","2023-01-02"
"39007","2022","COM","2020","151","5","156","2023-01-02"
"39008","2022","COM","2020","445","49","494","2023-01-02"
"39009","2022","COM","2020","530","15","545","2023-01-02"
"39010","2022","COM","2020","92","2","94","2023-01-02"
"39011","2022","COM","2020","417","7","424","2023-01-02"
"39013","2022","COM","2020","3239","204","3443","2023-01-02"
"39014","2022","COM","2020","215","7","222","2023-01-02"
"39015","2022","COM","2020","115","2","117","2023-01-02"
"39016","2022","COM","2020","1112","30","1142","2023-01-02"
"39017","2022","COM","2020","1196","37","1233","2023-01-02"
"39018","2022","COM","2020","634","7","641","2023-01-02"
"39019","2022","COM","2020","214","9","223","2023-01-02"
"39020","2022","COM","2020","100","4","104","2023-01-02"
"39021","2022","COM","2020","595","14","609","2023-01-02"
"39022","2022","COM","2020","746","11","757","2023-01-02"
"39024","2022","COM","2020","267","6","273","2023-01-02"
"39025","2022","COM","2020","266","3","269","2023-01-02"
"39026","2022","COM","2020","182","1","183","2023-01-02"
"39027","2022","COM","2020","188","6","194","2023-01-02"
"39028","2022","COM","2020","466","5","471","2023-01-02"
"39029","2022","COM","2020","377","9","386","2023-01-02"
"39030","2022","COM","2020","832","20","852","2023-01-02"
"39031","2022","COM","2020","201","2","203","2023-01-02"
"39032","2022","COM","2020","361","17","378","2023-01-02"
"39034","2022","COM","2020","319","9","328","2023-01-02"
"39035","2022","COM","2020","354","9","363","2023-01-02"
"39037","2022","COM","2020","194","4","198","2023-01-02"
"39038","2022","COM","2020","144","2","146","2023-01-02"
"39039","2022","COM","2020","243","5","248","2023-01-02"
"39040","2022","COM","2020","176","2","178","2023-01-02"
"39041","2022","COM","2020","158","6","164","2023-01-02"
"39042","2022","COM","2020","492","22","514","2023-01-02"
"39043","2022","COM","2020","1422","22","1444","2023-01-02"
"39045","2022","COM","2020","78","3","81","2023-01-02"
"39046","2022","COM","2020","75","3","78","2023-01-02"
"39047","2022","COM","2020","516","11","527","2023-01-02"
"39048","2022","COM","2020","251","8","259","2023-01-02"
"39049","2022","COM","2020","406","13","419","2023-01-02"
"39050","2022","COM","2020","157","5","162","2023-01-02"
"39051","2022","COM","2020","417","5","422","2023-01-02"
"39052","2022","COM","2020","70","1","71","2023-01-02"
"39053","2022","COM","2020","211","10","221","2023-01-02"
"39054","2022","COM","2020","104","2","106","2023-01-02"
"39055","2022","COM","2020","47","1","48","2023-01-02"
"39056","2022","COM","2020","1527","30","1557","2023-01-02"
"39057","2022","COM","2020","99","1","100","2023-01-02"
"39058","2022","COM","2020","177","5","182","2023-01-02"
"39059","2022","COM","2020","1650","43","1693","2023-01-02"
"39060","2022","COM","2020","57","0","57","2023-01-02"
"39061","2022","COM","2020","108","5","113","2023-01-02"
"39062","2022","COM","2020","69","0","69","2023-01-02"
"39063","2022","COM","2020","250","4","254","2023-01-02"
"39065","2022","COM","2020","116","0","116","2023-01-02"
"39066","2022","COM","2020","179","6","185","2023-01-02"
"39068","2022","COM","2020","310","9","319","2023-01-02"
"39070","2022","COM","2020","93","2","95","2023-01-02"
"39072","2022","COM","2020","268","6","274","2023-01-02"
"39073","2022","COM","2020","172","6","178","2023-01-02"
"39074","2022","COM","2020","205","8","213","2023-01-02"
"39076","2022","COM","2020","223","2","225","2023-01-02"
"39077","2022","COM","2020","43","2","45","2023-01-02"
"39078","2022","COM","2020","692","13","705","2023-01-02"
"39079","2022","COM","2020","202","9","211","2023-01-02"
"39080","2022","COM","2020","60","2","62","2023-01-02"
"39081","2022","COM","2020","391","9","400","2023-01-02"
"39083","2022","COM","2020","335","6","341","2023-01-02"
"39084","2022","COM","2020","143","5","148","2023-01-02"
"39085","2022","COM","2020","89","1","90","2023-01-02"
"39086","2022","COM","2020","234","2","236","2023-01-02"
"39088","2022","COM","2020","390","10","400","2023-01-02"
"39090","2022","COM","2020","187","4","191","2023-01-02"
"39091","2022","COM","2020","88","1","89","2023-01-02"
"39092","2022","COM","2020","189","0","189","2023-01-02"
"39093","2022","COM","2020","424","10","434","2023-01-02"
"39094","2022","COM","2020","161","7","168","2023-01-02"
"39095","2022","COM","2020","122","5","127","2023-01-02"
"39096","2022","COM","2020","465","9","474","2023-01-02"
"39097","2022","COM","2020","8040","426","8466","2023-01-02"
"39099","2022","COM","2020","442","6","448","2023-01-02"
"39100","2022","COM","2020","104","3","107","2023-01-02"
"39101","2022","COM","2020","1456","34","1490","2023-01-02"
"39102","2022","COM","2020","226","4","230","2023-01-02"
"39103","2022","COM","2020","306","1","307","2023-01-02"
"39104","2022","COM","2020","601","10","611","2023-01-02"
"39105","2022","COM","2020","216","8","224","2023-01-02"
"39106","2022","COM","2020","288","5","293","2023-01-02"
"39107","2022","COM","2020","142","3","145","2023-01-02"
"39108","2022","COM","2020","55","3","58","2023-01-02"
"39109","2022","COM","2020","175","6","181","2023-01-02"
"39110","2022","COM","2020","66","0","66","2023-01-02"
"39111","2022","COM","2020","38","0","38","2023-01-02"
"39112","2022","COM","2020","108","2","110","2023-01-02"
"39114","2022","COM","2020","140","6","146","2023-01-02"
"39116","2022","COM","2020","152","2","154","2023-01-02"
"39117","2022","COM","2020","106","0","106","2023-01-02"
"39118","2022","COM","2020","52","0","52","2023-01-02"
"39119","2022","COM","2020","86","3","89","2023-01-02"
"39120","2022","COM","2020","126","8","134","2023-01-02"
"39121","2022","COM","2020","413","7","420","2023-01-02"
"39122","2022","COM","2020","113","5","118","2023-01-02"
"39124","2022","COM","2020","470","13","483","2023-01-02"
"39126","2022","COM","2020","393","11","404","2023-01-02"
"39127","2022","COM","2020","109","1","110","2023-01-02"
"39128","2022","COM","2020","1563","25","1588","2023-01-02"
"39129","2022","COM","2020","390","14","404","2023-01-02"
"39130","2022","COM","2020","789","40","829","2023-01-02"
"39131","2022","COM","2020","565","13","578","2023-01-02"
"39132","2022","COM","2020","32","0","32","2023-01-02"
"39133","2022","COM","2020","71","2","73","2023-01-02"
"39134","2022","COM","2020","226","8","234","2023-01-02"
"39136","2022","COM","2020","38","2","40","2023-01-02"
"39137","2022","COM","2020","432","13","445","2023-01-02"
"39138","2022","COM","2020","334","7","341","2023-01-02"
"39139","2022","COM","2020","78","0","78","2023-01-02"
"39140","2022","COM","2020","39","0","39","2023-01-02"
"39141","2022","COM","2020","281","6","287","2023-01-02"
"39142","2022","COM","2020","128","2","130","2023-01-02"
"39143","2022","COM","2020","34","0","34","2023-01-02"
"39145","2022","COM","2020","296","19","315","2023-01-02"
"39146","2022","COM","2020","607","24","631","2023-01-02"
"39147","2022","COM","2020","96","4","100","2023-01-02"
"39149","2022","COM","2020","314","5","319","2023-01-02"
"39150","2022","COM","2020","1014","30","1044","2023-01-02"
"39151","2022","COM","2020","127","5","132","2023-01-02"
"39153","2022","COM","2020","803","30","833","2023-01-02"
"39154","2022","COM","2020","1427","40","1467","2023-01-02"
"39155","2022","COM","2020","77","0","77","2023-01-02"
"39156","2022","COM","2020","242","7","249","2023-01-02"
"39157","2022","COM","2020","54","3","57","2023-01-02"
"39159","2022","COM","2020","262","2","264","2023-01-02"
"39160","2022","COM","2020","896","16","912","2023-01-02"
"39162","2022","COM","2020","254","5","259","2023-01-02"
"39163","2022","COM","2020","116","1","117","2023-01-02"
"39164","2022","COM","2020","661","28","689","2023-01-02"
"39165","2022","COM","2020","57","0","57","2023-01-02"
"39166","2022","COM","2020","215","2","217","2023-01-02"
"39167","2022","COM","2020","358","5","363","2023-01-02"
"39168","2022","COM","2020","46","0","46","2023-01-02"
"39169","2022","COM","2020","594","16","610","2023-01-02"
"39170","2022","COM","2020","927","28","955","2023-01-02"
"39171","2022","COM","2020","1143","31","1174","2023-01-02"
"39172","2022","COM","2020","255","4","259","2023-01-02"
"39173","2022","COM","2020","1297","28","1325","2023-01-02"
"39174","2022","COM","2020","65","0","65","2023-01-02"
"39175","2022","COM","2020","71","3","74","2023-01-02"
"39176","2022","COM","2020","526","9","535","2023-01-02"
"39177","2022","COM","2020","973","23","996","2023-01-02"
"39178","2022","COM","2020","77","2","79","2023-01-02"
"39179","2022","COM","2020","235","7","242","2023-01-02"
"39180","2022","COM","2020","256","120","376","2023-01-02"
"39182","2022","COM","2020","679","27","706","2023-01-02"
"39183","2022","COM","2020","634","80","714","2023-01-02"
"39184","2022","COM","2020","191","5","196","2023-01-02"
"39185","2022","COM","2020","390","13","403","2023-01-02"
"39187","2022","COM","2020","274","7","281","2023-01-02"
"39188","2022","COM","2020","349","4","353","2023-01-02"
"39189","2022","COM","2020","2621","76","2697","2023-01-02"
"39190","2022","COM","2020","1315","29","1344","2023-01-02"
"39191","2022","COM","2020","82","5","87","2023-01-02"
"39192","2022","COM","2020","72","1","73","2023-01-02"
"39193","2022","COM","2020","1008","19","1027","2023-01-02"
"39194","2022","COM","2020","481","6","487","2023-01-02"
"39196","2022","COM","2020","118","2","120","2023-01-02"
"39197","2022","COM","2020","363","12","375","2023-01-02"
"39198","2022","COM","2020","23611","872","24483","2023-01-02"
"39199","2022","COM","2020","1220","37","1257","2023-01-02"
"39200","2022","COM","2020","214","6","220","2023-01-02"
"39201","2022","COM","2020","280","39","319","2023-01-02"
"39202","2022","COM","2020","139","1","140","2023-01-02"
"39203","2022","COM","2020","104","2","106","2023-01-02"
"39204","2022","COM","2020","29","1","30","2023-01-02"
"39205","2022","COM","2020","379","10","389","2023-01-02"
"39206","2022","COM","2020","222","8","230","2023-01-02"
"39207","2022","COM","2020","82","3","85","2023-01-02"
"39208","2022","COM","2020","146","4","150","2023-01-02"
"39209","2022","COM","2020","318","7","325","2023-01-02"
"39210","2022","COM","2020","583","13","596","2023-01-02"
"39211","2022","COM","2020","251","3","254","2023-01-02"
"39214","2022","COM","2020","122","1","123","2023-01-02"
"39216","2022","COM","2020","307","12","319","2023-01-02"
"39217","2022","COM","2020","568","16","584","2023-01-02"
"39218","2022","COM","2020","432","9","441","2023-01-02"
"39219","2022","COM","2020","657","8","665","2023-01-02"
"39220","2022","COM","2020","404","10","414","2023-01-02"
"39221","2022","COM","2020","31","1","32","2023-01-02"
"39222","2022","COM","2020","81","7","88","2023-01-02"
"39223","2022","COM","2020","197","5","202","2023-01-02"
"39225","2022","COM","2020","191","6","197","2023-01-02"
"39227","2022","COM","2020","193","2","195","2023-01-02"
"39228","2022","COM","2020","1099","29","1128","2023-01-02"
"39229","2022","COM","2020","205","10","215","2023-01-02"
"39230","2022","COM","2020","75","3","78","2023-01-02"
"39232","2022","COM","2020","454","7","461","2023-01-02"
"39233","2022","COM","2020","2272","44","2316","2023-01-02"
"39234","2022","COM","2020","80","1","81","2023-01-02"
"39235","2022","COM","2020","1192","14","1206","2023-01-02"
"39236","2022","COM","2020","52","0","52","2023-01-02"
"39237","2022","COM","2020","52","4","56","2023-01-02"
"39238","2022","COM","2020","109","7","116","2023-01-02"
"39239","2022","COM","2020","39","2","41","2023-01-02"
"39240","2022","COM","2020","170","5","175","2023-01-02"
"39241","2022","COM","2020","380","8","388","2023-01-02"
"39244","2022","COM","2020","159","5","164","2023-01-02"
"39245","2022","COM","2020","360","10","370","2023-01-02"
"39246","2022","COM","2020","431","13","444","2023-01-02"
"39247","2022","COM","2020","74","1","75","2023-01-02"
"39248","2022","COM","2020","44","0","44","2023-01-02"
"39249","2022","COM","2020","75","4","79","2023-01-02"
"39250","2022","COM","2020","178","3","181","2023-01-02"
"39251","2022","COM","2020","449","95","544","2023-01-02"
"39252","2022","COM","2020","714","11","725","2023-01-02"
"39253","2022","COM","2020","271","8","279","2023-01-02"
"39254","2022","COM","2020","137","6","143","2023-01-02"
"39255","2022","COM","2020","230","5","235","2023-01-02"
"39258","2022","COM","2020","632","14","646","2023-01-02"
"39259","2022","COM","2020","37","0","37","2023-01-02"
"39261","2022","COM","2020","139","3","142","2023-01-02"
"39262","2022","COM","2020","132","1","133","2023-01-02"
"39263","2022","COM","2020","389","13","402","2023-01-02"
"39265","2022","COM","2020","199","4","203","2023-01-02"
"39266","2022","COM","2020","349","2","351","2023-01-02"
"39267","2022","COM","2020","98","4","102","2023-01-02"
"39268","2022","COM","2020","59","1","60","2023-01-02"
"39269","2022","COM","2020","258","5","263","2023-01-02"
"39270","2022","COM","2020","537","59","596","2023-01-02"
"39271","2022","COM","2020","390","17","407","2023-01-02"
"39272","2022","COM","2020","47","3","50","2023-01-02"
"39273","2022","COM","2020","232","4","236","2023-01-02"
"39274","2022","COM","2020","286","12","298","2023-01-02"
"39275","2022","COM","2020","648","17","665","2023-01-02"
"39277","2022","COM","2020","53","1","54","2023-01-02"
"39278","2022","COM","2020","138","2","140","2023-01-02"
"39279","2022","COM","2020","610","12","622","2023-01-02"
"39280","2022","COM","2020","101","2","103","2023-01-02"
"39281","2022","COM","2020","87","2","89","2023-01-02"
"39282","2022","COM","2020","79","2","81","2023-01-02"
"39283","2022","COM","2020","621","18","639","2023-01-02"
"39284","2022","COM","2020","143","1","144","2023-01-02"
"39285","2022","COM","2020","331","8","339","2023-01-02"
"39286","2022","COM","2020","2327","106","2433","2023-01-02"
"39288","2022","COM","2020","384","9","393","2023-01-02"
"39289","2022","COM","2020","348","7","355","2023-01-02"
"39290","2022","COM","2020","466","12","478","2023-01-02"
"39291","2022","COM","2020","239","6","245","2023-01-02"
"39292","2022","COM","2020","156","4","160","2023-01-02"
"39293","2022","COM","2020","206","4","210","2023-01-02"
"39295","2022","COM","2020","160","1","161","2023-01-02"
"39296","2022","COM","2020","214","5","219","2023-01-02"
"39297","2022","COM","2020","1134","31","1165","2023-01-02"
"39298","2022","COM","2020","58","3","61","2023-01-02"
"39299","2022","COM","2020","487","11","498","2023-01-02"
"39300","2022","COM","2020","17092","829","17921","2023-01-02"
"39301","2022","COM","2020","171","4","175","2023-01-02"
"39302","2022","COM","2020","95","4","99","2023-01-02"
"39304","2022","COM","2020","228","9","237","2023-01-02"
"39305","2022","COM","2020","574","10","584","2023-01-02"
"39306","2022","COM","2020","979","29","1008","2023-01-02"
"39307","2022","COM","2020","328","10","338","2023-01-02"
"39308","2022","COM","2020","317","6","323","2023-01-02"
"39310","2022","COM","2020","479","14","493","2023-01-02"
"39312","2022","COM","2020","110","1","111","2023-01-02"
"39313","2022","COM","2020","215","1","216","2023-01-02"
"39314","2022","COM","2020","77","4","81","2023-01-02"
"39315","2022","COM","2020","394","21","415","2023-01-02"
"39317","2022","COM","2020","355","15","370","2023-01-02"
"39318","2022","COM","2020","190","13","203","2023-01-02"
"39319","2022","COM","2020","144","1","145","2023-01-02"
"39320","2022","COM","2020","336","1","337","2023-01-02"
"39321","2022","COM","2020","159","5","164","2023-01-02"
"39322","2022","COM","2020","60","0","60","2023-01-02"
"39323","2022","COM","2020","316","12","328","2023-01-02"
"39324","2022","COM","2020","7","0","7","2023-01-02"
"39325","2022","COM","2020","574","16","590","2023-01-02"
"39326","2022","COM","2020","175","4","179","2023-01-02"
"39327","2022","COM","2020","853","14","867","2023-01-02"
"39328","2022","COM","2020","427","8","435","2023-01-02"
"39329","2022","COM","2020","170","2","172","2023-01-02"
"39330","2022","COM","2020","152","5","157","2023-01-02"
"39331","2022","COM","2020","846","25","871","2023-01-02"
"39333","2022","COM","2020","2133","108","2241","2023-01-02"
"39334","2022","COM","2020","128","5","133","2023-01-02"
"39335","2022","COM","2020","569","13","582","2023-01-02"
"39336","2022","COM","2020","112","4","116","2023-01-02"
"39337","2022","COM","2020","88","1","89","2023-01-02"
"39338","2022","COM","2020","506","9","515","2023-01-02"
"39339","2022","COM","2020","1120","29","1149","2023-01-02"
"39342","2022","COM","2020","123","1","124","2023-01-02"
"39343","2022","COM","2020","16","0","16","2023-01-02"
"39344","2022","COM","2020","333","14","347","2023-01-02"
"39345","2022","COM","2020","397","17","414","2023-01-02"
"39346","2022","COM","2020","111","5","116","2023-01-02"
"39348","2022","COM","2020","414","47","461","2023-01-02"
"39349","2022","COM","2020","490","24","514","2023-01-02"
"39350","2022","COM","2020","306","6","312","2023-01-02"
"39351","2022","COM","2020","147","6","153","2023-01-02"
"39352","2022","COM","2020","137","3","140","2023-01-02"
"39353","2022","COM","2020","164","9","173","2023-01-02"
"39354","2022","COM","2020","372","3","375","2023-01-02"
"39355","2022","COM","2020","235","6","241","2023-01-02"
"39356","2022","COM","2020","207","8","215","2023-01-02"
"39359","2022","COM","2020","32","0","32","2023-01-02"
"39360","2022","COM","2020","173","1","174","2023-01-02"
"39361","2022","COM","2020","194","5","199","2023-01-02"
"39362","2022","COM","2020","3099","331","3430","2023-01-02"
"39363","2022","COM","2020","83","1","84","2023-01-02"
"39364","2022","COM","2020","494","14","508","2023-01-02"
"39365","2022","COM","2020","1287","20","1307","2023-01-02"
"39366","2022","COM","2020","231","16","247","2023-01-02"
"39367","2022","COM","2020","2274","84","2358","2023-01-02"
"39368","2022","COM","2020","5226","270","5496","2023-01-02"
"39370","2022","COM","2020","1062","315","1377","2023-01-02"
"39372","2022","COM","2020","87","8","95","2023-01-02"
"39373","2022","COM","2020","160","5","165","2023-01-02"
"39375","2022","COM","2020","129","0","129","2023-01-02"
"39376","2022","COM","2020","74","2","76","2023-01-02"
"39377","2022","COM","2020","174","8","182","2023-01-02"
"39378","2022","COM","2020","766","15","781","2023-01-02"
"39379","2022","COM","2020","526","11","537","2023-01-02"
"39380","2022","COM","2020","44","2","46","2023-01-02"
"39381","2022","COM","2020","98","3","101","2023-01-02"
"39385","2022","COM","2020","541","7","548","2023-01-02"
"39386","2022","COM","2020","95","0","95","2023-01-02"
"39387","2022","COM","2020","294","6","300","2023-01-02"
"39388","2022","COM","2020","195","8","203","2023-01-02"
"39389","2022","COM","2020","595","14","609","2023-01-02"
"39390","2022","COM","2020","297","12","309","2023-01-02"
"39391","2022","COM","2020","394","12","406","2023-01-02"
"39392","2022","COM","2020","192","3","195","2023-01-02"
"39393","2022","COM","2020","63","2","65","2023-01-02"
"39394","2022","COM","2020","70","4","74","2023-01-02"
"39396","2022","COM","2020","1105","12","1117","2023-01-02"
"39397","2022","COM","2020","1604","47","1651","2023-01-02"
"39398","2022","COM","2020","405","3","408","2023-01-02"
"39399","2022","COM","2020","340","8","348","2023-01-02"
"39400","2022","COM","2020","149","2","151","2023-01-02"
"39401","2022","COM","2020","237","6","243","2023-01-02"
"39402","2022","COM","2020","341","6","347","2023-01-02"
"39403","2022","COM","2020","221","7","228","2023-01-02"
"39404","2022","COM","2020","474","11","485","2023-01-02"
"39405","2022","COM","2020","1004","21","1025","2023-01-02"
"39406","2022","COM","2020","268","3","271","2023-01-02"
"39407","2022","COM","2020","336","6","342","2023-01-02"
"39408","2022","COM","2020","154","6","160","2023-01-02"
"39409","2022","COM","2020","133","4","137","2023-01-02"
"39411","2022","COM","2020","1511","45","1556","2023-01-02"
"39412","2022","COM","2020","312","7","319","2023-01-02"
"39413","2022","COM","2020","329","8","337","2023-01-02"
"39415","2022","COM","2020","1093","9","1102","2023-01-02"
"39418","2022","COM","2020","98","2","100","2023-01-02"
"39419","2022","COM","2020","62","0","62","2023-01-02"
"39420","2022","COM","2020","208","3","211","2023-01-02"
"39421","2022","COM","2020","242","15","257","2023-01-02"
"39422","2022","COM","2020","522","11","533","2023-01-02"
"39423","2022","COM","2020","104","9","113","2023-01-02"
"39424","2022","COM","2020","159","3","162","2023-01-02"
"39425","2022","COM","2020","88","0","88","2023-01-02"
"39426","2022","COM","2020","210","10","220","2023-01-02"
"39427","2022","COM","2020","62","1","63","2023-01-02"
"39428","2022","COM","2020","22","3","25","2023-01-02"
"39429","2022","COM","2020","439","7","446","2023-01-02"
"39430","2022","COM","2020","105","1","106","2023-01-02"
"39431","2022","COM","2020","334","4","338","2023-01-02"
"39432","2022","COM","2020","126","2","128","2023-01-02"
"39434","2022","COM","2020","4013","371","4384","2023-01-02"
"39435","2022","COM","2020","631","22","653","2023-01-02"
"39436","2022","COM","2020","234","0","234","2023-01-02"
"39437","2022","COM","2020","275","4","279","2023-01-02"
"39439","2022","COM","2020","529","11","540","2023-01-02"
"39441","2022","COM","2020","1201","32","1233","2023-01-02"
"39443","2022","COM","2020","118","5","123","2023-01-02"
"39444","2022","COM","2020","60","2","62","2023-01-02"
"39445","2022","COM","2020","282","15","297","2023-01-02"
"39446","2022","COM","2020","248","7","255","2023-01-02"
"39447","2022","COM","2020","268","11","279","2023-01-02"
"39448","2022","COM","2020","461","15","476","2023-01-02"
"39449","2022","COM","2020","264","10","274","2023-01-02"
"39451","2022","COM","2020","505","3","508","2023-01-02"
"39452","2022","COM","2020","527","7","534","2023-01-02"
"39453","2022","COM","2020","448","12","460","2023-01-02"
"39454","2022","COM","2020","92","2","94","2023-01-02"
"39455","2022","COM","2020","53","1","54","2023-01-02"
"39456","2022","COM","2020","345","4","349","2023-01-02"
"39457","2022","COM","2020","55","0","55","2023-01-02"
"39458","2022","COM","2020","241","10","251","2023-01-02"
"39460","2022","COM","2020","193","8","201","2023-01-02"
"39461","2022","COM","2020","84","0","84","2023-01-02"
"39462","2022","COM","2020","676","4","680","2023-01-02"
"39463","2022","COM","2020","231","6","237","2023-01-02"
"39464","2022","COM","2020","212","6","218","2023-01-02"
"39465","2022","COM","2020","203","2","205","2023-01-02"
"39466","2022","COM","2020","123","1","124","2023-01-02"
"39467","2022","COM","2020","153","6","159","2023-01-02"
"39468","2022","COM","2020","139","3","142","2023-01-02"
"39469","2022","COM","2020","116","0","116","2023-01-02"
"39470","2022","COM","2020","3663","75","3738","2023-01-02"
"39471","2022","COM","2020","758","17","775","2023-01-02"
"39472","2022","COM","2020","209","5","214","2023-01-02"
"39473","2022","COM","2020","89","2","91","2023-01-02"
"39474","2022","COM","2020","355","9","364","2023-01-02"
"39475","2022","COM","2020","2379","97","2476","2023-01-02"
"39476","2022","COM","2020","1821","46","1867","2023-01-02"
"39477","2022","COM","2020","260","5","265","2023-01-02"
"39478","2022","COM","2020","8895","244","9139","2023-01-02"
"39479","2022","COM","2020","243","7","250","2023-01-02"
"39480","2022","COM","2020","266","9","275","2023-01-02"
"39481","2022","COM","2020","383","9","392","2023-01-02"
"39485","2022","COM","2020","787","14","801","2023-01-02"
"39486","2022","COM","2020","114","4","118","2023-01-02"
"39487","2022","COM","2020","1824","37","1861","2023-01-02"
"39489","2022","COM","2020","456","11","467","2023-01-02"
"39490","2022","COM","2020","245","5","250","2023-01-02"
"39491","2022","COM","2020","2191","91","2282","2023-01-02"
"39492","2022","COM","2020","229","6","235","2023-01-02"
"39493","2022","COM","2020","232","1","233","2023-01-02"
"39494","2022","COM","2020","368","21","389","2023-01-02"
"39495","2022","COM","2020","70","0","70","2023-01-02"
"39497","2022","COM","2020","94","2","96","2023-01-02"
"39498","2022","COM","2020","619","15","634","2023-01-02"
"39499","2022","COM","2020","192","1","193","2023-01-02"
"39500","2022","COM","2020","2528","150","2678","2023-01-02"
"39501","2022","COM","2020","1171","27","1198","2023-01-02"
"39502","2022","COM","2020","280","8","288","2023-01-02"
"39503","2022","COM","2020","396","15","411","2023-01-02"
"39504","2022","COM","2020","222","7","229","2023-01-02"
"39505","2022","COM","2020","58","3","61","2023-01-02"
"39507","2022","COM","2020","79","1","80","2023-01-02"
"39508","2022","COM","2020","725","9","734","2023-01-02"
"39510","2022","COM","2020","800","22","822","2023-01-02"
"39511","2022","COM","2020","62","3","65","2023-01-02"
"39512","2022","COM","2020","52","2","54","2023-01-02"
"39513","2022","COM","2020","231","1","232","2023-01-02"
"39514","2022","COM","2020","188","8","196","2023-01-02"
"39517","2022","COM","2020","527","14","541","2023-01-02"
"39518","2022","COM","2020","71","2","73","2023-01-02"
"39519","2022","COM","2020","175","5","180","2023-01-02"
"39520","2022","COM","2020","492","9","501","2023-01-02"
"39522","2022","COM","2020","105","2","107","2023-01-02"
"39523","2022","COM","2020","191","9","200","2023-01-02"
"39525","2022","COM","2020","395","9","404","2023-01-02"
"39526","2022","COM","2020","3934","104","4038","2023-01-02"
"39527","2022","COM","2020","121","0","121","2023-01-02"
"39528","2022","COM","2020","383","10","393","2023-01-02"
"39529","2022","COM","2020","64","1","65","2023-01-02"
"39530","2022","COM","2020","848","23","871","2023-01-02"
"39531","2022","COM","2020","184","5","189","2023-01-02"
"39532","2022","COM","2020","38","1","39","2023-01-02"
"39533","2022","COM","2020","215","6","221","2023-01-02"
"39534","2022","COM","2020","250","6","256","2023-01-02"
"39535","2022","COM","2020","456","14","470","2023-01-02"
"39537","2022","COM","2020","461","10","471","2023-01-02"
"39538","2022","COM","2020","61","1","62","2023-01-02"
"39539","2022","COM","2020","296","6","302","2023-01-02"
"39540","2022","COM","2020","189","11","200","2023-01-02"
"39543","2022","COM","2020","219","9","228","2023-01-02"
"39545","2022","COM","2020","170","5","175","2023-01-02"
"39546","2022","COM","2020","355","13","368","2023-01-02"
"39547","2022","COM","2020","677","18","695","2023-01-02"
"39548","2022","COM","2020","73","5","78","2023-01-02"
"39550","2022","COM","2020","193","5","198","2023-01-02"
"39551","2022","COM","2020","115","3","118","2023-01-02"
"39552","2022","COM","2020","297","10","307","2023-01-02"
"39553","2022","COM","2020","289","10","299","2023-01-02"
"39554","2022","COM","2020","227","6","233","2023-01-02"
"39555","2022","COM","2020","252","2","254","2023-01-02"
"39556","2022","COM","2020","95","3","98","2023-01-02"
"39557","2022","COM","2020","184","8","192","2023-01-02"
"39558","2022","COM","2020","297","13","310","2023-01-02"
"39559","2022","COM","2020","392","4","396","2023-01-02"
"39560","2022","COM","2020","604","14","618","2023-01-02"
"39561","2022","COM","2020","385","6","391","2023-01-02"
"39565","2022","COM","2020","89","1","90","2023-01-02"
"39567","2022","COM","2020","298","10","308","2023-01-02"
"39568","2022","COM","2020","38","2","40","2023-01-02"
"39569","2022","COM","2020","676","11","687","2023-01-02"
"39570","2022","COM","2020","222","1","223","2023-01-02"
"39571","2022","COM","2020","235","1","236","2023-01-02"
"39572","2022","COM","2020","390","8","398","2023-01-02"
"39573","2022","COM","2020","781","16","797","2023-01-02"
"39574","2022","COM","2020","711","20","731","2023-01-02"
"39575","2022","COM","2020","89","2","91","2023-01-02"
"39576","2022","COM","2020","936","26","962","2023-01-02"
"39577","2022","COM","2020","395","13","408","2023-01-02"
"39579","2022","COM","2020","890","41","931","2023-01-02"
"39581","2022","COM","2020","273","1","274","2023-01-02"
"39582","2022","COM","2020","785","23","808","2023-01-02"
"39583","2022","COM","2020","184","5","189","2023-01-02"
"39584","2022","COM","2020","162","1","163","2023-01-02"
"39585","2022","COM","2020","20","0","20","2023-01-02"
"39586","2022","COM","2020","28","0","28","2023-01-02"
"40001","2022","COM","2020","6197","556","6753","2023-01-02"
"40002","2022","COM","2020","1565","23","1588","2023-01-02"
"40003","2022","COM","2020","271","9","280","2023-01-02"
"40004","2022","COM","2020","2193","49","2242","2023-01-02"
"40005","2022","COM","2020","202","3","205","2023-01-02"
"40006","2022","COM","2020","706","7","713","2023-01-02"
"40007","2022","COM","2020","166","2","168","2023-01-02"
"40008","2022","COM","2020","99","2","101","2023-01-02"
"40011","2022","COM","2020","329","3","332","2023-01-02"
"40012","2022","COM","2020","263","4","267","2023-01-02"
"40013","2022","COM","2020","97","5","102","2023-01-02"
"40014","2022","COM","2020","358","5","363","2023-01-02"
"40015","2022","COM","2020","46","2","48","2023-01-02"
"40016","2022","COM","2020","260","2","262","2023-01-02"
"40017","2022","COM","2020","393","9","402","2023-01-02"
"40018","2022","COM","2020","388","6","394","2023-01-02"
"40019","2022","COM","2020","1068","29","1097","2023-01-02"
"40020","2022","COM","2020","625","23","648","2023-01-02"
"40021","2022","COM","2020","904","20","924","2023-01-02"
"40022","2022","COM","2020","395","13","408","2023-01-02"
"40023","2022","COM","2020","345","8","353","2023-01-02"
"40024","2022","COM","2020","263","4","267","2023-01-02"
"40025","2022","COM","2020","843","22","865","2023-01-02"
"40026","2022","COM","2020","374","10","384","2023-01-02"
"40027","2022","COM","2020","155","2","157","2023-01-02"
"40028","2022","COM","2020","257","9","266","2023-01-02"
"40029","2022","COM","2020","317","7","324","2023-01-02"
"40030","2022","COM","2020","50","0","50","2023-01-02"
"40031","2022","COM","2020","1198","12","1210","2023-01-02"
"40032","2022","COM","2020","211","2","213","2023-01-02"
"40033","2022","COM","2020","159","5","164","2023-01-02"
"40034","2022","COM","2020","605","25","630","2023-01-02"
"40035","2022","COM","2020","569","10","579","2023-01-02"
"40036","2022","COM","2020","3748","71","3819","2023-01-02"
"40037","2022","COM","2020","1878","46","1924","2023-01-02"
"40038","2022","COM","2020","108","4","112","2023-01-02"
"40039","2022","COM","2020","152","0","152","2023-01-02"
"40040","2022","COM","2020","373","9","382","2023-01-02"
"40041","2022","COM","2020","128","2","130","2023-01-02"
"40042","2022","COM","2020","342","7","349","2023-01-02"
"40043","2022","COM","2020","766","13","779","2023-01-02"
"40044","2022","COM","2020","953","18","971","2023-01-02"
"40046","2022","COM","2020","14034","359","14393","2023-01-02"
"40047","2022","COM","2020","264","6","270","2023-01-02"
"40049","2022","COM","2020","397","6","403","2023-01-02"
"40050","2022","COM","2020","209","2","211","2023-01-02"
"40051","2022","COM","2020","842","27","869","2023-01-02"
"40052","2022","COM","2020","210","4","214","2023-01-02"
"40053","2022","COM","2020","306","4","310","2023-01-02"
"40054","2022","COM","2020","263","6","269","2023-01-02"
"40055","2022","COM","2020","1643","29","1672","2023-01-02"
"40056","2022","COM","2020","763","20","783","2023-01-02"
"40057","2022","COM","2020","248","6","254","2023-01-02"
"40058","2022","COM","2020","227","11","238","2023-01-02"
"40059","2022","COM","2020","765","20","785","2023-01-02"
"40060","2022","COM","2020","139","4","143","2023-01-02"
"40061","2022","COM","2020","994","26","1020","2023-01-02"
"40062","2022","COM","2020","523","7","530","2023-01-02"
"40063","2022","COM","2020","831","17","848","2023-01-02"
"40064","2022","COM","2020","170","3","173","2023-01-02"
"40065","2022","COM","2020","9181","313","9494","2023-01-02"
"40066","2022","COM","2020","538","4","542","2023-01-02"
"40067","2022","COM","2020","636","6","642","2023-01-02"
"40068","2022","COM","2020","584","18","602","2023-01-02"
"40069","2022","COM","2020","416","5","421","2023-01-02"
"40070","2022","COM","2020","406","13","419","2023-01-02"
"40071","2022","COM","2020","605","43","648","2023-01-02"
"40072","2022","COM","2020","186","6","192","2023-01-02"
"40073","2022","COM","2020","119","2","121","2023-01-02"
"40074","2022","COM","2020","558","19","577","2023-01-02"
"40075","2022","COM","2020","2497","28","2525","2023-01-02"
"40076","2022","COM","2020","436","8","444","2023-01-02"
"40077","2022","COM","2020","799","17","816","2023-01-02"
"40078","2022","COM","2020","395","7","402","2023-01-02"
"40079","2022","COM","2020","135","5","140","2023-01-02"
"40080","2022","COM","2020","1128","33","1161","2023-01-02"
"40081","2022","COM","2020","408","6","414","2023-01-02"
"40082","2022","COM","2020","252","7","259","2023-01-02"
"40083","2022","COM","2020","120","7","127","2023-01-02"
"40084","2022","COM","2020","745","34","779","2023-01-02"
"40085","2022","COM","2020","429","12","441","2023-01-02"
"40086","2022","COM","2020","536","8","544","2023-01-02"
"40087","2022","COM","2020","353","5","358","2023-01-02"
"40088","2022","COM","2020","21044","813","21857","2023-01-02"
"40089","2022","COM","2020","856","26","882","2023-01-02"
"40090","2022","COM","2020","462","10","472","2023-01-02"
"40091","2022","COM","2020","646","18","664","2023-01-02"
"40092","2022","COM","2020","221","5","226","2023-01-02"
"40093","2022","COM","2020","253","3","256","2023-01-02"
"40094","2022","COM","2020","751","13","764","2023-01-02"
"40095","2022","COM","2020","703","20","723","2023-01-02"
"40096","2022","COM","2020","103","2","105","2023-01-02"
"40097","2022","COM","2020","460","10","470","2023-01-02"
"40098","2022","COM","2020","353","12","365","2023-01-02"
"40099","2022","COM","2020","323","3","326","2023-01-02"
"40100","2022","COM","2020","409","2","411","2023-01-02"
"40101","2022","COM","2020","474","14","488","2023-01-02"
"40102","2022","COM","2020","1277","229","1506","2023-01-02"
"40103","2022","COM","2020","634","12","646","2023-01-02"
"40104","2022","COM","2020","1460","34","1494","2023-01-02"
"40105","2022","COM","2020","433","13","446","2023-01-02"
"40106","2022","COM","2020","216","6","222","2023-01-02"
"40108","2022","COM","2020","869","17","886","2023-01-02"
"40109","2022","COM","2020","433","9","442","2023-01-02"
"40110","2022","COM","2020","750","15","765","2023-01-02"
"40111","2022","COM","2020","702","16","718","2023-01-02"
"40112","2022","COM","2020","100","1","101","2023-01-02"
"40113","2022","COM","2020","528","9","537","2023-01-02"
"40114","2022","COM","2020","359","13","372","2023-01-02"
"40115","2022","COM","2020","287","10","297","2023-01-02"
"40116","2022","COM","2020","274","3","277","2023-01-02"
"40117","2022","COM","2020","2443","80","2523","2023-01-02"
"40118","2022","COM","2020","1470","29","1499","2023-01-02"
"40119","2022","COM","2020","4631","108","4739","2023-01-02"
"40120","2022","COM","2020","598","17","615","2023-01-02"
"40121","2022","COM","2020","276","5","281","2023-01-02"
"40122","2022","COM","2020","981","28","1009","2023-01-02"
"40123","2022","COM","2020","1158","33","1191","2023-01-02"
"40124","2022","COM","2020","140","2","142","2023-01-02"
"40125","2022","COM","2020","1371","38","1409","2023-01-02"
"40126","2022","COM","2020","1881","43","1924","2023-01-02"
"40127","2022","COM","2020","616","8","624","2023-01-02"
"40128","2022","COM","2020","698","19","717","2023-01-02"
"40129","2022","COM","2020","914","19","933","2023-01-02"
"40130","2022","COM","2020","160","0","160","2023-01-02"
"40131","2022","COM","2020","689","5","694","2023-01-02"
"40132","2022","COM","2020","1417","26","1443","2023-01-02"
"40133","2022","COM","2020","6934","116","7050","2023-01-02"
"40134","2022","COM","2020","2795","36","2831","2023-01-02"
"40135","2022","COM","2020","863","8","871","2023-01-02"
"40136","2022","COM","2020","156","3","159","2023-01-02"
"40137","2022","COM","2020","285","10","295","2023-01-02"
"40138","2022","COM","2020","283","6","289","2023-01-02"
"40139","2022","COM","2020","555","15","570","2023-01-02"
"40140","2022","COM","2020","191","3","194","2023-01-02"
"40141","2022","COM","2020","291","4","295","2023-01-02"
"40142","2022","COM","2020","1054","20","1074","2023-01-02"
"40143","2022","COM","2020","302","4","306","2023-01-02"
"40144","2022","COM","2020","245","9","254","2023-01-02"
"40145","2022","COM","2020","594","22","616","2023-01-02"
"40146","2022","COM","2020","165","3","168","2023-01-02"
"40147","2022","COM","2020","370","3","373","2023-01-02"
"40148","2022","COM","2020","82","3","85","2023-01-02"
"40149","2022","COM","2020","373","5","378","2023-01-02"
"40150","2022","COM","2020","1932","53","1985","2023-01-02"
"40151","2022","COM","2020","432","12","444","2023-01-02"
"40152","2022","COM","2020","1026","25","1051","2023-01-02"
"40153","2022","COM","2020","231","6","237","2023-01-02"
"40154","2022","COM","2020","312","6","318","2023-01-02"
"40155","2022","COM","2020","1513","39","1552","2023-01-02"
"40156","2022","COM","2020","566","5","571","2023-01-02"
"40157","2022","COM","2020","1682","39","1721","2023-01-02"
"40158","2022","COM","2020","274","3","277","2023-01-02"
"40159","2022","COM","2020","320","4","324","2023-01-02"
"40160","2022","COM","2020","180","7","187","2023-01-02"
"40161","2022","COM","2020","84","1","85","2023-01-02"
"40162","2022","COM","2020","575","10","585","2023-01-02"
"40163","2022","COM","2020","581","8","589","2023-01-02"
"40164","2022","COM","2020","362","1","363","2023-01-02"
"40165","2022","COM","2020","380","11","391","2023-01-02"
"40166","2022","COM","2020","75","1","76","2023-01-02"
"40167","2022","COM","2020","654","10","664","2023-01-02"
"40168","2022","COM","2020","2450","37","2487","2023-01-02"
"40169","2022","COM","2020","126","3","129","2023-01-02"
"40170","2022","COM","2020","231","3","234","2023-01-02"
"40171","2022","COM","2020","120","3","123","2023-01-02"
"40172","2022","COM","2020","267","7","274","2023-01-02"
"40173","2022","COM","2020","139","5","144","2023-01-02"
"40174","2022","COM","2020","85","4","89","2023-01-02"
"40175","2022","COM","2020","444","6","450","2023-01-02"
"40176","2022","COM","2020","86","1","87","2023-01-02"
"40177","2022","COM","2020","311","17","328","2023-01-02"
"40178","2022","COM","2020","642","27","669","2023-01-02"
"40179","2022","COM","2020","1841","47","1888","2023-01-02"
"40180","2022","COM","2020","1158","30","1188","2023-01-02"
"40181","2022","COM","2020","986","33","1019","2023-01-02"
"40182","2022","COM","2020","831","11","842","2023-01-02"
"40183","2022","COM","2020","965","30","995","2023-01-02"
"40184","2022","COM","2020","7321","168","7489","2023-01-02"
"40185","2022","COM","2020","354","8","362","2023-01-02"
"40186","2022","COM","2020","822","18","840","2023-01-02"
"40187","2022","COM","2020","1225","19","1244","2023-01-02"
"40188","2022","COM","2020","475","12","487","2023-01-02"
"40189","2022","COM","2020","82","3","85","2023-01-02"
"40190","2022","COM","2020","390","11","401","2023-01-02"
"40191","2022","COM","2020","616","12","628","2023-01-02"
"40192","2022","COM","2020","29953","1413","31366","2023-01-02"
"40193","2022","COM","2020","76","2","78","2023-01-02"
"40194","2022","COM","2020","1193","31","1224","2023-01-02"
"40195","2022","COM","2020","611","13","624","2023-01-02"
"40196","2022","COM","2020","565","13","578","2023-01-02"
"40197","2022","COM","2020","4976","132","5108","2023-01-02"
"40198","2022","COM","2020","173","7","180","2023-01-02"
"40199","2022","COM","2020","269","4","273","2023-01-02"
"40200","2022","COM","2020","669","10","679","2023-01-02"
"40201","2022","COM","2020","1329","103","1432","2023-01-02"
"40202","2022","COM","2020","3259","76","3335","2023-01-02"
"40203","2022","COM","2020","320","13","333","2023-01-02"
"40204","2022","COM","2020","267","4","271","2023-01-02"
"40205","2022","COM","2020","247","8","255","2023-01-02"
"40206","2022","COM","2020","317","13","330","2023-01-02"
"40207","2022","COM","2020","1507","208","1715","2023-01-02"
"40208","2022","COM","2020","365","6","371","2023-01-02"
"40209","2022","COM","2020","5519","120","5639","2023-01-02"
"40210","2022","COM","2020","1032","19","1051","2023-01-02"
"40211","2022","COM","2020","762","18","780","2023-01-02"
"40212","2022","COM","2020","1028","17","1045","2023-01-02"
"40213","2022","COM","2020","640","13","653","2023-01-02"
"40214","2022","COM","2020","499","6","505","2023-01-02"
"40215","2022","COM","2020","286","8","294","2023-01-02"
"40216","2022","COM","2020","197","2","199","2023-01-02"
"40217","2022","COM","2020","6928","195","7123","2023-01-02"
"40218","2022","COM","2020","488","13","501","2023-01-02"
"40219","2022","COM","2020","107","2","109","2023-01-02"
"40220","2022","COM","2020","138","2","140","2023-01-02"
"40221","2022","COM","2020","339","4","343","2023-01-02"
"40222","2022","COM","2020","744","14","758","2023-01-02"
"40223","2022","COM","2020","230","7","237","2023-01-02"
"40224","2022","COM","2020","3637","184","3821","2023-01-02"
"40225","2022","COM","2020","196","2","198","2023-01-02"
"40226","2022","COM","2020","203","3","206","2023-01-02"
"40227","2022","COM","2020","1453","20","1473","2023-01-02"
"40228","2022","COM","2020","1579","29","1608","2023-01-02"
"40229","2022","COM","2020","1673","33","1706","2023-01-02"
"40230","2022","COM","2020","2899","98","2997","2023-01-02"
"40231","2022","COM","2020","1195","33","1228","2023-01-02"
"40232","2022","COM","2020","220","10","230","2023-01-02"
"40233","2022","COM","2020","3105","64","3169","2023-01-02"
"40234","2022","COM","2020","899","28","927","2023-01-02"
"40235","2022","COM","2020","693","19","712","2023-01-02"
"40236","2022","COM","2020","781","19","800","2023-01-02"
"40237","2022","COM","2020","776","6","782","2023-01-02"
"40238","2022","COM","2020","623","18","641","2023-01-02"
"40239","2022","COM","2020","104","3","107","2023-01-02"
"40240","2022","COM","2020","507","18","525","2023-01-02"
"40242","2022","COM","2020","104","0","104","2023-01-02"
"40243","2022","COM","2020","3065","41","3106","2023-01-02"
"40244","2022","COM","2020","1324","30","1354","2023-01-02"
"40245","2022","COM","2020","1927","35","1962","2023-01-02"
"40246","2022","COM","2020","1163","149","1312","2023-01-02"
"40247","2022","COM","2020","179","6","185","2023-01-02"
"40248","2022","COM","2020","1890","28","1918","2023-01-02"
"40249","2022","COM","2020","501","12","513","2023-01-02"
"40250","2022","COM","2020","703","22","725","2023-01-02"
"40251","2022","COM","2020","420","14","434","2023-01-02"
"40252","2022","COM","2020","630","15","645","2023-01-02"
"40253","2022","COM","2020","647","11","658","2023-01-02"
"40254","2022","COM","2020","431","12","443","2023-01-02"
"40255","2022","COM","2020","469","11","480","2023-01-02"
"40256","2022","COM","2020","713","16","729","2023-01-02"
"40257","2022","COM","2020","1340","31","1371","2023-01-02"
"40258","2022","COM","2020","252","3","255","2023-01-02"
"40259","2022","COM","2020","428","14","442","2023-01-02"
"40260","2022","COM","2020","417","7","424","2023-01-02"
"40261","2022","COM","2020","2812","50","2862","2023-01-02"
"40262","2022","COM","2020","317","6","323","2023-01-02"
"40263","2022","COM","2020","411","7","418","2023-01-02"
"40264","2022","COM","2020","1755","25","1780","2023-01-02"
"40265","2022","COM","2020","111","0","111","2023-01-02"
"40266","2022","COM","2020","1687","35","1722","2023-01-02"
"40267","2022","COM","2020","1008","13","1021","2023-01-02"
"40268","2022","COM","2020","699","22","721","2023-01-02"
"40269","2022","COM","2020","1233","38","1271","2023-01-02"
"40270","2022","COM","2020","442","13","455","2023-01-02"
"40271","2022","COM","2020","1201","25","1226","2023-01-02"
"40272","2022","COM","2020","1659","41","1700","2023-01-02"
"40273","2022","COM","2020","6033","137","6170","2023-01-02"
"40274","2022","COM","2020","1370","40","1410","2023-01-02"
"40275","2022","COM","2020","617","19","636","2023-01-02"
"40276","2022","COM","2020","316","8","324","2023-01-02"
"40277","2022","COM","2020","713","50","763","2023-01-02"
"40278","2022","COM","2020","977","16","993","2023-01-02"
"40279","2022","COM","2020","14126","483","14609","2023-01-02"
"40280","2022","COM","2020","1722","32","1754","2023-01-02"
"40281","2022","COM","2020","9726","361","10087","2023-01-02"
"40282","2022","COM","2020","4927","119","5046","2023-01-02"
"40283","2022","COM","2020","3337","187","3524","2023-01-02"
"40284","2022","COM","2020","7798","248","8046","2023-01-02"
"40285","2022","COM","2020","625","14","639","2023-01-02"
"40286","2022","COM","2020","1131","24","1155","2023-01-02"
"40287","2022","COM","2020","4487","66","4553","2023-01-02"
"40288","2022","COM","2020","1153","23","1176","2023-01-02"
"40289","2022","COM","2020","254","1","255","2023-01-02"
"40290","2022","COM","2020","107","3","110","2023-01-02"
"40291","2022","COM","2020","1780","33","1813","2023-01-02"
"40292","2022","COM","2020","1543","73","1616","2023-01-02"
"40293","2022","COM","2020","1100","22","1122","2023-01-02"
"40294","2022","COM","2020","1569","33","1602","2023-01-02"
"40295","2022","COM","2020","1130","19","1149","2023-01-02"
"40296","2022","COM","2020","3890","96","3986","2023-01-02"
"40297","2022","COM","2020","233","3","236","2023-01-02"
"40298","2022","COM","2020","398","12","410","2023-01-02"
"40299","2022","COM","2020","189","11","200","2023-01-02"
"40300","2022","COM","2020","996","35","1031","2023-01-02"
"40301","2022","COM","2020","138","5","143","2023-01-02"
"40303","2022","COM","2020","335","2","337","2023-01-02"
"40304","2022","COM","2020","3497","87","3584","2023-01-02"
"40305","2022","COM","2020","191","8","199","2023-01-02"
"40306","2022","COM","2020","619","13","632","2023-01-02"
"40307","2022","COM","2020","1156","23","1179","2023-01-02"
"40308","2022","COM","2020","889","26","915","2023-01-02"
"40309","2022","COM","2020","1134","19","1153","2023-01-02"
"40310","2022","COM","2020","8318","204","8522","2023-01-02"
"40311","2022","COM","2020","655","14","669","2023-01-02"
"40312","2022","COM","2020","12914","320","13234","2023-01-02"
"40313","2022","COM","2020","3209","46","3255","2023-01-02"
"40314","2022","COM","2020","1283","25","1308","2023-01-02"
"40315","2022","COM","2020","777","11","788","2023-01-02"
"40316","2022","COM","2020","836","19","855","2023-01-02"
"40317","2022","COM","2020","3308","82","3390","2023-01-02"
"40318","2022","COM","2020","323","6","329","2023-01-02"
"40319","2022","COM","2020","255","7","262","2023-01-02"
"40320","2022","COM","2020","602","14","616","2023-01-02"
"40321","2022","COM","2020","243","9","252","2023-01-02"
"40322","2022","COM","2020","203","2","205","2023-01-02"
"40323","2022","COM","2020","246","5","251","2023-01-02"
"40324","2022","COM","2020","258","10","268","2023-01-02"
"40325","2022","COM","2020","278","11","289","2023-01-02"
"40326","2022","COM","2020","1438","34","1472","2023-01-02"
"40327","2022","COM","2020","224","5","229","2023-01-02"
"40328","2022","COM","2020","1637","33","1670","2023-01-02"
"40329","2022","COM","2020","479","6","485","2023-01-02"
"40330","2022","COM","2020","311","8","319","2023-01-02"
"40331","2022","COM","2020","2445","47","2492","2023-01-02"
"40332","2022","COM","2020","2323","56","2379","2023-01-02"
"40333","2022","COM","2020","1344","26","1370","2023-01-02"
"40334","2022","COM","2020","377","13","390","2023-01-02"
"41001","2022","COM","2020","190","5","195","2023-01-02"
"41002","2022","COM","2020","812","21","833","2023-01-02"
"41003","2022","COM","2020","590","198","788","2023-01-02"
"41004","2022","COM","2020","264","5","269","2023-01-02"
"41006","2022","COM","2020","444","8","452","2023-01-02"
"41007","2022","COM","2020","742","13","755","2023-01-02"
"41008","2022","COM","2020","718","20","738","2023-01-02"
"41009","2022","COM","2020","683","17","700","2023-01-02"
"41010","2022","COM","2020","1005","29","1034","2023-01-02"
"41012","2022","COM","2020","204","12","216","2023-01-02"
"41013","2022","COM","2020","273","4","277","2023-01-02"
"41014","2022","COM","2020","160","2","162","2023-01-02"
"41016","2022","COM","2020","1056","15","1071","2023-01-02"
"41017","2022","COM","2020","653","19","672","2023-01-02"
"41018","2022","COM","2020","46660","1467","48127","2023-01-02"
"41019","2022","COM","2020","93","2","95","2023-01-02"
"41020","2022","COM","2020","458","5","463","2023-01-02"
"41022","2022","COM","2020","132","2","134","2023-01-02"
"41024","2022","COM","2020","180","7","187","2023-01-02"
"41025","2022","COM","2020","1321","17","1338","2023-01-02"
"41026","2022","COM","2020","170","3","173","2023-01-02"
"41027","2022","COM","2020","143","2","145","2023-01-02"
"41028","2022","COM","2020","482","9","491","2023-01-02"
"41029","2022","COM","2020","1504","25","1529","2023-01-02"
"41030","2022","COM","2020","226","4","230","2023-01-02"
"41031","2022","COM","2020","2671","71","2742","2023-01-02"
"41032","2022","COM","2020","2683","79","2762","2023-01-02"
"41034","2022","COM","2020","92","1","93","2023-01-02"
"41035","2022","COM","2020","619","13","632","2023-01-02"
"41036","2022","COM","2020","450","8","458","2023-01-02"
"41037","2022","COM","2020","210","4","214","2023-01-02"
"41038","2022","COM","2020","411","12","423","2023-01-02"
"41039","2022","COM","2020","684","19","703","2023-01-02"
"41040","2022","COM","2020","800","27","827","2023-01-02"
"41041","2022","COM","2020","158","3","161","2023-01-02"
"41042","2022","COM","2020","534","4","538","2023-01-02"
"41043","2022","COM","2020","1679","34","1713","2023-01-02"
"41044","2022","COM","2020","1110","14","1124","2023-01-02"
"41045","2022","COM","2020","1082","22","1104","2023-01-02"
"41046","2022","COM","2020","1064","22","1086","2023-01-02"
"41047","2022","COM","2020","4519","113","4632","2023-01-02"
"41048","2022","COM","2020","229","4","233","2023-01-02"
"41049","2022","COM","2020","935","13","948","2023-01-02"
"41050","2022","COM","2020","918","39","957","2023-01-02"
"41051","2022","COM","2020","1075","26","1101","2023-01-02"
"41052","2022","COM","2020","1112","33","1145","2023-01-02"
"41053","2022","COM","2020","527","10","537","2023-01-02"
"41054","2022","COM","2020","342","5","347","2023-01-02"
"41055","2022","COM","2020","2401","54","2455","2023-01-02"
"41057","2022","COM","2020","167","6","173","2023-01-02"
"41058","2022","COM","2020","188","5","193","2023-01-02"
"41059","2022","COM","2020","6663","154","6817","2023-01-02"
"41060","2022","COM","2020","711","10","721","2023-01-02"
"41061","2022","COM","2020","1553","26","1579","2023-01-02"
"41062","2022","COM","2020","545","12","557","2023-01-02"
"41063","2022","COM","2020","494","8","502","2023-01-02"
"41065","2022","COM","2020","574","17","591","2023-01-02"
"41066","2022","COM","2020","431","15","446","2023-01-02"
"41067","2022","COM","2020","2781","77","2858","2023-01-02"
"41068","2022","COM","2020","498","9","507","2023-01-02"
"41069","2022","COM","2020","249","6","255","2023-01-02"
"41070","2022","COM","2020","518","11","529","2023-01-02"
"41071","2022","COM","2020","548","12","560","2023-01-02"
"41072","2022","COM","2020","407","16","423","2023-01-02"
"41073","2022","COM","2020","677","17","694","2023-01-02"
"41074","2022","COM","2020","1214","14","1228","2023-01-02"
"41075","2022","COM","2020","1013","8","1021","2023-01-02"
"41077","2022","COM","2020","127","6","133","2023-01-02"
"41078","2022","COM","2020","823","18","841","2023-01-02"
"41079","2022","COM","2020","101","0","101","2023-01-02"
"41080","2022","COM","2020","1397","28","1425","2023-01-02"
"41081","2022","COM","2020","225","5","230","2023-01-02"
"41083","2022","COM","2020","560","4","564","2023-01-02"
"41084","2022","COM","2020","962","25","987","2023-01-02"
"41085","2022","COM","2020","1056","13","1069","2023-01-02"
"41086","2022","COM","2020","648","8","656","2023-01-02"
"41087","2022","COM","2020","328","5","333","2023-01-02"
"41088","2022","COM","2020","235","4","239","2023-01-02"
"41089","2022","COM","2020","206","2","208","2023-01-02"
"41090","2022","COM","2020","254","6","260","2023-01-02"
"41091","2022","COM","2020","1307","19","1326","2023-01-02"
"41093","2022","COM","2020","272","8","280","2023-01-02"
"41094","2022","COM","2020","1173","31","1204","2023-01-02"
"41095","2022","COM","2020","1053","16","1069","2023-01-02"
"41096","2022","COM","2020","335","2","337","2023-01-02"
"41097","2022","COM","2020","2367","31","2398","2023-01-02"
"41098","2022","COM","2020","170","4","174","2023-01-02"
"41099","2022","COM","2020","495","12","507","2023-01-02"
"41100","2022","COM","2020","169","7","176","2023-01-02"
"41101","2022","COM","2020","1156","32","1188","2023-01-02"
"41102","2022","COM","2020","384","4","388","2023-01-02"
"41103","2022","COM","2020","413","11","424","2023-01-02"
"41104","2022","COM","2020","2322","54","2376","2023-01-02"
"41105","2022","COM","2020","856","16","872","2023-01-02"
"41106","2022","COM","2020","4611","55","4666","2023-01-02"
"41107","2022","COM","2020","476","6","482","2023-01-02"
"41108","2022","COM","2020","122","1","123","2023-01-02"
"41109","2022","COM","2020","740","19","759","2023-01-02"
"41110","2022","COM","2020","830","19","849","2023-01-02"
"41112","2022","COM","2020","242","9","251","2023-01-02"
"41113","2022","COM","2020","178","8","186","2023-01-02"
"41114","2022","COM","2020","282","6","288","2023-01-02"
"41115","2022","COM","2020","398","6","404","2023-01-02"
"41116","2022","COM","2020","198","3","201","2023-01-02"
"41118","2022","COM","2020","196","4","200","2023-01-02"
"41119","2022","COM","2020","342","5","347","2023-01-02"
"41120","2022","COM","2020","1250","35","1285","2023-01-02"
"41121","2022","COM","2020","32","0","32","2023-01-02"
"41122","2022","COM","2020","236","5","241","2023-01-02"
"41123","2022","COM","2020","679","12","691","2023-01-02"
"41124","2022","COM","2020","332","19","351","2023-01-02"
"41125","2022","COM","2020","717","17","734","2023-01-02"
"41126","2022","COM","2020","1159","21","1180","2023-01-02"
"41127","2022","COM","2020","336","4","340","2023-01-02"
"41128","2022","COM","2020","717","19","736","2023-01-02"
"41129","2022","COM","2020","698","12","710","2023-01-02"
"41130","2022","COM","2020","669","13","682","2023-01-02"
"41131","2022","COM","2020","819","27","846","2023-01-02"
"41132","2022","COM","2020","317","6","323","2023-01-02"
"41134","2022","COM","2020","630","21","651","2023-01-02"
"41135","2022","COM","2020","877","12","889","2023-01-02"
"41136","2022","COM","2020","6211","105","6316","2023-01-02"
"41137","2022","COM","2020","570","24","594","2023-01-02"
"41138","2022","COM","2020","313","9","322","2023-01-02"
"41139","2022","COM","2020","1093","13","1106","2023-01-02"
"41140","2022","COM","2020","718","17","735","2023-01-02"
"41141","2022","COM","2020","363","9","372","2023-01-02"
"41142","2022","COM","2020","2331","95","2426","2023-01-02"
"41143","2022","COM","2020","1310","47","1357","2023-01-02"
"41144","2022","COM","2020","727","22","749","2023-01-02"
"41145","2022","COM","2020","794","20","814","2023-01-02"
"41146","2022","COM","2020","958","14","972","2023-01-02"
"41147","2022","COM","2020","1914","42","1956","2023-01-02"
"41148","2022","COM","2020","1305","33","1338","2023-01-02"
"41149","2022","COM","2020","3698","195","3893","2023-01-02"
"41150","2022","COM","2020","3309","91","3400","2023-01-02"
"41151","2022","COM","2020","3675","41","3716","2023-01-02"
"41152","2022","COM","2020","633","12","645","2023-01-02"
"41153","2022","COM","2020","149","2","151","2023-01-02"
"41154","2022","COM","2020","1084","27","1111","2023-01-02"
"41155","2022","COM","2020","1234","32","1266","2023-01-02"
"41156","2022","COM","2020","527","14","541","2023-01-02"
"41157","2022","COM","2020","1517","16","1533","2023-01-02"
"41158","2022","COM","2020","2423","59","2482","2023-01-02"
"41159","2022","COM","2020","1243","16","1259","2023-01-02"
"41160","2022","COM","2020","321","4","325","2023-01-02"
"41161","2022","COM","2020","2321","48","2369","2023-01-02"
"41163","2022","COM","2020","121","2","123","2023-01-02"
"41164","2022","COM","2020","2708","30","2738","2023-01-02"
"41166","2022","COM","2020","385","4","389","2023-01-02"
"41167","2022","COM","2020","3401","87","3488","2023-01-02"
"41168","2022","COM","2020","235","4","239","2023-01-02"
"41171","2022","COM","2020","1702","29","1731","2023-01-02"
"41172","2022","COM","2020","224","2","226","2023-01-02"
"41173","2022","COM","2020","3436","60","3496","2023-01-02"
"41174","2022","COM","2020","174","6","180","2023-01-02"
"41175","2022","COM","2020","1113","20","1133","2023-01-02"
"41176","2022","COM","2020","739","13","752","2023-01-02"
"41177","2022","COM","2020","158","0","158","2023-01-02"
"41178","2022","COM","2020","61","2","63","2023-01-02"
"41179","2022","COM","2020","189","1","190","2023-01-02"
"41180","2022","COM","2020","1518","177","1695","2023-01-02"
"41181","2022","COM","2020","801","21","822","2023-01-02"
"41182","2022","COM","2020","282","11","293","2023-01-02"
"41184","2022","COM","2020","601","7","608","2023-01-02"
"41185","2022","COM","2020","2304","55","2359","2023-01-02"
"41186","2022","COM","2020","301","5","306","2023-01-02"
"41187","2022","COM","2020","176","4","180","2023-01-02"
"41188","2022","COM","2020","117","3","120","2023-01-02"
"41189","2022","COM","2020","474","6","480","2023-01-02"
"41190","2022","COM","2020","220","6","226","2023-01-02"
"41191","2022","COM","2020","67","3","70","2023-01-02"
"41192","2022","COM","2020","266","3","269","2023-01-02"
"41193","2022","COM","2020","140","2","142","2023-01-02"
"41194","2022","COM","2020","18206","479","18685","2023-01-02"
"41195","2022","COM","2020","148","2","150","2023-01-02"
"41196","2022","COM","2020","80","3","83","2023-01-02"
"41198","2022","COM","2020","2839","91","2930","2023-01-02"
"41199","2022","COM","2020","1205","28","1233","2023-01-02"
"41200","2022","COM","2020","477","29","506","2023-01-02"
"41201","2022","COM","2020","320","3","323","2023-01-02"
"41203","2022","COM","2020","492","8","500","2023-01-02"
"41204","2022","COM","2020","1789","42","1831","2023-01-02"
"41205","2022","COM","2020","175","2","177","2023-01-02"
"41206","2022","COM","2020","876","26","902","2023-01-02"
"41207","2022","COM","2020","1141","21","1162","2023-01-02"
"41208","2022","COM","2020","114","4","118","2023-01-02"
"41209","2022","COM","2020","793","42","835","2023-01-02"
"41211","2022","COM","2020","2735","54","2789","2023-01-02"
"41212","2022","COM","2020","3166","96","3262","2023-01-02"
"41213","2022","COM","2020","100","5","105","2023-01-02"
"41214","2022","COM","2020","669","12","681","2023-01-02"
"41215","2022","COM","2020","96","2","98","2023-01-02"
"41216","2022","COM","2020","543","9","552","2023-01-02"
"41217","2022","COM","2020","751","14","765","2023-01-02"
"41218","2022","COM","2020","764","13","777","2023-01-02"
"41219","2022","COM","2020","322","3","325","2023-01-02"
"41220","2022","COM","2020","4299","82","4381","2023-01-02"
"41221","2022","COM","2020","646","17","663","2023-01-02"
"41222","2022","COM","2020","370","6","376","2023-01-02"
"41223","2022","COM","2020","781","10","791","2023-01-02"
"41224","2022","COM","2020","178","1","179","2023-01-02"
"41225","2022","COM","2020","574","11","585","2023-01-02"
"41226","2022","COM","2020","3056","92","3148","2023-01-02"
"41228","2022","COM","2020","294","3","297","2023-01-02"
"41229","2022","COM","2020","1458","33","1491","2023-01-02"
"41230","2022","COM","2020","1833","56","1889","2023-01-02"
"41231","2022","COM","2020","1181","27","1208","2023-01-02"
"41232","2022","COM","2020","4925","98","5023","2023-01-02"
"41233","2022","COM","2020","880","15","895","2023-01-02"
"41234","2022","COM","2020","289","9","298","2023-01-02"
"41235","2022","COM","2020","1010","19","1029","2023-01-02"
"41236","2022","COM","2020","90","3","93","2023-01-02"
"41237","2022","COM","2020","1055","18","1073","2023-01-02"
"41238","2022","COM","2020","1968","27","1995","2023-01-02"
"41239","2022","COM","2020","1002","22","1024","2023-01-02"
"41241","2022","COM","2020","1342","23","1365","2023-01-02"
"41242","2022","COM","2020","4459","63","4522","2023-01-02"
"41243","2022","COM","2020","808","20","828","2023-01-02"
"41245","2022","COM","2020","381","5","386","2023-01-02"
"41246","2022","COM","2020","481","18","499","2023-01-02"
"41247","2022","COM","2020","1618","24","1642","2023-01-02"
"41248","2022","COM","2020","1031","22","1053","2023-01-02"
"41249","2022","COM","2020","1042","14","1056","2023-01-02"
"41250","2022","COM","2020","481","8","489","2023-01-02"
"41251","2022","COM","2020","538","9","547","2023-01-02"
"41252","2022","COM","2020","1548","36","1584","2023-01-02"
"41253","2022","COM","2020","268","5","273","2023-01-02"
"41254","2022","COM","2020","182","4","186","2023-01-02"
"41255","2022","COM","2020","330","6","336","2023-01-02"
"41256","2022","COM","2020","1244","16","1260","2023-01-02"
"41258","2022","COM","2020","1153","23","1176","2023-01-02"
"41259","2022","COM","2020","824","35","859","2023-01-02"
"41260","2022","COM","2020","418","6","424","2023-01-02"
"41261","2022","COM","2020","132","3","135","2023-01-02"
"41262","2022","COM","2020","1119","15","1134","2023-01-02"
"41265","2022","COM","2020","281","11","292","2023-01-02"
"41266","2022","COM","2020","83","3","86","2023-01-02"
"41267","2022","COM","2020","941","16","957","2023-01-02"
"41268","2022","COM","2020","157","2","159","2023-01-02"
"41269","2022","COM","2020","15680","627","16307","2023-01-02"
"41271","2022","COM","2020","606","14","620","2023-01-02"
"41273","2022","COM","2020","457","8","465","2023-01-02"
"41274","2022","COM","2020","126","0","126","2023-01-02"
"41275","2022","COM","2020","1253","25","1278","2023-01-02"
"41276","2022","COM","2020","2490","81","2571","2023-01-02"
"41277","2022","COM","2020","118","0","118","2023-01-02"
"41278","2022","COM","2020","258","7","265","2023-01-02"
"41279","2022","COM","2020","390","6","396","2023-01-02"
"41280","2022","COM","2020","2647","66","2713","2023-01-02"
"41281","2022","COM","2020","422","9","431","2023-01-02"
"41282","2022","COM","2020","428","11","439","2023-01-02"
"41283","2022","COM","2020","272","4","276","2023-01-02"
"41284","2022","COM","2020","64","2","66","2023-01-02"
"41285","2022","COM","2020","487","4","491","2023-01-02"
"41286","2022","COM","2020","149","5","154","2023-01-02"
"41287","2022","COM","2020","498","13","511","2023-01-02"
"41288","2022","COM","2020","810","16","826","2023-01-02"
"41289","2022","COM","2020","388","9","397","2023-01-02"
"41290","2022","COM","2020","234","0","234","2023-01-02"
"41291","2022","COM","2020","318","4","322","2023-01-02"
"41292","2022","COM","2020","200","1","201","2023-01-02"
"41293","2022","COM","2020","247","5","252","2023-01-02"
"41294","2022","COM","2020","1117","59","1176","2023-01-02"
"41295","2022","COM","2020","8084","202","8286","2023-01-02"
"41296","2022","COM","2020","1453","32","1485","2023-01-02"
"41297","2022","COM","2020","780","6","786","2023-01-02"
"42001","2022","COM","2020","462","6","468","2023-01-02"
"42002","2022","COM","2020","178","2","180","2023-01-02"
"42003","2022","COM","2020","1898","46","1944","2023-01-02"
"42005","2022","COM","2020","10108","151","10259","2023-01-02"
"42006","2022","COM","2020","397","9","406","2023-01-02"
"42007","2022","COM","2020","216","5","221","2023-01-02"
"42008","2022","COM","2020","111","1","112","2023-01-02"
"42009","2022","COM","2020","525","5","530","2023-01-02"
"42010","2022","COM","2020","1678","24","1702","2023-01-02"
"42011","2022","COM","2020","2837","55","2892","2023-01-02"
"42012","2022","COM","2020","682","23","705","2023-01-02"
"42013","2022","COM","2020","1987","49","2036","2023-01-02"
"42014","2022","COM","2020","314","8","322","2023-01-02"
"42015","2022","COM","2020","1467","23","1490","2023-01-02"
"42016","2022","COM","2020","423","9","432","2023-01-02"
"42017","2022","COM","2020","479","7","486","2023-01-02"
"42018","2022","COM","2020","460","11","471","2023-01-02"
"42019","2022","COM","2020","3025","67","3092","2023-01-02"
"42020","2022","COM","2020","1185","24","1209","2023-01-02"
"42021","2022","COM","2020","1259","10","1269","2023-01-02"
"42022","2022","COM","2020","4215","57","4272","2023-01-02"
"42023","2022","COM","2020","2950","60","3010","2023-01-02"
"42025","2022","COM","2020","197","4","201","2023-01-02"
"42026","2022","COM","2020","1719","35","1754","2023-01-02"
"42027","2022","COM","2020","398","8","406","2023-01-02"
"42028","2022","COM","2020","384","9","393","2023-01-02"
"42029","2022","COM","2020","1512","47","1559","2023-01-02"
"42030","2022","COM","2020","537","3","540","2023-01-02"
"42031","2022","COM","2020","306","7","313","2023-01-02"
"42032","2022","COM","2020","1701","23","1724","2023-01-02"
"42033","2022","COM","2020","624","25","649","2023-01-02"
"42034","2022","COM","2020","105","7","112","2023-01-02"
"42035","2022","COM","2020","209","9","218","2023-01-02"
"42036","2022","COM","2020","505","15","520","2023-01-02"
"42037","2022","COM","2020","610","24","634","2023-01-02"
"42038","2022","COM","2020","721","11","732","2023-01-02"
"42039","2022","COM","2020","453","5","458","2023-01-02"
"42040","2022","COM","2020","46","2","48","2023-01-02"
"42041","2022","COM","2020","639","6","645","2023-01-02"
"42042","2022","COM","2020","1054","20","1074","2023-01-02"
"42043","2022","COM","2020","1812","36","1848","2023-01-02"
"42044","2022","COM","2020","11857","87","11944","2023-01-02"
"42045","2022","COM","2020","39","1","40","2023-01-02"
"42046","2022","COM","2020","1978","45","2023","2023-01-02"
"42047","2022","COM","2020","324","2","326","2023-01-02"
"42048","2022","COM","2020","1475","30","1505","2023-01-02"
"42049","2022","COM","2020","662","21","683","2023-01-02"
"42050","2022","COM","2020","138","3","141","2023-01-02"
"42051","2022","COM","2020","536","14","550","2023-01-02"
"42052","2022","COM","2020","3714","96","3810","2023-01-02"
"42053","2022","COM","2020","1651","19","1670","2023-01-02"
"42054","2022","COM","2020","355","7","362","2023-01-02"
"42055","2022","COM","2020","133","8","141","2023-01-02"
"42056","2022","COM","2020","2885","50","2935","2023-01-02"
"42058","2022","COM","2020","254","7","261","2023-01-02"
"42059","2022","COM","2020","5436","94","5530","2023-01-02"
"42060","2022","COM","2020","524","6","530","2023-01-02"
"42061","2022","COM","2020","553","14","567","2023-01-02"
"42062","2022","COM","2020","1158","25","1183","2023-01-02"
"42063","2022","COM","2020","399","9","408","2023-01-02"
"42064","2022","COM","2020","754","30","784","2023-01-02"
"42065","2022","COM","2020","1415","53","1468","2023-01-02"
"42066","2022","COM","2020","521","11","532","2023-01-02"
"42067","2022","COM","2020","297","3","300","2023-01-02"
"42068","2022","COM","2020","419","11","430","2023-01-02"
"42069","2022","COM","2020","3018","88","3106","2023-01-02"
"42070","2022","COM","2020","925","24","949","2023-01-02"
"42071","2022","COM","2020","6886","134","7020","2023-01-02"
"42072","2022","COM","2020","64","1","65","2023-01-02"
"42073","2022","COM","2020","741","18","759","2023-01-02"
"42074","2022","COM","2020","1075","27","1102","2023-01-02"
"42075","2022","COM","2020","1356","14","1370","2023-01-02"
"42076","2022","COM","2020","912","23","935","2023-01-02"
"42077","2022","COM","2020","304","6","310","2023-01-02"
"42078","2022","COM","2020","248","10","258","2023-01-02"
"42079","2022","COM","2020","709","13","722","2023-01-02"
"42081","2022","COM","2020","1547","18","1565","2023-01-02"
"42083","2022","COM","2020","529","4","533","2023-01-02"
"42084","2022","COM","2020","160","4","164","2023-01-02"
"42085","2022","COM","2020","843","14","857","2023-01-02"
"42086","2022","COM","2020","516","13","529","2023-01-02"
"42087","2022","COM","2020","1230","53","1283","2023-01-02"
"42088","2022","COM","2020","755","17","772","2023-01-02"
"42089","2022","COM","2020","652","28","680","2023-01-02"
"42090","2022","COM","2020","490","8","498","2023-01-02"
"42091","2022","COM","2020","684","12","696","2023-01-02"
"42092","2022","COM","2020","2702","110","2812","2023-01-02"
"42093","2022","COM","2020","1364","20","1384","2023-01-02"
"42094","2022","COM","2020","8352","136","8488","2023-01-02"
"42095","2022","COM","2020","16953","173","17126","2023-01-02"
"42096","2022","COM","2020","683","11","694","2023-01-02"
"42097","2022","COM","2020","4690","65","4755","2023-01-02"
"42098","2022","COM","2020","579","14","593","2023-01-02"
"42099","2022","COM","2020","3732","54","3786","2023-01-02"
"42100","2022","COM","2020","279","10","289","2023-01-02"
"42101","2022","COM","2020","141","2","143","2023-01-02"
"42102","2022","COM","2020","882","22","904","2023-01-02"
"42103","2022","COM","2020","5100","37","5137","2023-01-02"
"42104","2022","COM","2020","867","21","888","2023-01-02"
"42105","2022","COM","2020","254","4","258","2023-01-02"
"42106","2022","COM","2020","243","7","250","2023-01-02"
"42107","2022","COM","2020","320","9","329","2023-01-02"
"42108","2022","COM","2020","1112","14","1126","2023-01-02"
"42109","2022","COM","2020","108","1","109","2023-01-02"
"42110","2022","COM","2020","4766","40","4806","2023-01-02"
"42112","2022","COM","2020","414","8","422","2023-01-02"
"42113","2022","COM","2020","239","6","245","2023-01-02"
"42115","2022","COM","2020","1226","15","1241","2023-01-02"
"42116","2022","COM","2020","246","9","255","2023-01-02"
"42117","2022","COM","2020","112","8","120","2023-01-02"
"42118","2022","COM","2020","754","18","772","2023-01-02"
"42119","2022","COM","2020","361","10","371","2023-01-02"
"42120","2022","COM","2020","1798","38","1836","2023-01-02"
"42121","2022","COM","2020","163","2","165","2023-01-02"
"42122","2022","COM","2020","1725","78","1803","2023-01-02"
"42123","2022","COM","2020","4746","28","4774","2023-01-02"
"42124","2022","COM","2020","299","6","305","2023-01-02"
"42125","2022","COM","2020","140","2","142","2023-01-02"
"42126","2022","COM","2020","1271","28","1299","2023-01-02"
"42127","2022","COM","2020","7517","133","7650","2023-01-02"
"42128","2022","COM","2020","395","7","402","2023-01-02"
"42129","2022","COM","2020","1827","68","1895","2023-01-02"
"42130","2022","COM","2020","567","9","576","2023-01-02"
"42131","2022","COM","2020","330","8","338","2023-01-02"
"42132","2022","COM","2020","562","16","578","2023-01-02"
"42133","2022","COM","2020","693","19","712","2023-01-02"
"42134","2022","COM","2020","1386","47","1433","2023-01-02"
"42135","2022","COM","2020","543","28","571","2023-01-02"
"42136","2022","COM","2020","780","33","813","2023-01-02"
"42137","2022","COM","2020","804","15","819","2023-01-02"
"42138","2022","COM","2020","672","21","693","2023-01-02"
"42139","2022","COM","2020","1340","70","1410","2023-01-02"
"42140","2022","COM","2020","456","8","464","2023-01-02"
"42141","2022","COM","2020","571","11","582","2023-01-02"
"42142","2022","COM","2020","322","6","328","2023-01-02"
"42143","2022","COM","2020","503","5","508","2023-01-02"
"42145","2022","COM","2020","1100","20","1120","2023-01-02"
"42146","2022","COM","2020","65","3","68","2023-01-02"
"42147","2022","COM","2020","15943","602","16545","2023-01-02"
"42148","2022","COM","2020","501","9","510","2023-01-02"
"42149","2022","COM","2020","5444","106","5550","2023-01-02"
"42150","2022","COM","2020","1358","34","1392","2023-01-02"
"42151","2022","COM","2020","411","77","488","2023-01-02"
"42152","2022","COM","2020","559","326","885","2023-01-02"
"42153","2022","COM","2020","482","8","490","2023-01-02"
"42154","2022","COM","2020","467","50","517","2023-01-02"
"42155","2022","COM","2020","1015","23","1038","2023-01-02"
"42156","2022","COM","2020","1379","19","1398","2023-01-02"
"42157","2022","COM","2020","794","13","807","2023-01-02"
"42158","2022","COM","2020","211","3","214","2023-01-02"
"42159","2022","COM","2020","1577","104","1681","2023-01-02"
"42160","2022","COM","2020","188","6","194","2023-01-02"
"42161","2022","COM","2020","577","18","595","2023-01-02"
"42162","2022","COM","2020","1151","19","1170","2023-01-02"
"42163","2022","COM","2020","1054","19","1073","2023-01-02"
"42164","2022","COM","2020","68","0","68","2023-01-02"
"42165","2022","COM","2020","2883","81","2964","2023-01-02"
"42166","2022","COM","2020","631","16","647","2023-01-02"
"42167","2022","COM","2020","388","10","398","2023-01-02"
"42168","2022","COM","2020","3726","103","3829","2023-01-02"
"42169","2022","COM","2020","1589","27","1616","2023-01-02"
"42170","2022","COM","2020","2106","179","2285","2023-01-02"
"42171","2022","COM","2020","284","7","291","2023-01-02"
"42172","2022","COM","2020","1062","25","1087","2023-01-02"
"42173","2022","COM","2020","358","9","367","2023-01-02"
"42174","2022","COM","2020","1168","23","1191","2023-01-02"
"42175","2022","COM","2020","1207","34","1241","2023-01-02"
"42176","2022","COM","2020","2191","45","2236","2023-01-02"
"42177","2022","COM","2020","2562","53","2615","2023-01-02"
"42178","2022","COM","2020","871","12","883","2023-01-02"
"42179","2022","COM","2020","863","29","892","2023-01-02"
"42180","2022","COM","2020","1033","99","1132","2023-01-02"
"42181","2022","COM","2020","1490","30","1520","2023-01-02"
"42182","2022","COM","2020","3209","107","3316","2023-01-02"
"42183","2022","COM","2020","7943","47","7990","2023-01-02"
"42184","2022","COM","2020","10917","244","11161","2023-01-02"
"42185","2022","COM","2020","715","20","735","2023-01-02"
"42186","2022","COM","2020","15086","122","15208","2023-01-02"
"42187","2022","COM","2020","34415","737","35152","2023-01-02"
"42188","2022","COM","2020","253","4","257","2023-01-02"
"42189","2022","COM","2020","9878","88","9966","2023-01-02"
"42191","2022","COM","2020","989","33","1022","2023-01-02"
"42192","2022","COM","2020","429","5","434","2023-01-02"
"42193","2022","COM","2020","1425","37","1462","2023-01-02"
"42194","2022","COM","2020","201","2","203","2023-01-02"
"42195","2022","COM","2020","987","20","1007","2023-01-02"
"42196","2022","COM","2020","116","4","120","2023-01-02"
"42197","2022","COM","2020","1044","31","1075","2023-01-02"
"42198","2022","COM","2020","916","26","942","2023-01-02"
"42199","2022","COM","2020","1920","60","1980","2023-01-02"
"42200","2022","COM","2020","1518","26","1544","2023-01-02"
"42201","2022","COM","2020","694","29","723","2023-01-02"
"42202","2022","COM","2020","687","16","703","2023-01-02"
"42203","2022","COM","2020","313","1","314","2023-01-02"
"42204","2022","COM","2020","1497","35","1532","2023-01-02"
"42205","2022","COM","2020","689","15","704","2023-01-02"
"42206","2022","COM","2020","1718","36","1754","2023-01-02"
"42207","2022","COM","2020","35309","388","35697","2023-01-02"
"42208","2022","COM","2020","1909","45","1954","2023-01-02"
"42209","2022","COM","2020","390","12","402","2023-01-02"
"42210","2022","COM","2020","477","7","484","2023-01-02"
"42211","2022","COM","2020","2428","34","2462","2023-01-02"
"42212","2022","COM","2020","994","30","1024","2023-01-02"
"42213","2022","COM","2020","310","12","322","2023-01-02"
"42214","2022","COM","2020","1048","29","1077","2023-01-02"
"42215","2022","COM","2020","1265","23","1288","2023-01-02"
"42216","2022","COM","2020","667","17","684","2023-01-02"
"42217","2022","COM","2020","456","7","463","2023-01-02"
"42218","2022","COM","2020","174082","1934","176016","2023-01-02"
"42219","2022","COM","2020","1028","23","1051","2023-01-02"
"42220","2022","COM","2020","606","19","625","2023-01-02"
"42221","2022","COM","2020","531","9","540","2023-01-02"
"42222","2022","COM","2020","5837","129","5966","2023-01-02"
"42223","2022","COM","2020","6185","67","6252","2023-01-02"
"42224","2022","COM","2020","2945","144","3089","2023-01-02"
"42225","2022","COM","2020","3866","87","3953","2023-01-02"
"42226","2022","COM","2020","438","3","441","2023-01-02"
"42227","2022","COM","2020","408","7","415","2023-01-02"
"42228","2022","COM","2020","1465","26","1491","2023-01-02"
"42229","2022","COM","2020","225","6","231","2023-01-02"
"42230","2022","COM","2020","1610","34","1644","2023-01-02"
"42231","2022","COM","2020","1226","70","1296","2023-01-02"
"42232","2022","COM","2020","636","11","647","2023-01-02"
"42233","2022","COM","2020","954","24","978","2023-01-02"
"42234","2022","COM","2020","3659","54","3713","2023-01-02"
"42235","2022","COM","2020","332","5","337","2023-01-02"
"42236","2022","COM","2020","529","10","539","2023-01-02"
"42237","2022","COM","2020","6633","68","6701","2023-01-02"
"42238","2022","COM","2020","324","11","335","2023-01-02"
"42239","2022","COM","2020","1155","24","1179","2023-01-02"
"42240","2022","COM","2020","858","20","878","2023-01-02"
"42241","2022","COM","2020","391","5","396","2023-01-02"
"42242","2022","COM","2020","1949","29","1978","2023-01-02"
"42243","2022","COM","2020","288","5","293","2023-01-02"
"42245","2022","COM","2020","578","13","591","2023-01-02"
"42246","2022","COM","2020","1146","18","1164","2023-01-02"
"42247","2022","COM","2020","282","9","291","2023-01-02"
"42248","2022","COM","2020","1125","38","1163","2023-01-02"
"42249","2022","COM","2020","1661","32","1693","2023-01-02"
"42251","2022","COM","2020","579","13","592","2023-01-02"
"42252","2022","COM","2020","255","2","257","2023-01-02"
"42253","2022","COM","2020","1161","39","1200","2023-01-02"
"42254","2022","COM","2020","792","17","809","2023-01-02"
"42255","2022","COM","2020","278","7","285","2023-01-02"
"42256","2022","COM","2020","5027","51","5078","2023-01-02"
"42257","2022","COM","2020","841","9","850","2023-01-02"
"42259","2022","COM","2020","3799","60","3859","2023-01-02"
"42260","2022","COM","2020","887","58","945","2023-01-02"
"42261","2022","COM","2020","907","19","926","2023-01-02"
"42262","2022","COM","2020","1819","37","1856","2023-01-02"
"42264","2022","COM","2020","965","24","989","2023-01-02"
"42265","2022","COM","2020","869","25","894","2023-01-02"
"42266","2022","COM","2020","660","14","674","2023-01-02"
"42267","2022","COM","2020","1695","45","1740","2023-01-02"
"42268","2022","COM","2020","803","15","818","2023-01-02"
"42269","2022","COM","2020","181","2","183","2023-01-02"
"42270","2022","COM","2020","1354","31","1385","2023-01-02"
"42271","2022","COM","2020","4793","58","4851","2023-01-02"
"42272","2022","COM","2020","1697","38","1735","2023-01-02"
"42273","2022","COM","2020","388","7","395","2023-01-02"
"42274","2022","COM","2020","263","5","268","2023-01-02"
"42275","2022","COM","2020","6088","94","6182","2023-01-02"
"42276","2022","COM","2020","424","6","430","2023-01-02"
"42277","2022","COM","2020","337","0","337","2023-01-02"
"42278","2022","COM","2020","142","1","143","2023-01-02"
"42279","2022","COM","2020","15239","249","15488","2023-01-02"
"42280","2022","COM","2020","411","11","422","2023-01-02"
"42281","2022","COM","2020","132","2","134","2023-01-02"
"42282","2022","COM","2020","239","5","244","2023-01-02"
"42283","2022","COM","2020","1214","28","1242","2023-01-02"
"42284","2022","COM","2020","1419","55","1474","2023-01-02"
"42285","2022","COM","2020","4099","65","4164","2023-01-02"
"42286","2022","COM","2020","948","15","963","2023-01-02"
"42287","2022","COM","2020","1086","23","1109","2023-01-02"
"42288","2022","COM","2020","699","13","712","2023-01-02"
"42289","2022","COM","2020","1923","62","1985","2023-01-02"
"42290","2022","COM","2020","591","19","610","2023-01-02"
"42293","2022","COM","2020","1207","21","1228","2023-01-02"
"42294","2022","COM","2020","979","27","1006","2023-01-02"
"42295","2022","COM","2020","561","7","568","2023-01-02"
"42296","2022","COM","2020","552","15","567","2023-01-02"
"42297","2022","COM","2020","598","30","628","2023-01-02"
"42298","2022","COM","2020","373","4","377","2023-01-02"
"42299","2022","COM","2020","3448","75","3523","2023-01-02"
"42300","2022","COM","2020","646","15","661","2023-01-02"
"42301","2022","COM","2020","707","9","716","2023-01-02"
"42302","2022","COM","2020","8009","171","8180","2023-01-02"
"42303","2022","COM","2020","265","6","271","2023-01-02"
"42304","2022","COM","2020","6706","272","6978","2023-01-02"
"42305","2022","COM","2020","7044","99","7143","2023-01-02"
"42306","2022","COM","2020","492","12","504","2023-01-02"
"42307","2022","COM","2020","926","18","944","2023-01-02"
"42308","2022","COM","2020","772","8","780","2023-01-02"
"42310","2022","COM","2020","144","2","146","2023-01-02"
"42311","2022","COM","2020","1462","38","1500","2023-01-02"
"42312","2022","COM","2020","623","17","640","2023-01-02"
"42313","2022","COM","2020","667","20","687","2023-01-02"
"42314","2022","COM","2020","285","2","287","2023-01-02"
"42315","2022","COM","2020","424","14","438","2023-01-02"
"42316","2022","COM","2020","8448","77","8525","2023-01-02"
"42317","2022","COM","2020","122","4","126","2023-01-02"
"42318","2022","COM","2020","1490","22","1512","2023-01-02"
"42319","2022","COM","2020","690","11","701","2023-01-02"
"42320","2022","COM","2020","707","10","717","2023-01-02"
"42321","2022","COM","2020","102","1","103","2023-01-02"
"42322","2022","COM","2020","1082","26","1108","2023-01-02"
"42323","2022","COM","2020","9001","106","9107","2023-01-02"
"42324","2022","COM","2020","1193","16","1209","2023-01-02"
"42325","2022","COM","2020","382","4","386","2023-01-02"
"42326","2022","COM","2020","898","29","927","2023-01-02"
"42327","2022","COM","2020","663","14","677","2023-01-02"
"42328","2022","COM","2020","719","74","793","2023-01-02"
"42329","2022","COM","2020","379","5","384","2023-01-02"
"42330","2022","COM","2020","7861","133","7994","2023-01-02"
"42331","2022","COM","2020","1024","31","1055","2023-01-02"
"42332","2022","COM","2020","5097","136","5233","2023-01-02"
"42333","2022","COM","2020","591","13","604","2023-01-02"
"42334","2022","COM","2020","1235","17","1252","2023-01-02"
"42335","2022","COM","2020","445","18","463","2023-01-02"
"42336","2022","COM","2020","632","17","649","2023-01-02"
"42337","2022","COM","2020","224","5","229","2023-01-02"
"42338","2022","COM","2020","1497","63","1560","2023-01-02"
"42339","2022","COM","2020","214","5","219","2023-01-02"
"43001","2022","COM","2020","174","4","178","2023-01-02"
"43002","2022","COM","2020","1454","62","1516","2023-01-02"
"43003","2022","COM","2020","873","18","891","2023-01-02"
"43004","2022","COM","2020","119","7","126","2023-01-02"
"43005","2022","COM","2020","153","2","155","2023-01-02"
"43006","2022","COM","2020","128","2","130","2023-01-02"
"43007","2022","COM","2020","604","18","622","2023-01-02"
"43008","2022","COM","2020","142","5","147","2023-01-02"
"43009","2022","COM","2020","23","0","23","2023-01-02"
"43010","2022","COM","2020","1200","30","1230","2023-01-02"
"43011","2022","COM","2020","180","5","185","2023-01-02"
"43012","2022","COM","2020","6166","83","6249","2023-01-02"
"43013","2022","COM","2020","303","9","312","2023-01-02"
"43014","2022","COM","2020","53","2","55","2023-01-02"
"43015","2022","COM","2020","49","0","49","2023-01-02"
"43016","2022","COM","2020","905","25","930","2023-01-02"
"43017","2022","COM","2020","287","7","294","2023-01-02"
"43018","2022","COM","2020","1388","127","1515","2023-01-02"
"43019","2022","COM","2020","110","2","112","2023-01-02"
"43020","2022","COM","2020","4461","69","4530","2023-01-02"
"43021","2022","COM","2020","1043","19","1062","2023-01-02"
"43022","2022","COM","2020","270","12","282","2023-01-02"
"43023","2022","COM","2020","207","2","209","2023-01-02"
"43024","2022","COM","2020","849","14","863","2023-01-02"
"43025","2022","COM","2020","2986","69","3055","2023-01-02"
"43026","2022","COM","2020","448","10","458","2023-01-02"
"43027","2022","COM","2020","44","0","44","2023-01-02"
"43028","2022","COM","2020","480","16","496","2023-01-02"
"43029","2022","COM","2020","99","4","103","2023-01-02"
"43030","2022","COM","2020","405","10","415","2023-01-02"
"43031","2022","COM","2020","134","5","139","2023-01-02"
"43032","2022","COM","2020","1703","51","1754","2023-01-02"
"43033","2022","COM","2020","634","11","645","2023-01-02"
"43034","2022","COM","2020","358","1","359","2023-01-02"
"43035","2022","COM","2020","76","1","77","2023-01-02"
"43036","2022","COM","2020","406","7","413","2023-01-02"
"43037","2022","COM","2020","280","7","287","2023-01-02"
"43038","2022","COM","2020","1002","26","1028","2023-01-02"
"43039","2022","COM","2020","610","14","624","2023-01-02"
"43040","2022","COM","2020","6537","314","6851","2023-01-02"
"43041","2022","COM","2020","4238","226","4464","2023-01-02"
"43042","2022","COM","2020","700","19","719","2023-01-02"
"43043","2022","COM","2020","475","7","482","2023-01-02"
"43044","2022","COM","2020","207","5","212","2023-01-02"
"43045","2022","COM","2020","431","15","446","2023-01-02"
"43046","2022","COM","2020","2429","70","2499","2023-01-02"
"43047","2022","COM","2020","336","9","345","2023-01-02"
"43048","2022","COM","2020","608","37","645","2023-01-02"
"43049","2022","COM","2020","497","9","506","2023-01-02"
"43050","2022","COM","2020","126","0","126","2023-01-02"
"43051","2022","COM","2020","2420","45","2465","2023-01-02"
"43052","2022","COM","2020","190","5","195","2023-01-02"
"43053","2022","COM","2020","205","3","208","2023-01-02"
"43054","2022","COM","2020","173","10","183","2023-01-02"
"43055","2022","COM","2020","162","4","166","2023-01-02"
"43056","2022","COM","2020","419","13","432","2023-01-02"
"43057","2022","COM","2020","47","1","48","2023-01-02"
"43058","2022","COM","2020","1072","29","1101","2023-01-02"
"43059","2022","COM","2020","110","1","111","2023-01-02"
"43060","2022","COM","2020","67","4","71","2023-01-02"
"43061","2022","COM","2020","868","22","890","2023-01-02"
"43062","2022","COM","2020","810","14","824","2023-01-02"
"43063","2022","COM","2020","155","1","156","2023-01-02"
"43064","2022","COM","2020","65","4","69","2023-01-02"
"43065","2022","COM","2020","120","4","124","2023-01-02"
"43066","2022","COM","2020","121","4","125","2023-01-02"
"43067","2022","COM","2020","266","7","273","2023-01-02"
"43068","2022","COM","2020","32","2","34","2023-01-02"
"43069","2022","COM","2020","310","12","322","2023-01-02"
"43070","2022","COM","2020","167","3","170","2023-01-02"
"43071","2022","COM","2020","462","5","467","2023-01-02"
"43072","2022","COM","2020","153","4","157","2023-01-02"
"43073","2022","COM","2020","132","3","135","2023-01-02"
"43074","2022","COM","2020","875","23","898","2023-01-02"
"43075","2022","COM","2020","72","4","76","2023-01-02"
"43076","2022","COM","2020","132","2","134","2023-01-02"
"43077","2022","COM","2020","543","9","552","2023-01-02"
"43078","2022","COM","2020","3216","82","3298","2023-01-02"
"43079","2022","COM","2020","296","5","301","2023-01-02"
"43080","2022","COM","2020","1968","20","1988","2023-01-02"
"43082","2022","COM","2020","69","2","71","2023-01-02"
"43083","2022","COM","2020","149","4","153","2023-01-02"
"43084","2022","COM","2020","1673","34","1707","2023-01-02"
"43085","2022","COM","2020","55","4","59","2023-01-02"
"43086","2022","COM","2020","171","8","179","2023-01-02"
"43087","2022","COM","2020","2665","62","2727","2023-01-02"
"43088","2022","COM","2020","331","9","340","2023-01-02"
"43089","2022","COM","2020","3521","127","3648","2023-01-02"
"43090","2022","COM","2020","127","4","131","2023-01-02"
"43091","2022","COM","2020","319","17","336","2023-01-02"
"43092","2022","COM","2020","358","8","366","2023-01-02"
"43093","2022","COM","2020","317","7","324","2023-01-02"
"43094","2022","COM","2020","80","2","82","2023-01-02"
"43095","2022","COM","2020","139","3","142","2023-01-02"
"43096","2022","COM","2020","886","222","1108","2023-01-02"
"43097","2022","COM","2020","105","2","107","2023-01-02"
"43098","2022","COM","2020","109","5","114","2023-01-02"
"43099","2022","COM","2020","552","6","558","2023-01-02"
"43100","2022","COM","2020","181","2","183","2023-01-02"
"43101","2022","COM","2020","56","6","62","2023-01-02"
"43102","2022","COM","2020","1114","17","1131","2023-01-02"
"43103","2022","COM","2020","112","1","113","2023-01-02"
"43104","2022","COM","2020","193","4","197","2023-01-02"
"43105","2022","COM","2020","179","5","184","2023-01-02"
"43106","2022","COM","2020","145","4","149","2023-01-02"
"43107","2022","COM","2020","84","0","84","2023-01-02"
"43108","2022","COM","2020","437","8","445","2023-01-02"
"43109","2022","COM","2020","78","3","81","2023-01-02"
"43110","2022","COM","2020","838","14","852","2023-01-02"
"43111","2022","COM","2020","872","24","896","2023-01-02"
"43112","2022","COM","2020","3451","77","3528","2023-01-02"
"43113","2022","COM","2020","1929","55","1984","2023-01-02"
"43114","2022","COM","2020","1736","38","1774","2023-01-02"
"43115","2022","COM","2020","1015","18","1033","2023-01-02"
"43116","2022","COM","2020","63","2","65","2023-01-02"
"43117","2022","COM","2020","250","6","256","2023-01-02"
"43118","2022","COM","2020","266","6","272","2023-01-02"
"43119","2022","COM","2020","829","18","847","2023-01-02"
"43120","2022","COM","2020","1317","26","1343","2023-01-02"
"43121","2022","COM","2020","215","5","220","2023-01-02"
"43122","2022","COM","2020","292","8","300","2023-01-02"
"43123","2022","COM","2020","403","15","418","2023-01-02"
"43124","2022","COM","2020","938","17","955","2023-01-02"
"43125","2022","COM","2020","88","2","90","2023-01-02"
"43126","2022","COM","2020","762","15","777","2023-01-02"
"43127","2022","COM","2020","858","18","876","2023-01-02"
"43128","2022","COM","2020","137","2","139","2023-01-02"
"43129","2022","COM","2020","152","7","159","2023-01-02"
"43130","2022","COM","2020","1111","29","1140","2023-01-02"
"43131","2022","COM","2020","196","2","198","2023-01-02"
"43132","2022","COM","2020","1441","43","1484","2023-01-02"
"43133","2022","COM","2020","142","3","145","2023-01-02"
"43134","2022","COM","2020","146","4","150","2023-01-02"
"43135","2022","COM","2020","1754","32","1786","2023-01-02"
"43136","2022","COM","2020","213","1","214","2023-01-02"
"43137","2022","COM","2020","8962","431","9393","2023-01-02"
"43138","2022","COM","2020","414","12","426","2023-01-02"
"43139","2022","COM","2020","54","0","54","2023-01-02"
"43140","2022","COM","2020","682","17","699","2023-01-02"
"43141","2022","COM","2020","1152","23","1175","2023-01-02"
"43142","2022","COM","2020","581","9","590","2023-01-02"
"43143","2022","COM","2020","126","0","126","2023-01-02"
"43144","2022","COM","2020","100","3","103","2023-01-02"
"43145","2022","COM","2020","54","0","54","2023-01-02"
"43147","2022","COM","2020","640","24","664","2023-01-02"
"43148","2022","COM","2020","864","13","877","2023-01-02"
"43149","2022","COM","2020","117","4","121","2023-01-02"
"43150","2022","COM","2020","474","12","486","2023-01-02"
"43151","2022","COM","2020","189","5","194","2023-01-02"
"43152","2022","COM","2020","2818","87","2905","2023-01-02"
"43153","2022","COM","2020","1889","36","1925","2023-01-02"
"43154","2022","COM","2020","545","14","559","2023-01-02"
"43155","2022","COM","2020","61","1","62","2023-01-02"
"43156","2022","COM","2020","114","6","120","2023-01-02"
"43157","2022","COM","2020","18947","837","19784","2023-01-02"
"43158","2022","COM","2020","347","12","359","2023-01-02"
"43159","2022","COM","2020","941","24","965","2023-01-02"
"43160","2022","COM","2020","196","2","198","2023-01-02"
"43162","2022","COM","2020","2986","57","3043","2023-01-02"
"43163","2022","COM","2020","1182","17","1199","2023-01-02"
"43164","2022","COM","2020","479","4","483","2023-01-02"
"43165","2022","COM","2020","1528","29","1557","2023-01-02"
"43166","2022","COM","2020","380","16","396","2023-01-02"
"43167","2022","COM","2020","196","4","200","2023-01-02"
"43168","2022","COM","2020","116","3","119","2023-01-02"
"43169","2022","COM","2020","51","0","51","2023-01-02"
"43170","2022","COM","2020","453","6","459","2023-01-02"
"43171","2022","COM","2020","81","4","85","2023-01-02"
"43172","2022","COM","2020","215","3","218","2023-01-02"
"43173","2022","COM","2020","92","2","94","2023-01-02"
"43174","2022","COM","2020","948","13","961","2023-01-02"
"43175","2022","COM","2020","165","7","172","2023-01-02"
"43177","2022","COM","2020","3459","53","3512","2023-01-02"
"43178","2022","COM","2020","194","8","202","2023-01-02"
"43180","2022","COM","2020","96","5","101","2023-01-02"
"43181","2022","COM","2020","752","20","772","2023-01-02"
"43182","2022","COM","2020","53","2","55","2023-01-02"
"43183","2022","COM","2020","115","2","117","2023-01-02"
"43184","2022","COM","2020","2468","37","2505","2023-01-02"
"43185","2022","COM","2020","3226","77","3303","2023-01-02"
"43186","2022","COM","2020","406","5","411","2023-01-02"
"43187","2022","COM","2020","321","4","325","2023-01-02"
"43188","2022","COM","2020","476","7","483","2023-01-02"
"43189","2022","COM","2020","520","15","535","2023-01-02"
"43190","2022","COM","2020","3597","104","3701","2023-01-02"
"43191","2022","COM","2020","245","5","250","2023-01-02"
"43192","2022","COM","2020","281","10","291","2023-01-02"
"43193","2022","COM","2020","161","2","163","2023-01-02"
"43194","2022","COM","2020","697","22","719","2023-01-02"
"43195","2022","COM","2020","185","5","190","2023-01-02"
"43196","2022","COM","2020","177","2","179","2023-01-02"
"43197","2022","COM","2020","346","7","353","2023-01-02"
"43198","2022","COM","2020","298","9","307","2023-01-02"
"43199","2022","COM","2020","967","25","992","2023-01-02"
"43200","2022","COM","2020","2010","45","2055","2023-01-02"
"43201","2022","COM","2020","246","7","253","2023-01-02"
"43202","2022","COM","2020","65","3","68","2023-01-02"
"43203","2022","COM","2020","490","13","503","2023-01-02"
"43204","2022","COM","2020","171","1","172","2023-01-02"
"43205","2022","COM","2020","4240","61","4301","2023-01-02"
"43206","2022","COM","2020","404","16","420","2023-01-02"
"43207","2022","COM","2020","248","11","259","2023-01-02"
"43208","2022","COM","2020","41","2","43","2023-01-02"
"43210","2022","COM","2020","236","7","243","2023-01-02"
"43211","2022","COM","2020","2623","70","2693","2023-01-02"
"43212","2022","COM","2020","1004","17","1021","2023-01-02"
"43213","2022","COM","2020","2300","53","2353","2023-01-02"
"43214","2022","COM","2020","110","5","115","2023-01-02"
"43215","2022","COM","2020","184","4","188","2023-01-02"
"43216","2022","COM","2020","2428","58","2486","2023-01-02"
"43217","2022","COM","2020","544","11","555","2023-01-02"
"43218","2022","COM","2020","1196","29","1225","2023-01-02"
"43219","2022","COM","2020","114","5","119","2023-01-02"
"43220","2022","COM","2020","174","4","178","2023-01-02"
"43221","2022","COM","2020","397","6","403","2023-01-02"
"43222","2022","COM","2020","165","2","167","2023-01-02"
"43223","2022","COM","2020","1111","23","1134","2023-01-02"
"43224","2022","COM","2020","6023","97","6120","2023-01-02"
"43225","2022","COM","2020","51","0","51","2023-01-02"
"43226","2022","COM","2020","105","4","109","2023-01-02"
"43227","2022","COM","2020","816","18","834","2023-01-02"
"43228","2022","COM","2020","90","3","93","2023-01-02"
"43229","2022","COM","2020","610","12","622","2023-01-02"
"43230","2022","COM","2020","1040","18","1058","2023-01-02"
"43231","2022","COM","2020","142","5","147","2023-01-02"
"43232","2022","COM","2020","347","12","359","2023-01-02"
"43233","2022","COM","2020","1084","40","1124","2023-01-02"
"43234","2022","COM","2020","1694","126","1820","2023-01-02"
"43236","2022","COM","2020","1485","20","1505","2023-01-02"
"43237","2022","COM","2020","227","4","231","2023-01-02"
"43238","2022","COM","2020","300","7","307","2023-01-02"
"43239","2022","COM","2020","804","15","819","2023-01-02"
"43240","2022","COM","2020","266","5","271","2023-01-02"
"43241","2022","COM","2020","1274","33","1307","2023-01-02"
"43242","2022","COM","2020","72","2","74","2023-01-02"
"43244","2022","COM","2020","3099","76","3175","2023-01-02"
"43245","2022","COM","2020","218","8","226","2023-01-02"
"43246","2022","COM","2020","457","18","475","2023-01-02"
"43247","2022","COM","2020","68","1","69","2023-01-02"
"43249","2022","COM","2020","527","12","539","2023-01-02"
"43250","2022","COM","2020","42","4","46","2023-01-02"
"43251","2022","COM","2020","3421","122","3543","2023-01-02"
"43252","2022","COM","2020","25","2","27","2023-01-02"
"43253","2022","COM","2020","193","9","202","2023-01-02"
"43254","2022","COM","2020","266","4","270","2023-01-02"
"43256","2022","COM","2020","341","5","346","2023-01-02"
"43257","2022","COM","2020","501","9","510","2023-01-02"
"43258","2022","COM","2020","1810","51","1861","2023-01-02"
"43259","2022","COM","2020","362","12","374","2023-01-02"
"43260","2022","COM","2020","22","0","22","2023-01-02"
"43261","2022","COM","2020","622","11","633","2023-01-02"
"43262","2022","COM","2020","1193","30","1223","2023-01-02"
"43263","2022","COM","2020","68","0","68","2023-01-02"
"43264","2022","COM","2020","285","16","301","2023-01-02"
"43265","2022","COM","2020","1452","47","1499","2023-01-02"
"43267","2022","COM","2020","1450","11","1461","2023-01-02"
"43268","2022","COM","2020","7320","423","7743","2023-01-02"
"44001","2022","COM","2020","2056","40","2096","2023-01-02"
"44002","2022","COM","2020","4057","142","4199","2023-01-02"
"44003","2022","COM","2020","11081","398","11479","2023-01-02"
"44005","2022","COM","2020","7049","109","7158","2023-01-02"
"44006","2022","COM","2020","1875","43","1918","2023-01-02"
"44007","2022","COM","2020","2444","56","2500","2023-01-02"
"44009","2022","COM","2020","9410","249","9659","2023-01-02"
"44010","2022","COM","2020","2822","72","2894","2023-01-02"
"44012","2022","COM","2020","3206","40","3246","2023-01-02"
"44013","2022","COM","2020","3249","41","3290","2023-01-02"
"44014","2022","COM","2020","3927","72","3999","2023-01-02"
"44015","2022","COM","2020","10086","175","10261","2023-01-02"
"44016","2022","COM","2020","1071","18","1089","2023-01-02"
"44018","2022","COM","2020","8102","139","8241","2023-01-02"
"44019","2022","COM","2020","1044","11","1055","2023-01-02"
"44020","2022","COM","2020","20450","298","20748","2023-01-02"
"44021","2022","COM","2020","5013","87","5100","2023-01-02"
"44022","2022","COM","2020","2722","50","2772","2023-01-02"
"44023","2022","COM","2020","3081","45","3126","2023-01-02"
"44024","2022","COM","2020","2862","59","2921","2023-01-02"
"44025","2022","COM","2020","3949","67","4016","2023-01-02"
"44026","2022","COM","2020","20463","500","20963","2023-01-02"
"44027","2022","COM","2020","2480","41","2521","2023-01-02"
"44028","2022","COM","2020","3984","106","4090","2023-01-02"
"44029","2022","COM","2020","7042","120","7162","2023-01-02"
"44030","2022","COM","2020","4339","93","4432","2023-01-02"
"44031","2022","COM","2020","804","16","820","2023-01-02"
"44032","2022","COM","2020","3414","50","3464","2023-01-02"
"44033","2022","COM","2020","3194","43","3237","2023-01-02"
"44035","2022","COM","2020","19981","439","20420","2023-01-02"
"44036","2022","COM","2020","12016","458","12474","2023-01-02"
"44037","2022","COM","2020","3157","186","3343","2023-01-02"
"44038","2022","COM","2020","2965","47","3012","2023-01-02"
"44039","2022","COM","2020","1152","8","1160","2023-01-02"
"44041","2022","COM","2020","5951","90","6041","2023-01-02"
"44043","2022","COM","2020","7507","245","7752","2023-01-02"
"44044","2022","COM","2020","1084","27","1111","2023-01-02"
"44045","2022","COM","2020","3800","46","3846","2023-01-02"
"44046","2022","COM","2020","2658","54","2712","2023-01-02"
"44047","2022","COM","2020","22680","291","22971","2023-01-02"
"44048","2022","COM","2020","2541","51","2592","2023-01-02"
"44049","2022","COM","2020","4114","56","4170","2023-01-02"
"44050","2022","COM","2020","3003","27","3030","2023-01-02"
"44051","2022","COM","2020","3511","428","3939","2023-01-02"
"44052","2022","COM","2020","8109","82","8191","2023-01-02"
"44053","2022","COM","2020","2288","37","2325","2023-01-02"
"44054","2022","COM","2020","3045","71","3116","2023-01-02"
"44055","2022","COM","2020","16160","546","16706","2023-01-02"
"44056","2022","COM","2020","3705","61","3766","2023-01-02"
"44057","2022","COM","2020","2302","60","2362","2023-01-02"
"44058","2022","COM","2020","472","11","483","2023-01-02"
"44061","2022","COM","2020","3228","55","3283","2023-01-02"
"44062","2022","COM","2020","1842","32","1874","2023-01-02"
"44063","2022","COM","2020","3746","88","3834","2023-01-02"
"44064","2022","COM","2020","4950","357","5307","2023-01-02"
"44065","2022","COM","2020","769","21","790","2023-01-02"
"44066","2022","COM","2020","6606","117","6723","2023-01-02"
"44067","2022","COM","2020","5239","83","5322","2023-01-02"
"44068","2022","COM","2020","3378","55","3433","2023-01-02"
"44069","2022","COM","2020","16042","570","16612","2023-01-02"
"44070","2022","COM","2020","4694","113","4807","2023-01-02"
"44071","2022","COM","2020","5954","156","6110","2023-01-02"
"44072","2022","COM","2020","7088","115","7203","2023-01-02"
"44073","2022","COM","2020","6407","116","6523","2023-01-02"
"44074","2022","COM","2020","4087","51","4138","2023-01-02"
"44075","2022","COM","2020","1804","39","1843","2023-01-02"
"44076","2022","COM","2020","1408","19","1427","2023-01-02"
"44077","2022","COM","2020","2632","28","2660","2023-01-02"
"44078","2022","COM","2020","330","3","333","2023-01-02"
"44079","2022","COM","2020","3118","297","3415","2023-01-02"
"44080","2022","COM","2020","771","18","789","2023-01-02"
"44081","2022","COM","2020","4633","109","4742","2023-01-02"
"44082","2022","COM","2020","5371","109","5480","2023-01-02"
"44083","2022","COM","2020","2487","29","2516","2023-01-02"
"44084","2022","COM","2020","8517","137","8654","2023-01-02"
"44085","2022","COM","2020","965","32","997","2023-01-02"
"44086","2022","COM","2020","1056","22","1078","2023-01-02"
"44087","2022","COM","2020","7626","233","7859","2023-01-02"
"44088","2022","COM","2020","3023","43","3066","2023-01-02"
"44089","2022","COM","2020","3564","57","3621","2023-01-02"
"44090","2022","COM","2020","1606","22","1628","2023-01-02"
"44091","2022","COM","2020","1524","31","1555","2023-01-02"
"44092","2022","COM","2020","684","10","694","2023-01-02"
"44094","2022","COM","2020","3259","65","3324","2023-01-02"
"44095","2022","COM","2020","1548","25","1573","2023-01-02"
"44096","2022","COM","2020","4726","97","4823","2023-01-02"
"44097","2022","COM","2020","2088","46","2134","2023-01-02"
"44098","2022","COM","2020","5432","70","5502","2023-01-02"
"44099","2022","COM","2020","1967","60","2027","2023-01-02"
"44100","2022","COM","2020","2316","61","2377","2023-01-02"
"44101","2022","COM","2020","6372","143","6515","2023-01-02"
"44102","2022","COM","2020","3238","54","3292","2023-01-02"
"44103","2022","COM","2020","7216","95","7311","2023-01-02"
"44104","2022","COM","2020","833","11","844","2023-01-02"
"44105","2022","COM","2020","365","7","372","2023-01-02"
"44106","2022","COM","2020","1805","22","1827","2023-01-02"
"44107","2022","COM","2020","1942","35","1977","2023-01-02"
"44108","2022","COM","2020","2874","54","2928","2023-01-02"
"44109","2022","COM","2020","320732","5125","325857","2023-01-02"
"44110","2022","COM","2020","9198","198","9396","2023-01-02"
"44111","2022","COM","2020","2285","40","2325","2023-01-02"
"44112","2022","COM","2020","586","11","597","2023-01-02"
"44113","2022","COM","2020","4216","89","4305","2023-01-02"
"44114","2022","COM","2020","27438","698","28136","2023-01-02"
"44115","2022","COM","2020","3936","67","4003","2023-01-02"
"44116","2022","COM","2020","3008","111","3119","2023-01-02"
"44117","2022","COM","2020","3305","48","3353","2023-01-02"
"44118","2022","COM","2020","1424","26","1450","2023-01-02"
"44119","2022","COM","2020","2004","32","2036","2023-01-02"
"44120","2022","COM","2020","5251","218","5469","2023-01-02"
"44121","2022","COM","2020","427","3","430","2023-01-02"
"44122","2022","COM","2020","3818","55","3873","2023-01-02"
"44123","2022","COM","2020","997","14","1011","2023-01-02"
"44124","2022","COM","2020","751","15","766","2023-01-02"
"44125","2022","COM","2020","2368","50","2418","2023-01-02"
"44126","2022","COM","2020","4448","87","4535","2023-01-02"
"44127","2022","COM","2020","2780","35","2815","2023-01-02"
"44128","2022","COM","2020","5265","105","5370","2023-01-02"
"44129","2022","COM","2020","11030","276","11306","2023-01-02"
"44130","2022","COM","2020","6690","85","6775","2023-01-02"
"44131","2022","COM","2020","16886","454","17340","2023-01-02"
"44132","2022","COM","2020","11828","331","12159","2023-01-02"
"44133","2022","COM","2020","2981","54","3035","2023-01-02"
"44134","2022","COM","2020","1085","22","1107","2023-01-02"
"44135","2022","COM","2020","4024","92","4116","2023-01-02"
"44136","2022","COM","2020","1226","28","1254","2023-01-02"
"44137","2022","COM","2020","3476","64","3540","2023-01-02"
"44138","2022","COM","2020","1148","19","1167","2023-01-02"
"44139","2022","COM","2020","1435","21","1456","2023-01-02"
"44140","2022","COM","2020","1520","26","1546","2023-01-02"
"44141","2022","COM","2020","1286","13","1299","2023-01-02"
"44142","2022","COM","2020","1949","37","1986","2023-01-02"
"44143","2022","COM","2020","42993","763","43756","2023-01-02"
"44144","2022","COM","2020","2358","58","2416","2023-01-02"
"44145","2022","COM","2020","3134","47","3181","2023-01-02"
"44146","2022","COM","2020","2156","40","2196","2023-01-02"
"44148","2022","COM","2020","705","8","713","2023-01-02"
"44149","2022","COM","2020","3989","48","4037","2023-01-02"
"44150","2022","COM","2020","3973","61","4034","2023-01-02"
"44151","2022","COM","2020","6813","174","6987","2023-01-02"
"44152","2022","COM","2020","2964","53","3017","2023-01-02"
"44153","2022","COM","2020","1741","50","1791","2023-01-02"
"44154","2022","COM","2020","14473","336","14809","2023-01-02"
"44155","2022","COM","2020","3428","75","3503","2023-01-02"
"44156","2022","COM","2020","3074","39","3113","2023-01-02"
"44157","2022","COM","2020","1724","21","1745","2023-01-02"
"44158","2022","COM","2020","7578","180","7758","2023-01-02"
"44159","2022","COM","2020","1236","24","1260","2023-01-02"
"44161","2022","COM","2020","3761","69","3830","2023-01-02"
"44162","2022","COM","2020","49067","734","49801","2023-01-02"
"44163","2022","COM","2020","4807","106","4913","2023-01-02"
"44164","2022","COM","2020","2336","46","2382","2023-01-02"
"44165","2022","COM","2020","2325","47","2372","2023-01-02"
"44166","2022","COM","2020","5970","115","6085","2023-01-02"
"44168","2022","COM","2020","4109","63","4172","2023-01-02"
"44169","2022","COM","2020","7505","109","7614","2023-01-02"
"44170","2022","COM","2020","959","20","979","2023-01-02"
"44171","2022","COM","2020","1999","33","2032","2023-01-02"
"44172","2022","COM","2020","15417","263","15680","2023-01-02"
"44173","2022","COM","2020","2140","45","2185","2023-01-02"
"44174","2022","COM","2020","2278","39","2317","2023-01-02"
"44175","2022","COM","2020","4962","95","5057","2023-01-02"
"44176","2022","COM","2020","3206","53","3259","2023-01-02"
"44178","2022","COM","2020","2600","44","2644","2023-01-02"
"44179","2022","COM","2020","5236","84","5320","2023-01-02"
"44180","2022","COM","2020","6485","122","6607","2023-01-02"
"44182","2022","COM","2020","5297","88","5385","2023-01-02"
"44183","2022","COM","2020","2805","62","2867","2023-01-02"
"44184","2022","COM","2020","71887","1756","73643","2023-01-02"
"44185","2022","COM","2020","3280","66","3346","2023-01-02"
"44186","2022","COM","2020","7111","135","7246","2023-01-02"
"44187","2022","COM","2020","4594","148","4742","2023-01-02"
"44188","2022","COM","2020","9213","196","9409","2023-01-02"
"44189","2022","COM","2020","2408","34","2442","2023-01-02"
"44190","2022","COM","2020","27958","681","28639","2023-01-02"
"44192","2022","COM","2020","2730","45","2775","2023-01-02"
"44193","2022","COM","2020","1531","22","1553","2023-01-02"
"44194","2022","COM","2020","8473","166","8639","2023-01-02"
"44195","2022","COM","2020","9283","193","9476","2023-01-02"
"44196","2022","COM","2020","1653","24","1677","2023-01-02"
"44197","2022","COM","2020","1651","34","1685","2023-01-02"
"44198","2022","COM","2020","8900","110","9010","2023-01-02"
"44199","2022","COM","2020","1996","52","2048","2023-01-02"
"44200","2022","COM","2020","339","7","346","2023-01-02"
"44201","2022","COM","2020","7325","203","7528","2023-01-02"
"44202","2022","COM","2020","1808","26","1834","2023-01-02"
"44203","2022","COM","2020","2032","19","2051","2023-01-02"
"44204","2022","COM","2020","10704","180","10884","2023-01-02"
"44205","2022","COM","2020","2535","38","2573","2023-01-02"
"44206","2022","COM","2020","1890","29","1919","2023-01-02"
"44207","2022","COM","2020","1102","10","1112","2023-01-02"
"44208","2022","COM","2020","941","9","950","2023-01-02"
"44209","2022","COM","2020","10054","254","10308","2023-01-02"
"44210","2022","COM","2020","8101","80","8181","2023-01-02"
"44211","2022","COM","2020","4889","93","4982","2023-01-02"
"44212","2022","COM","2020","9412","219","9631","2023-01-02"
"44213","2022","COM","2020","7533","125","7658","2023-01-02"
"44214","2022","COM","2020","2051","28","2079","2023-01-02"
"44215","2022","COM","2020","25879","570","26449","2023-01-02"
"44216","2022","COM","2020","4040","74","4114","2023-01-02"
"44217","2022","COM","2020","6328","93","6421","2023-01-02"
"44218","2022","COM","2020","684","15","699","2023-01-02"
"44220","2022","COM","2020","1632","21","1653","2023-01-02"
"44221","2022","COM","2020","1536","19","1555","2023-01-02"
"44222","2022","COM","2020","1241","20","1261","2023-01-02"
"44223","2022","COM","2020","3688","48","3736","2023-01-02"
"44224","2022","COM","2020","1748","21","1769","2023-01-02"
"45001","2022","COM","2020","197","5","202","2023-01-02"
"45002","2022","COM","2020","376","5","381","2023-01-02"
"45004","2022","COM","2020","13279","579","13858","2023-01-02"
"45005","2022","COM","2020","262","6","268","2023-01-02"
"45006","2022","COM","2020","1128","29","1157","2023-01-02"
"45008","2022","COM","2020","1969","29","1998","2023-01-02"
"45009","2022","COM","2020","1143","30","1173","2023-01-02"
"45010","2022","COM","2020","1075","38","1113","2023-01-02"
"45011","2022","COM","2020","208","3","211","2023-01-02"
"45012","2022","COM","2020","181","3","184","2023-01-02"
"45013","2022","COM","2020","225","8","233","2023-01-02"
"45014","2022","COM","2020","499","11","510","2023-01-02"
"45015","2022","COM","2020","710","13","723","2023-01-02"
"45016","2022","COM","2020","931","21","952","2023-01-02"
"45017","2022","COM","2020","339","3","342","2023-01-02"
"45018","2022","COM","2020","965","18","983","2023-01-02"
"45019","2022","COM","2020","651","31","682","2023-01-02"
"45020","2022","COM","2020","979","18","997","2023-01-02"
"45021","2022","COM","2020","309","6","315","2023-01-02"
"45022","2022","COM","2020","444","6","450","2023-01-02"
"45023","2022","COM","2020","111","2","113","2023-01-02"
"45024","2022","COM","2020","2045","47","2092","2023-01-02"
"45025","2022","COM","2020","1526","22","1548","2023-01-02"
"45026","2022","COM","2020","980","15","995","2023-01-02"
"45027","2022","COM","2020","390","8","398","2023-01-02"
"45028","2022","COM","2020","7384","187","7571","2023-01-02"
"45029","2022","COM","2020","1779","23","1802","2023-01-02"
"45030","2022","COM","2020","2006","128","2134","2023-01-02"
"45031","2022","COM","2020","1446","88","1534","2023-01-02"
"45032","2022","COM","2020","316","8","324","2023-01-02"
"45033","2022","COM","2020","368","20","388","2023-01-02"
"45034","2022","COM","2020","2105","49","2154","2023-01-02"
"45035","2022","COM","2020","1125","24","1149","2023-01-02"
"45036","2022","COM","2020","848","29","877","2023-01-02"
"45037","2022","COM","2020","508","10","518","2023-01-02"
"45038","2022","COM","2020","416","13","429","2023-01-02"
"45039","2022","COM","2020","706","19","725","2023-01-02"
"45040","2022","COM","2020","1861","24","1885","2023-01-02"
"45041","2022","COM","2020","108","3","111","2023-01-02"
"45042","2022","COM","2020","1895","40","1935","2023-01-02"
"45043","2022","COM","2020","1013","24","1037","2023-01-02"
"45044","2022","COM","2020","162","7","169","2023-01-02"
"45045","2022","COM","2020","311","12","323","2023-01-02"
"45046","2022","COM","2020","1057","17","1074","2023-01-02"
"45047","2022","COM","2020","414","13","427","2023-01-02"
"45049","2022","COM","2020","1216","31","1247","2023-01-02"
"45050","2022","COM","2020","1326","38","1364","2023-01-02"
"45051","2022","COM","2020","1740","34","1774","2023-01-02"
"45052","2022","COM","2020","99","0","99","2023-01-02"
"45053","2022","COM","2020","5212","95","5307","2023-01-02"
"45054","2022","COM","2020","540","8","548","2023-01-02"
"45055","2022","COM","2020","556","10","566","2023-01-02"
"45056","2022","COM","2020","319","5","324","2023-01-02"
"45058","2022","COM","2020","178","7","185","2023-01-02"
"45059","2022","COM","2020","191","1","192","2023-01-02"
"45060","2022","COM","2020","779","19","798","2023-01-02"
"45061","2022","COM","2020","2400","58","2458","2023-01-02"
"45062","2022","COM","2020","1501","24","1525","2023-01-02"
"45063","2022","COM","2020","924","18","942","2023-01-02"
"45064","2022","COM","2020","442","6","448","2023-01-02"
"45065","2022","COM","2020","224","3","227","2023-01-02"
"45066","2022","COM","2020","677","10","687","2023-01-02"
"45067","2022","COM","2020","3987","109","4096","2023-01-02"
"45068","2022","COM","2020","12743","236","12979","2023-01-02"
"45069","2022","COM","2020","954","23","977","2023-01-02"
"45070","2022","COM","2020","58","0","58","2023-01-02"
"45072","2022","COM","2020","1652","25","1677","2023-01-02"
"45073","2022","COM","2020","494","6","500","2023-01-02"
"45074","2022","COM","2020","111","2","113","2023-01-02"
"45075","2022","COM","2020","10095","211","10306","2023-01-02"
"45076","2022","COM","2020","228","7","235","2023-01-02"
"45077","2022","COM","2020","622","6","628","2023-01-02"
"45078","2022","COM","2020","252","2","254","2023-01-02"
"45079","2022","COM","2020","157","0","157","2023-01-02"
"45080","2022","COM","2020","341","14","355","2023-01-02"
"45081","2022","COM","2020","612","16","628","2023-01-02"
"45082","2022","COM","2020","8382","120","8502","2023-01-02"
"45083","2022","COM","2020","2106","33","2139","2023-01-02"
"45084","2022","COM","2020","436","9","445","2023-01-02"
"45085","2022","COM","2020","1869","25","1894","2023-01-02"
"45086","2022","COM","2020","277","4","281","2023-01-02"
"45087","2022","COM","2020","3122","52","3174","2023-01-02"
"45088","2022","COM","2020","287","10","297","2023-01-02"
"45089","2022","COM","2020","8699","176","8875","2023-01-02"
"45091","2022","COM","2020","317","13","330","2023-01-02"
"45092","2022","COM","2020","1465","36","1501","2023-01-02"
"45093","2022","COM","2020","2634","37","2671","2023-01-02"
"45094","2022","COM","2020","225","2","227","2023-01-02"
"45095","2022","COM","2020","2096","43","2139","2023-01-02"
"45096","2022","COM","2020","529","7","536","2023-01-02"
"45097","2022","COM","2020","1217","13","1230","2023-01-02"
"45098","2022","COM","2020","3466","69","3535","2023-01-02"
"45099","2022","COM","2020","506","9","515","2023-01-02"
"45100","2022","COM","2020","500","20","520","2023-01-02"
"45101","2022","COM","2020","274","6","280","2023-01-02"
"45102","2022","COM","2020","355","10","365","2023-01-02"
"45103","2022","COM","2020","1556","18","1574","2023-01-02"
"45104","2022","COM","2020","2822","60","2882","2023-01-02"
"45105","2022","COM","2020","77","2","79","2023-01-02"
"45107","2022","COM","2020","315","0","315","2023-01-02"
"45108","2022","COM","2020","2293","34","2327","2023-01-02"
"45109","2022","COM","2020","544","11","555","2023-01-02"
"45110","2022","COM","2020","313","8","321","2023-01-02"
"45111","2022","COM","2020","452","4","456","2023-01-02"
"45112","2022","COM","2020","342","11","353","2023-01-02"
"45113","2022","COM","2020","262","5","267","2023-01-02"
"45114","2022","COM","2020","229","11","240","2023-01-02"
"45115","2022","COM","2020","3848","66","3914","2023-01-02"
"45116","2022","COM","2020","945","26","971","2023-01-02"
"45118","2022","COM","2020","331","4","335","2023-01-02"
"45119","2022","COM","2020","2404","53","2457","2023-01-02"
"45120","2022","COM","2020","171","2","173","2023-01-02"
"45121","2022","COM","2020","472","9","481","2023-01-02"
"45122","2022","COM","2020","1424","37","1461","2023-01-02"
"45123","2022","COM","2020","1875","34","1909","2023-01-02"
"45124","2022","COM","2020","175","3","178","2023-01-02"
"45125","2022","COM","2020","111","2","113","2023-01-02"
"45126","2022","COM","2020","2854","63","2917","2023-01-02"
"45127","2022","COM","2020","3272","36","3308","2023-01-02"
"45129","2022","COM","2020","1346","27","1373","2023-01-02"
"45130","2022","COM","2020","1407","27","1434","2023-01-02"
"45131","2022","COM","2020","386","11","397","2023-01-02"
"45132","2022","COM","2020","354","4","358","2023-01-02"
"45133","2022","COM","2020","563","17","580","2023-01-02"
"45134","2022","COM","2020","1419","29","1448","2023-01-02"
"45135","2022","COM","2020","305","10","315","2023-01-02"
"45136","2022","COM","2020","545","8","553","2023-01-02"
"45137","2022","COM","2020","726","17","743","2023-01-02"
"45138","2022","COM","2020","51","0","51","2023-01-02"
"45139","2022","COM","2020","494","17","511","2023-01-02"
"45141","2022","COM","2020","156","1","157","2023-01-02"
"45142","2022","COM","2020","3792","68","3860","2023-01-02"
"45143","2022","COM","2020","32","1","33","2023-01-02"
"45144","2022","COM","2020","1139","87","1226","2023-01-02"
"45145","2022","COM","2020","3712","79","3791","2023-01-02"
"45146","2022","COM","2020","7371","159","7530","2023-01-02"
"45147","2022","COM","2020","21104","260","21364","2023-01-02"
"45148","2022","COM","2020","1710","43","1753","2023-01-02"
"45149","2022","COM","2020","270","3","273","2023-01-02"
"45150","2022","COM","2020","183","4","187","2023-01-02"
"45151","2022","COM","2020","250","8","258","2023-01-02"
"45152","2022","COM","2020","213","5","218","2023-01-02"
"45153","2022","COM","2020","727","24","751","2023-01-02"
"45154","2022","COM","2020","2043","34","2077","2023-01-02"
"45155","2022","COM","2020","13305","411","13716","2023-01-02"
"45156","2022","COM","2020","595","14","609","2023-01-02"
"45157","2022","COM","2020","413","6","419","2023-01-02"
"45158","2022","COM","2020","318","10","328","2023-01-02"
"45159","2022","COM","2020","188","7","195","2023-01-02"
"45160","2022","COM","2020","709","8","717","2023-01-02"
"45161","2022","COM","2020","799","20","819","2023-01-02"
"45162","2022","COM","2020","525","13","538","2023-01-02"
"45164","2022","COM","2020","661","16","677","2023-01-02"
"45165","2022","COM","2020","609","7","616","2023-01-02"
"45166","2022","COM","2020","285","8","293","2023-01-02"
"45167","2022","COM","2020","1728","29","1757","2023-01-02"
"45168","2022","COM","2020","550","4","554","2023-01-02"
"45169","2022","COM","2020","9541","236","9777","2023-01-02"
"45170","2022","COM","2020","167","2","169","2023-01-02"
"45171","2022","COM","2020","545","14","559","2023-01-02"
"45173","2022","COM","2020","4688","51","4739","2023-01-02"
"45174","2022","COM","2020","262","6","268","2023-01-02"
"45175","2022","COM","2020","1504","25","1529","2023-01-02"
"45176","2022","COM","2020","426","4","430","2023-01-02"
"45177","2022","COM","2020","238","3","241","2023-01-02"
"45178","2022","COM","2020","1385","24","1409","2023-01-02"
"45179","2022","COM","2020","3101","49","3150","2023-01-02"
"45180","2022","COM","2020","82","0","82","2023-01-02"
"45181","2022","COM","2020","89","2","91","2023-01-02"
"45182","2022","COM","2020","1238","24","1262","2023-01-02"
"45183","2022","COM","2020","133","4","137","2023-01-02"
"45184","2022","COM","2020","394","6","400","2023-01-02"
"45185","2022","COM","2020","298","9","307","2023-01-02"
"45186","2022","COM","2020","589","13","602","2023-01-02"
"45187","2022","COM","2020","2988","62","3050","2023-01-02"
"45188","2022","COM","2020","2515","62","2577","2023-01-02"
"45189","2022","COM","2020","248","6","254","2023-01-02"
"45191","2022","COM","2020","8004","161","8165","2023-01-02"
"45193","2022","COM","2020","2145","46","2191","2023-01-02"
"45194","2022","COM","2020","2938","50","2988","2023-01-02"
"45195","2022","COM","2020","559","13","572","2023-01-02"
"45196","2022","COM","2020","1576","30","1606","2023-01-02"
"45197","2022","COM","2020","1755","38","1793","2023-01-02"
"45198","2022","COM","2020","304","9","313","2023-01-02"
"45199","2022","COM","2020","500","5","505","2023-01-02"
"45200","2022","COM","2020","1401","37","1438","2023-01-02"
"45201","2022","COM","2020","177","3","180","2023-01-02"
"45202","2022","COM","2020","1009","15","1024","2023-01-02"
"45203","2022","COM","2020","6567","93","6660","2023-01-02"
"45204","2022","COM","2020","840","22","862","2023-01-02"
"45205","2022","COM","2020","257","6","263","2023-01-02"
"45206","2022","COM","2020","320","4","324","2023-01-02"
"45207","2022","COM","2020","389","8","397","2023-01-02"
"45208","2022","COM","2020","14738","482","15220","2023-01-02"
"45209","2022","COM","2020","302","5","307","2023-01-02"
"45210","2022","COM","2020","733","19","752","2023-01-02"
"45212","2022","COM","2020","1261","28","1289","2023-01-02"
"45213","2022","COM","2020","626","19","645","2023-01-02"
"45214","2022","COM","2020","238","4","242","2023-01-02"
"45215","2022","COM","2020","247","3","250","2023-01-02"
"45216","2022","COM","2020","128","2","130","2023-01-02"
"45217","2022","COM","2020","166","5","171","2023-01-02"
"45218","2022","COM","2020","112","1","113","2023-01-02"
"45219","2022","COM","2020","192","2","194","2023-01-02"
"45220","2022","COM","2020","574","17","591","2023-01-02"
"45222","2022","COM","2020","1469","36","1505","2023-01-02"
"45223","2022","COM","2020","360","6","366","2023-01-02"
"45224","2022","COM","2020","4978","77","5055","2023-01-02"
"45225","2022","COM","2020","351","14","365","2023-01-02"
"45226","2022","COM","2020","1356","23","1379","2023-01-02"
"45227","2022","COM","2020","1164","22","1186","2023-01-02"
"45228","2022","COM","2020","1189","28","1217","2023-01-02"
"45229","2022","COM","2020","2575","37","2612","2023-01-02"
"45230","2022","COM","2020","731","5","736","2023-01-02"
"45231","2022","COM","2020","129","5","134","2023-01-02"
"45232","2022","COM","2020","22503","514","23017","2023-01-02"
"45233","2022","COM","2020","399","3","402","2023-01-02"
"45234","2022","COM","2020","117026","2354","119380","2023-01-02"
"45235","2022","COM","2020","4194","79","4273","2023-01-02"
"45237","2022","COM","2020","125","1","126","2023-01-02"
"45238","2022","COM","2020","691","12","703","2023-01-02"
"45239","2022","COM","2020","415","6","421","2023-01-02"
"45240","2022","COM","2020","1322","23","1345","2023-01-02"
"45241","2022","COM","2020","542","12","554","2023-01-02"
"45242","2022","COM","2020","277","5","282","2023-01-02"
"45243","2022","COM","2020","313","6","319","2023-01-02"
"45244","2022","COM","2020","2593","82","2675","2023-01-02"
"45245","2022","COM","2020","1118","21","1139","2023-01-02"
"45246","2022","COM","2020","131","5","136","2023-01-02"
"45247","2022","COM","2020","3694","64","3758","2023-01-02"
"45248","2022","COM","2020","2270","38","2308","2023-01-02"
"45249","2022","COM","2020","907","23","930","2023-01-02"
"45250","2022","COM","2020","248","3","251","2023-01-02"
"45251","2022","COM","2020","306","3","309","2023-01-02"
"45252","2022","COM","2020","9067","146","9213","2023-01-02"
"45253","2022","COM","2020","1747","43","1790","2023-01-02"
"45254","2022","COM","2020","2419","49","2468","2023-01-02"
"45255","2022","COM","2020","438","5","443","2023-01-02"
"45256","2022","COM","2020","248","6","254","2023-01-02"
"45257","2022","COM","2020","510","7","517","2023-01-02"
"45258","2022","COM","2020","3413","56","3469","2023-01-02"
"45259","2022","COM","2020","1128","21","1149","2023-01-02"
"45260","2022","COM","2020","250","8","258","2023-01-02"
"45261","2022","COM","2020","1306","17","1323","2023-01-02"
"45262","2022","COM","2020","139","2","141","2023-01-02"
"45263","2022","COM","2020","297","8","305","2023-01-02"
"45264","2022","COM","2020","182","4","186","2023-01-02"
"45265","2022","COM","2020","405","5","410","2023-01-02"
"45266","2022","COM","2020","202","1","203","2023-01-02"
"45268","2022","COM","2020","614","8","622","2023-01-02"
"45269","2022","COM","2020","3607","72","3679","2023-01-02"
"45270","2022","COM","2020","2004","52","2056","2023-01-02"
"45271","2022","COM","2020","962","22","984","2023-01-02"
"45272","2022","COM","2020","3313","75","3388","2023-01-02"
"45273","2022","COM","2020","3028","40","3068","2023-01-02"
"45274","2022","COM","2020","7633","188","7821","2023-01-02"
"45275","2022","COM","2020","466","5","471","2023-01-02"
"45276","2022","COM","2020","510","5","515","2023-01-02"
"45277","2022","COM","2020","451","12","463","2023-01-02"
"45278","2022","COM","2020","1065","69","1134","2023-01-02"
"45279","2022","COM","2020","1891","42","1933","2023-01-02"
"45280","2022","COM","2020","1079","16","1095","2023-01-02"
"45281","2022","COM","2020","950","17","967","2023-01-02"
"45282","2022","COM","2020","3099","86","3185","2023-01-02"
"45283","2022","COM","2020","159","6","165","2023-01-02"
"45284","2022","COM","2020","21396","587","21983","2023-01-02"
"45285","2022","COM","2020","16570","242","16812","2023-01-02"
"45286","2022","COM","2020","9225","135","9360","2023-01-02"
"45288","2022","COM","2020","396","9","405","2023-01-02"
"45289","2022","COM","2020","1216","18","1234","2023-01-02"
"45290","2022","COM","2020","1789","28","1817","2023-01-02"
"45291","2022","COM","2020","1232","47","1279","2023-01-02"
"45292","2022","COM","2020","852","13","865","2023-01-02"
"45293","2022","COM","2020","1151","24","1175","2023-01-02"
"45294","2022","COM","2020","141","1","142","2023-01-02"
"45296","2022","COM","2020","749","16","765","2023-01-02"
"45297","2022","COM","2020","1025","16","1041","2023-01-02"
"45298","2022","COM","2020","6170","103","6273","2023-01-02"
"45299","2022","COM","2020","270","0","270","2023-01-02"
"45300","2022","COM","2020","4186","104","4290","2023-01-02"
"45301","2022","COM","2020","397","3","400","2023-01-02"
"45302","2022","COM","2020","16598","189","16787","2023-01-02"
"45303","2022","COM","2020","626","17","643","2023-01-02"
"45305","2022","COM","2020","214","1","215","2023-01-02"
"45306","2022","COM","2020","781","14","795","2023-01-02"
"45307","2022","COM","2020","1090","25","1115","2023-01-02"
"45308","2022","COM","2020","3217","75","3292","2023-01-02"
"45309","2022","COM","2020","702","15","717","2023-01-02"
"45310","2022","COM","2020","1691","22","1713","2023-01-02"
"45311","2022","COM","2020","659","18","677","2023-01-02"
"45312","2022","COM","2020","475","8","483","2023-01-02"
"45313","2022","COM","2020","813","13","826","2023-01-02"
"45314","2022","COM","2020","451","9","460","2023-01-02"
"45315","2022","COM","2020","5141","62","5203","2023-01-02"
"45316","2022","COM","2020","789","23","812","2023-01-02"
"45317","2022","COM","2020","1351","30","1381","2023-01-02"
"45320","2022","COM","2020","420","12","432","2023-01-02"
"45321","2022","COM","2020","699","20","719","2023-01-02"
"45322","2022","COM","2020","188","4","192","2023-01-02"
"45323","2022","COM","2020","220","4","224","2023-01-02"
"45324","2022","COM","2020","2381","48","2429","2023-01-02"
"45325","2022","COM","2020","291","4","295","2023-01-02"
"45326","2022","COM","2020","389","9","398","2023-01-02"
"45327","2022","COM","2020","3445","83","3528","2023-01-02"
"45328","2022","COM","2020","293","5","298","2023-01-02"
"45329","2022","COM","2020","1282","24","1306","2023-01-02"
"45330","2022","COM","2020","215","4","219","2023-01-02"
"45331","2022","COM","2020","614","9","623","2023-01-02"
"45332","2022","COM","2020","1492","24","1516","2023-01-02"
"45333","2022","COM","2020","1974","40","2014","2023-01-02"
"45334","2022","COM","2020","632","8","640","2023-01-02"
"45335","2022","COM","2020","1938","44","1982","2023-01-02"
"45336","2022","COM","2020","867","13","880","2023-01-02"
"45337","2022","COM","2020","284","2","286","2023-01-02"
"45338","2022","COM","2020","6835","367","7202","2023-01-02"
"45339","2022","COM","2020","483","7","490","2023-01-02"
"45340","2022","COM","2020","563","11","574","2023-01-02"
"45341","2022","COM","2020","197","6","203","2023-01-02"
"45342","2022","COM","2020","398","3","401","2023-01-02"
"45343","2022","COM","2020","206","6","212","2023-01-02"
"45344","2022","COM","2020","1084","20","1104","2023-01-02"
"45345","2022","COM","2020","1118","34","1152","2023-01-02"
"45346","2022","COM","2020","2269","41","2310","2023-01-02"
"45347","2022","COM","2020","811","16","827","2023-01-02"
"45348","2022","COM","2020","694","17","711","2023-01-02"
"46001","2022","COM","2020","523","12","535","2023-01-02"
"46002","2022","COM","2020","72","2","74","2023-01-02"
"46003","2022","COM","2020","692","24","716","2023-01-02"
"46004","2022","COM","2020","227","6","233","2023-01-02"
"46005","2022","COM","2020","332","9","341","2023-01-02"
"46006","2022","COM","2020","389","4","393","2023-01-02"
"46007","2022","COM","2020","986","23","1009","2023-01-02"
"46008","2022","COM","2020","218","3","221","2023-01-02"
"46009","2022","COM","2020","661","19","680","2023-01-02"
"46010","2022","COM","2020","370","10","380","2023-01-02"
"46011","2022","COM","2020","363","11","374","2023-01-02"
"46012","2022","COM","2020","554","14","568","2023-01-02"
"46013","2022","COM","2020","185","6","191","2023-01-02"
"46015","2022","COM","2020","1473","34","1507","2023-01-02"
"46016","2022","COM","2020","384","15","399","2023-01-02"
"46017","2022","COM","2020","144","4","148","2023-01-02"
"46018","2022","COM","2020","133","2","135","2023-01-02"
"46020","2022","COM","2020","230","12","242","2023-01-02"
"46021","2022","COM","2020","697","23","720","2023-01-02"
"46022","2022","COM","2020","209","3","212","2023-01-02"
"46023","2022","COM","2020","515","6","521","2023-01-02"
"46024","2022","COM","2020","404","12","416","2023-01-02"
"46026","2022","COM","2020","122","3","125","2023-01-02"
"46027","2022","COM","2020","122","2","124","2023-01-02"
"46028","2022","COM","2020","1069","29","1098","2023-01-02"
"46029","2022","COM","2020","1998","52","2050","2023-01-02"
"46030","2022","COM","2020","337","12","349","2023-01-02"
"46031","2022","COM","2020","131","2","133","2023-01-02"
"46032","2022","COM","2020","403","5","408","2023-01-02"
"46033","2022","COM","2020","560","12","572","2023-01-02"
"46034","2022","COM","2020","306","8","314","2023-01-02"
"46035","2022","COM","2020","180","8","188","2023-01-02"
"46036","2022","COM","2020","125","2","127","2023-01-02"
"46037","2022","COM","2020","93","1","94","2023-01-02"
"46038","2022","COM","2020","1370","28","1398","2023-01-02"
"46039","2022","COM","2020","211","2","213","2023-01-02"
"46040","2022","COM","2020","225","8","233","2023-01-02"
"46041","2022","COM","2020","155","8","163","2023-01-02"
"46042","2022","COM","2020","20159","922","21081","2023-01-02"
"46043","2022","COM","2020","199","5","204","2023-01-02"
"46044","2022","COM","2020","600","22","622","2023-01-02"
"46045","2022","COM","2020","1117","32","1149","2023-01-02"
"46046","2022","COM","2020","460","10","470","2023-01-02"
"46047","2022","COM","2020","168","6","174","2023-01-02"
"46049","2022","COM","2020","215","5","220","2023-01-02"
"46050","2022","COM","2020","135","4","139","2023-01-02"
"46051","2022","COM","2020","374","7","381","2023-01-02"
"46052","2022","COM","2020","257","5","262","2023-01-02"
"46053","2022","COM","2020","424","12","436","2023-01-02"
"46054","2022","COM","2020","393","2","395","2023-01-02"
"46055","2022","COM","2020","1112","27","1139","2023-01-02"
"46056","2022","COM","2020","106","2","108","2023-01-02"
"46057","2022","COM","2020","622","12","634","2023-01-02"
"46058","2022","COM","2020","413","14","427","2023-01-02"
"46059","2022","COM","2020","224","10","234","2023-01-02"
"46060","2022","COM","2020","229","1","230","2023-01-02"
"46061","2022","COM","2020","177","6","183","2023-01-02"
"46062","2022","COM","2020","429","6","435","2023-01-02"
"46063","2022","COM","2020","1836","38","1874","2023-01-02"
"46064","2022","COM","2020","914","7","921","2023-01-02"
"46065","2022","COM","2020","426","15","441","2023-01-02"
"46066","2022","COM","2020","643","6","649","2023-01-02"
"46068","2022","COM","2020","167","2","169","2023-01-02"
"46069","2022","COM","2020","169","3","172","2023-01-02"
"46070","2022","COM","2020","599","14","613","2023-01-02"
"46072","2022","COM","2020","303","6","309","2023-01-02"
"46073","2022","COM","2020","415","17","432","2023-01-02"
"46074","2022","COM","2020","412","8","420","2023-01-02"
"46075","2022","COM","2020","239","5","244","2023-01-02"
"46076","2022","COM","2020","347","7","354","2023-01-02"
"46078","2022","COM","2020","96","1","97","2023-01-02"
"46079","2022","COM","2020","102","2","104","2023-01-02"
"46080","2022","COM","2020","781","15","796","2023-01-02"
"46081","2022","COM","2020","72","3","75","2023-01-02"
"46082","2022","COM","2020","366","9","375","2023-01-02"
"46083","2022","COM","2020","1125","15","1140","2023-01-02"
"46084","2022","COM","2020","307","7","314","2023-01-02"
"46085","2022","COM","2020","238","6","244","2023-01-02"
"46086","2022","COM","2020","640","13","653","2023-01-02"
"46087","2022","COM","2020","649","18","667","2023-01-02"
"46088","2022","COM","2020","825","22","847","2023-01-02"
"46089","2022","COM","2020","947","9","956","2023-01-02"
"46090","2022","COM","2020","152","1","153","2023-01-02"
"46091","2022","COM","2020","208","4","212","2023-01-02"
"46092","2022","COM","2020","219","3","222","2023-01-02"
"46093","2022","COM","2020","86","2","88","2023-01-02"
"46094","2022","COM","2020","267","6","273","2023-01-02"
"46095","2022","COM","2020","1040","25","1065","2023-01-02"
"46096","2022","COM","2020","96","2","98","2023-01-02"
"46097","2022","COM","2020","109","6","115","2023-01-02"
"46098","2022","COM","2020","306","7","313","2023-01-02"
"46100","2022","COM","2020","697","29","726","2023-01-02"
"46101","2022","COM","2020","473","9","482","2023-01-02"
"46102","2022","COM","2020","9784","596","10380","2023-01-02"
"46103","2022","COM","2020","994","26","1020","2023-01-02"
"46104","2022","COM","2020","91","5","96","2023-01-02"
"46105","2022","COM","2020","792","17","809","2023-01-02"
"46106","2022","COM","2020","239","9","248","2023-01-02"
"46107","2022","COM","2020","173","5","178","2023-01-02"
"46108","2022","COM","2020","409","13","422","2023-01-02"
"46109","2022","COM","2020","513","9","522","2023-01-02"
"46111","2022","COM","2020","171","4","175","2023-01-02"
"46112","2022","COM","2020","250","6","256","2023-01-02"
"46113","2022","COM","2020","306","5","311","2023-01-02"
"46114","2022","COM","2020","365","7","372","2023-01-02"
"46115","2022","COM","2020","161","7","168","2023-01-02"
"46116","2022","COM","2020","71","6","77","2023-01-02"
"46117","2022","COM","2020","667","40","707","2023-01-02"
"46118","2022","COM","2020","674","15","689","2023-01-02"
"46119","2022","COM","2020","299","0","299","2023-01-02"
"46120","2022","COM","2020","343","4","347","2023-01-02"
"46121","2022","COM","2020","142","3","145","2023-01-02"
"46122","2022","COM","2020","105","3","108","2023-01-02"
"46123","2022","COM","2020","360","7","367","2023-01-02"
"46124","2022","COM","2020","297","12","309","2023-01-02"
"46125","2022","COM","2020","329","10","339","2023-01-02"
"46126","2022","COM","2020","217","4","221","2023-01-02"
"46127","2022","COM","2020","3959","127","4086","2023-01-02"
"46128","2022","COM","2020","3480","59","3539","2023-01-02"
"46129","2022","COM","2020","290","10","300","2023-01-02"
"46130","2022","COM","2020","226","3","229","2023-01-02"
"46131","2022","COM","2020","166","5","171","2023-01-02"
"46132","2022","COM","2020","516","22","538","2023-01-02"
"46133","2022","COM","2020","269","3","272","2023-01-02"
"46134","2022","COM","2020","267","6","273","2023-01-02"
"46135","2022","COM","2020","48","2","50","2023-01-02"
"46136","2022","COM","2020","272","7","279","2023-01-02"
"46137","2022","COM","2020","1274","23","1297","2023-01-02"
"46138","2022","COM","2020","900","18","918","2023-01-02"
"46139","2022","COM","2020","201","7","208","2023-01-02"
"46140","2022","COM","2020","362","15","377","2023-01-02"
"46142","2022","COM","2020","173","2","175","2023-01-02"
"46143","2022","COM","2020","1285","41","1326","2023-01-02"
"46144","2022","COM","2020","249","11","260","2023-01-02"
"46145","2022","COM","2020","794","11","805","2023-01-02"
"46146","2022","COM","2020","93","2","95","2023-01-02"
"46147","2022","COM","2020","128","0","128","2023-01-02"
"46148","2022","COM","2020","1836","45","1881","2023-01-02"
"46149","2022","COM","2020","703","14","717","2023-01-02"
"46151","2022","COM","2020","115","3","118","2023-01-02"
"46152","2022","COM","2020","302","4","306","2023-01-02"
"46153","2022","COM","2020","578","12","590","2023-01-02"
"46154","2022","COM","2020","351","7","358","2023-01-02"
"46155","2022","COM","2020","137","1","138","2023-01-02"
"46156","2022","COM","2020","1213","30","1243","2023-01-02"
"46157","2022","COM","2020","133","5","138","2023-01-02"
"46159","2022","COM","2020","228","5","233","2023-01-02"
"46160","2022","COM","2020","419","14","433","2023-01-02"
"46161","2022","COM","2020","246","6","252","2023-01-02"
"46162","2022","COM","2020","205","6","211","2023-01-02"
"46163","2022","COM","2020","285","4","289","2023-01-02"
"46164","2022","COM","2020","252","11","263","2023-01-02"
"46165","2022","COM","2020","471","11","482","2023-01-02"
"46167","2022","COM","2020","110","0","110","2023-01-02"
"46168","2022","COM","2020","190","2","192","2023-01-02"
"46169","2022","COM","2020","203","7","210","2023-01-02"
"46170","2022","COM","2020","924","26","950","2023-01-02"
"46171","2022","COM","2020","228","3","231","2023-01-02"
"46172","2022","COM","2020","502","16","518","2023-01-02"
"46173","2022","COM","2020","773","8","781","2023-01-02"
"46174","2022","COM","2020","235","8","243","2023-01-02"
"46175","2022","COM","2020","926","36","962","2023-01-02"
"46176","2022","COM","2020","709","14","723","2023-01-02"
"46177","2022","COM","2020","511","20","531","2023-01-02"
"46178","2022","COM","2020","260","2","262","2023-01-02"
"46179","2022","COM","2020","128","5","133","2023-01-02"
"46180","2022","COM","2020","606","27","633","2023-01-02"
"46181","2022","COM","2020","93","5","98","2023-01-02"
"46182","2022","COM","2020","1776","28","1804","2023-01-02"
"46183","2022","COM","2020","202","3","205","2023-01-02"
"46184","2022","COM","2020","348","12","360","2023-01-02"
"46185","2022","COM","2020","1638","38","1676","2023-01-02"
"46186","2022","COM","2020","360","5","365","2023-01-02"
"46187","2022","COM","2020","525","10","535","2023-01-02"
"46188","2022","COM","2020","295","10","305","2023-01-02"
"46189","2022","COM","2020","492","13","505","2023-01-02"
"46190","2022","COM","2020","127","3","130","2023-01-02"
"46191","2022","COM","2020","1135","25","1160","2023-01-02"
"46192","2022","COM","2020","263","8","271","2023-01-02"
"46193","2022","COM","2020","454","8","462","2023-01-02"
"46194","2022","COM","2020","187","6","193","2023-01-02"
"46195","2022","COM","2020","358","8","366","2023-01-02"
"46196","2022","COM","2020","94","1","95","2023-01-02"
"46197","2022","COM","2020","1069","125","1194","2023-01-02"
"46198","2022","COM","2020","110","1","111","2023-01-02"
"46199","2022","COM","2020","345","6","351","2023-01-02"
"46200","2022","COM","2020","262","4","266","2023-01-02"
"46201","2022","COM","2020","1804","50","1854","2023-01-02"
"46202","2022","COM","2020","554","5","559","2023-01-02"
"46203","2022","COM","2020","213","6","219","2023-01-02"
"46204","2022","COM","2020","593","8","601","2023-01-02"
"46205","2022","COM","2020","318","2","320","2023-01-02"
"46206","2022","COM","2020","118","6","124","2023-01-02"
"46207","2022","COM","2020","301","6","307","2023-01-02"
"46208","2022","COM","2020","294","7","301","2023-01-02"
"46209","2022","COM","2020","162","9","171","2023-01-02"
"46210","2022","COM","2020","71","1","72","2023-01-02"
"46211","2022","COM","2020","357","2","359","2023-01-02"
"46212","2022","COM","2020","71","0","71","2023-01-02"
"46213","2022","COM","2020","165","4","169","2023-01-02"
"46214","2022","COM","2020","386","10","396","2023-01-02"
"46215","2022","COM","2020","635","14","649","2023-01-02"
"46216","2022","COM","2020","652","29","681","2023-01-02"
"46217","2022","COM","2020","431","11","442","2023-01-02"
"46218","2022","COM","2020","186","4","190","2023-01-02"
"46219","2022","COM","2020","344","13","357","2023-01-02"
"46220","2022","COM","2020","772","28","800","2023-01-02"
"46221","2022","COM","2020","539","11","550","2023-01-02"
"46222","2022","COM","2020","193","3","196","2023-01-02"
"46223","2022","COM","2020","178","2","180","2023-01-02"
"46224","2022","COM","2020","3578","103","3681","2023-01-02"
"46225","2022","COM","2020","2419","66","2485","2023-01-02"
"46226","2022","COM","2020","230","7","237","2023-01-02"
"46227","2022","COM","2020","221","4","225","2023-01-02"
"46228","2022","COM","2020","724","20","744","2023-01-02"
"46229","2022","COM","2020","1020","19","1039","2023-01-02"
"46230","2022","COM","2020","89","4","93","2023-01-02"
"46231","2022","COM","2020","1929","24","1953","2023-01-02"
"46232","2022","COM","2020","985","24","1009","2023-01-02"
"46233","2022","COM","2020","108","1","109","2023-01-02"
"46234","2022","COM","2020","99","2","101","2023-01-02"
"46235","2022","COM","2020","170","4","174","2023-01-02"
"46236","2022","COM","2020","150","0","150","2023-01-02"
"46237","2022","COM","2020","365","12","377","2023-01-02"
"46238","2022","COM","2020","285","9","294","2023-01-02"
"46239","2022","COM","2020","208","5","213","2023-01-02"
"46240","2022","COM","2020","617","20","637","2023-01-02"
"46241","2022","COM","2020","189","4","193","2023-01-02"
"46242","2022","COM","2020","181","5","186","2023-01-02"
"46243","2022","COM","2020","189","1","190","2023-01-02"
"46244","2022","COM","2020","93","1","94","2023-01-02"
"46245","2022","COM","2020","82","0","82","2023-01-02"
"46246","2022","COM","2020","74","1","75","2023-01-02"
"46247","2022","COM","2020","151","5","156","2023-01-02"
"46249","2022","COM","2020","123","5","128","2023-01-02"
"46250","2022","COM","2020","83","2","85","2023-01-02"
"46251","2022","COM","2020","3427","155","3582","2023-01-02"
"46252","2022","COM","2020","314","8","322","2023-01-02"
"46253","2022","COM","2020","181","2","183","2023-01-02"
"46254","2022","COM","2020","137","5","142","2023-01-02"
"46255","2022","COM","2020","330","13","343","2023-01-02"
"46256","2022","COM","2020","201","6","207","2023-01-02"
"46257","2022","COM","2020","133","1","134","2023-01-02"
"46258","2022","COM","2020","165","1","166","2023-01-02"
"46259","2022","COM","2020","140","2","142","2023-01-02"
"46260","2022","COM","2020","227","10","237","2023-01-02"
"46262","2022","COM","2020","629","13","642","2023-01-02"
"46263","2022","COM","2020","697","16","713","2023-01-02"
"46264","2022","COM","2020","200","7","207","2023-01-02"
"46265","2022","COM","2020","333","5","338","2023-01-02"
"46266","2022","COM","2020","535","9","544","2023-01-02"
"46267","2022","COM","2020","567","12","579","2023-01-02"
"46268","2022","COM","2020","907","20","927","2023-01-02"
"46269","2022","COM","2020","60","2","62","2023-01-02"
"46270","2022","COM","2020","242","3","245","2023-01-02"
"46271","2022","COM","2020","405","17","422","2023-01-02"
"46272","2022","COM","2020","287","3","290","2023-01-02"
"46273","2022","COM","2020","844","26","870","2023-01-02"
"46276","2022","COM","2020","183","5","188","2023-01-02"
"46277","2022","COM","2020","201","4","205","2023-01-02"
"46279","2022","COM","2020","206","3","209","2023-01-02"
"46280","2022","COM","2020","177","5","182","2023-01-02"
"46281","2022","COM","2020","198","6","204","2023-01-02"
"46282","2022","COM","2020","95","0","95","2023-01-02"
"46283","2022","COM","2020","317","8","325","2023-01-02"
"46284","2022","COM","2020","407","8","415","2023-01-02"
"46286","2022","COM","2020","175","4","179","2023-01-02"
"46288","2022","COM","2020","215","10","225","2023-01-02"
"46289","2022","COM","2020","159","1","160","2023-01-02"
"46290","2022","COM","2020","342","7","349","2023-01-02"
"46292","2022","COM","2020","193","6","199","2023-01-02"
"46293","2022","COM","2020","483","12","495","2023-01-02"
"46294","2022","COM","2020","144","4","148","2023-01-02"
"46295","2022","COM","2020","222","4","226","2023-01-02"
"46296","2022","COM","2020","429","16","445","2023-01-02"
"46297","2022","COM","2020","1208","25","1233","2023-01-02"
"46299","2022","COM","2020","119","4","123","2023-01-02"
"46301","2022","COM","2020","530","5","535","2023-01-02"
"46302","2022","COM","2020","132","2","134","2023-01-02"
"46303","2022","COM","2020","134","2","136","2023-01-02"
"46304","2022","COM","2020","141","1","142","2023-01-02"
"46305","2022","COM","2020","310","3","313","2023-01-02"
"46306","2022","COM","2020","88","1","89","2023-01-02"
"46307","2022","COM","2020","640","7","647","2023-01-02"
"46308","2022","COM","2020","102","1","103","2023-01-02"
"46309","2022","COM","2020","3203","317","3520","2023-01-02"
"46310","2022","COM","2020","132","2","134","2023-01-02"
"46311","2022","COM","2020","1334","19","1353","2023-01-02"
"46312","2022","COM","2020","275","2","277","2023-01-02"
"46313","2022","COM","2020","454","10","464","2023-01-02"
"46314","2022","COM","2020","176","39","215","2023-01-02"
"46315","2022","COM","2020","166","3","169","2023-01-02"
"46316","2022","COM","2020","289","5","294","2023-01-02"
"46317","2022","COM","2020","484","13","497","2023-01-02"
"46318","2022","COM","2020","238","11","249","2023-01-02"
"46319","2022","COM","2020","173","3","176","2023-01-02"
"46320","2022","COM","2020","314","14","328","2023-01-02"
"46321","2022","COM","2020","370","8","378","2023-01-02"
"46322","2022","COM","2020","811","31","842","2023-01-02"
"46323","2022","COM","2020","99","2","101","2023-01-02"
"46324","2022","COM","2020","215","4","219","2023-01-02"
"46328","2022","COM","2020","345","12","357","2023-01-02"
"46329","2022","COM","2020","328","2","330","2023-01-02"
"46330","2022","COM","2020","1305","24","1329","2023-01-02"
"46332","2022","COM","2020","336","15","351","2023-01-02"
"46333","2022","COM","2020","183","4","187","2023-01-02"
"46334","2022","COM","2020","1546","57","1603","2023-01-02"
"46335","2022","COM","2020","389","16","405","2023-01-02"
"46336","2022","COM","2020","340","32","372","2023-01-02"
"46337","2022","COM","2020","261","7","268","2023-01-02"
"46338","2022","COM","2020","75","1","76","2023-01-02"
"46339","2022","COM","2020","380","8","388","2023-01-02"
"46340","2022","COM","2020","371","13","384","2023-01-02"
"47001","2022","COM","2020","32214","832","33046","2023-01-02"
"47002","2022","COM","2020","108","4","112","2023-01-02"
"47003","2022","COM","2020","439","10","449","2023-01-02"
"47004","2022","COM","2020","4253","115","4368","2023-01-02"
"47005","2022","COM","2020","485","5","490","2023-01-02"
"47006","2022","COM","2020","602","13","615","2023-01-02"
"47007","2022","COM","2020","165","5","170","2023-01-02"
"47008","2022","COM","2020","108","4","112","2023-01-02"
"47009","2022","COM","2020","240","9","249","2023-01-02"
"47010","2022","COM","2020","222","3","225","2023-01-02"
"47011","2022","COM","2020","198","9","207","2023-01-02"
"47012","2022","COM","2020","310","2","312","2023-01-02"
"47013","2022","COM","2020","320","11","331","2023-01-02"
"47014","2022","COM","2020","208","7","215","2023-01-02"
"47015","2022","COM","2020","2036","39","2075","2023-01-02"
"47016","2022","COM","2020","1165","24","1189","2023-01-02"
"47017","2022","COM","2020","422","9","431","2023-01-02"
"47018","2022","COM","2020","173","6","179","2023-01-02"
"47019","2022","COM","2020","986","16","1002","2023-01-02"
"47020","2022","COM","2020","188","8","196","2023-01-02"
"47021","2022","COM","2020","1501","70","1571","2023-01-02"
"47022","2022","COM","2020","535","9","544","2023-01-02"
"47023","2022","COM","2020","344","8","352","2023-01-02"
"47024","2022","COM","2020","1638","43","1681","2023-01-02"
"47025","2022","COM","2020","550","10","560","2023-01-02"
"47026","2022","COM","2020","227","8","235","2023-01-02"
"47027","2022","COM","2020","2987","43","3030","2023-01-02"
"47028","2022","COM","2020","847","20","867","2023-01-02"
"47029","2022","COM","2020","506","13","519","2023-01-02"
"47030","2022","COM","2020","211","6","217","2023-01-02"
"47031","2022","COM","2020","5639","94","5733","2023-01-02"
"47032","2022","COM","2020","6222","147","6369","2023-01-02"
"47033","2022","COM","2020","407","8","415","2023-01-02"
"47034","2022","COM","2020","639","14","653","2023-01-02"
"47035","2022","COM","2020","316","75","391","2023-01-02"
"47036","2022","COM","2020","374","6","380","2023-01-02"
"47037","2022","COM","2020","254","4","258","2023-01-02"
"47038","2022","COM","2020","611","25","636","2023-01-02"
"47039","2022","COM","2020","36","0","36","2023-01-02"
"47040","2022","COM","2020","2100","47","2147","2023-01-02"
"47041","2022","COM","2020","729","17","746","2023-01-02"
"47042","2022","COM","2020","182","6","188","2023-01-02"
"47043","2022","COM","2020","1257","27","1284","2023-01-02"
"47044","2022","COM","2020","310","6","316","2023-01-02"
"47045","2022","COM","2020","476","5","481","2023-01-02"
"47046","2022","COM","2020","595","13","608","2023-01-02"
"47047","2022","COM","2020","183","5","188","2023-01-02"
"47048","2022","COM","2020","1347","18","1365","2023-01-02"
"47049","2022","COM","2020","2402","50","2452","2023-01-02"
"47050","2022","COM","2020","131","2","133","2023-01-02"
"47051","2022","COM","2020","2391","48","2439","2023-01-02"
"47052","2022","COM","2020","4521","54","4575","2023-01-02"
"47053","2022","COM","2020","383","7","390","2023-01-02"
"47054","2022","COM","2020","1796","22","1818","2023-01-02"
"47055","2022","COM","2020","516","7","523","2023-01-02"
"47056","2022","COM","2020","912","33","945","2023-01-02"
"47057","2022","COM","2020","1366","20","1386","2023-01-02"
"47058","2022","COM","2020","262","10","272","2023-01-02"
"47059","2022","COM","2020","262","4","266","2023-01-02"
"47060","2022","COM","2020","1136","23","1159","2023-01-02"
"47061","2022","COM","2020","789","8","797","2023-01-02"
"47062","2022","COM","2020","413","4","417","2023-01-02"
"47063","2022","COM","2020","163","2","165","2023-01-02"
"47064","2022","COM","2020","242","6","248","2023-01-02"
"47065","2022","COM","2020","2578","196","2774","2023-01-02"
"47066","2022","COM","2020","878","18","896","2023-01-02"
"47067","2022","COM","2020","394","8","402","2023-01-02"
"47068","2022","COM","2020","1089","23","1112","2023-01-02"
"47069","2022","COM","2020","3129","48","3177","2023-01-02"
"47070","2022","COM","2020","846","18","864","2023-01-02"
"47071","2022","COM","2020","244","2","246","2023-01-02"
"47072","2022","COM","2020","108","3","111","2023-01-02"
"47073","2022","COM","2020","196","6","202","2023-01-02"
"47074","2022","COM","2020","371","7","378","2023-01-02"
"47075","2022","COM","2020","1094","24","1118","2023-01-02"
"47076","2022","COM","2020","280","5","285","2023-01-02"
"47077","2022","COM","2020","852","18","870","2023-01-02"
"47078","2022","COM","2020","1357","45","1402","2023-01-02"
"47079","2022","COM","2020","524","17","541","2023-01-02"
"47080","2022","COM","2020","141","2","143","2023-01-02"
"47081","2022","COM","2020","714","15","729","2023-01-02"
"47082","2022","COM","2020","215","1","216","2023-01-02"
"47083","2022","COM","2020","106","1","107","2023-01-02"
"47084","2022","COM","2020","274","6","280","2023-01-02"
"47085","2022","COM","2020","297","3","300","2023-01-02"
"47086","2022","COM","2020","1214","22","1236","2023-01-02"
"47087","2022","COM","2020","160","7","167","2023-01-02"
"47088","2022","COM","2020","612","9","621","2023-01-02"
"47089","2022","COM","2020","148","3","151","2023-01-02"
"47090","2022","COM","2020","363","8","371","2023-01-02"
"47091","2022","COM","2020","2278","44","2322","2023-01-02"
"47092","2022","COM","2020","399","6","405","2023-01-02"
"47093","2022","COM","2020","344","9","353","2023-01-02"
"47094","2022","COM","2020","814","14","828","2023-01-02"
"47095","2022","COM","2020","860","14","874","2023-01-02"
"47096","2022","COM","2020","204","5","209","2023-01-02"
"47097","2022","COM","2020","1007","18","1025","2023-01-02"
"47098","2022","COM","2020","346","15","361","2023-01-02"
"47099","2022","COM","2020","620","16","636","2023-01-02"
"47100","2022","COM","2020","5479","218","5697","2023-01-02"
"47101","2022","COM","2020","1333","27","1360","2023-01-02"
"47102","2022","COM","2020","738","11","749","2023-01-02"
"47103","2022","COM","2020","228","3","231","2023-01-02"
"47104","2022","COM","2020","259","5","264","2023-01-02"
"47105","2022","COM","2020","283","5","288","2023-01-02"
"47106","2022","COM","2020","4709","106","4815","2023-01-02"
"47107","2022","COM","2020","317","3","320","2023-01-02"
"47108","2022","COM","2020","244","7","251","2023-01-02"
"47109","2022","COM","2020","295","5","300","2023-01-02"
"47110","2022","COM","2020","1630","30","1660","2023-01-02"
"47111","2022","COM","2020","592","16","608","2023-01-02"
"47112","2022","COM","2020","440","8","448","2023-01-02"
"47113","2022","COM","2020","141","3","144","2023-01-02"
"47114","2022","COM","2020","398","7","405","2023-01-02"
"47115","2022","COM","2020","251","6","257","2023-01-02"
"47117","2022","COM","2020","1016","13","1029","2023-01-02"
"47118","2022","COM","2020","180","4","184","2023-01-02"
"47119","2022","COM","2020","550","9","559","2023-01-02"
"47120","2022","COM","2020","99","3","102","2023-01-02"
"47121","2022","COM","2020","307","3","310","2023-01-02"
"47122","2022","COM","2020","180","2","182","2023-01-02"
"47123","2022","COM","2020","414","5","419","2023-01-02"
"47124","2022","COM","2020","209","5","214","2023-01-02"
"47125","2022","COM","2020","313","7","320","2023-01-02"
"47126","2022","COM","2020","97","1","98","2023-01-02"
"47127","2022","COM","2020","812","11","823","2023-01-02"
"47128","2022","COM","2020","1104","30","1134","2023-01-02"
"47129","2022","COM","2020","278","6","284","2023-01-02"
"47130","2022","COM","2020","326","4","330","2023-01-02"
"47131","2022","COM","2020","700","15","715","2023-01-02"
"47132","2022","COM","2020","224","3","227","2023-01-02"
"47133","2022","COM","2020","586","11","597","2023-01-02"
"47134","2022","COM","2020","365","9","374","2023-01-02"
"47135","2022","COM","2020","389","8","397","2023-01-02"
"47136","2022","COM","2020","141","2","143","2023-01-02"
"47137","2022","COM","2020","1342","31","1373","2023-01-02"
"47138","2022","COM","2020","1597","24","1621","2023-01-02"
"47139","2022","COM","2020","94","1","95","2023-01-02"
"47140","2022","COM","2020","699","14","713","2023-01-02"
"47141","2022","COM","2020","279","6","285","2023-01-02"
"47142","2022","COM","2020","739","12","751","2023-01-02"
"47143","2022","COM","2020","2278","58","2336","2023-01-02"
"47144","2022","COM","2020","564","20","584","2023-01-02"
"47145","2022","COM","2020","3726","55","3781","2023-01-02"
"47146","2022","COM","2020","1416","28","1444","2023-01-02"
"47147","2022","COM","2020","685","12","697","2023-01-02"
"47148","2022","COM","2020","203","1","204","2023-01-02"
"47150","2022","COM","2020","367","6","373","2023-01-02"
"47151","2022","COM","2020","419","4","423","2023-01-02"
"47152","2022","COM","2020","413","6","419","2023-01-02"
"47154","2022","COM","2020","373","4","377","2023-01-02"
"47155","2022","COM","2020","662","16","678","2023-01-02"
"47156","2022","COM","2020","857","8","865","2023-01-02"
"47157","2022","COM","2020","17265","532","17797","2023-01-02"
"47158","2022","COM","2020","171","5","176","2023-01-02"
"47159","2022","COM","2020","1482","34","1516","2023-01-02"
"47160","2022","COM","2020","182","2","184","2023-01-02"
"47161","2022","COM","2020","116","1","117","2023-01-02"
"47162","2022","COM","2020","216","5","221","2023-01-02"
"47163","2022","COM","2020","608","12","620","2023-01-02"
"47164","2022","COM","2020","105","3","108","2023-01-02"
"47165","2022","COM","2020","1338","59","1397","2023-01-02"
"47167","2022","COM","2020","1465","24","1489","2023-01-02"
"47168","2022","COM","2020","3087","103","3190","2023-01-02"
"47169","2022","COM","2020","1188","54","1242","2023-01-02"
"47170","2022","COM","2020","625","23","648","2023-01-02"
"47171","2022","COM","2020","445","8","453","2023-01-02"
"47172","2022","COM","2020","587","18","605","2023-01-02"
"47173","2022","COM","2020","890","10","900","2023-01-02"
"47174","2022","COM","2020","736","17","753","2023-01-02"
"47175","2022","COM","2020","2338","53","2391","2023-01-02"
"47176","2022","COM","2020","171","12","183","2023-01-02"
"47177","2022","COM","2020","190","2","192","2023-01-02"
"47178","2022","COM","2020","401","5","406","2023-01-02"
"47179","2022","COM","2020","2054","34","2088","2023-01-02"
"47180","2022","COM","2020","641","14","655","2023-01-02"
"47181","2022","COM","2020","271","3","274","2023-01-02"
"47182","2022","COM","2020","241","1","242","2023-01-02"
"47183","2022","COM","2020","185","2","187","2023-01-02"
"47184","2022","COM","2020","261","4","265","2023-01-02"
"47185","2022","COM","2020","2669","51","2720","2023-01-02"
"47186","2022","COM","2020","767","12","779","2023-01-02"
"47187","2022","COM","2020","327","2","329","2023-01-02"
"47188","2022","COM","2020","286","3","289","2023-01-02"
"47189","2022","COM","2020","145","2","147","2023-01-02"
"47190","2022","COM","2020","550","45","595","2023-01-02"
"47191","2022","COM","2020","836","16","852","2023-01-02"
"47192","2022","COM","2020","78","0","78","2023-01-02"
"47193","2022","COM","2020","199","6","205","2023-01-02"
"47194","2022","COM","2020","317","5","322","2023-01-02"
"47195","2022","COM","2020","6854","511","7365","2023-01-02"
"47196","2022","COM","2020","223","1","224","2023-01-02"
"47197","2022","COM","2020","253","1","254","2023-01-02"
"47198","2022","COM","2020","325","5","330","2023-01-02"
"47199","2022","COM","2020","323","11","334","2023-01-02"
"47200","2022","COM","2020","114","1","115","2023-01-02"
"47201","2022","COM","2020","9352","166","9518","2023-01-02"
"47202","2022","COM","2020","309","7","316","2023-01-02"
"47203","2022","COM","2020","2395","37","2432","2023-01-02"
"47204","2022","COM","2020","284","3","287","2023-01-02"
"47205","2022","COM","2020","197","8","205","2023-01-02"
"47206","2022","COM","2020","570","5","575","2023-01-02"
"47207","2022","COM","2020","203","4","207","2023-01-02"
"47208","2022","COM","2020","198","6","204","2023-01-02"
"47209","2022","COM","2020","4156","119","4275","2023-01-02"
"47210","2022","COM","2020","1844","31","1875","2023-01-02"
"47211","2022","COM","2020","207","7","214","2023-01-02"
"47212","2022","COM","2020","288","6","294","2023-01-02"
"47213","2022","COM","2020","991","26","1017","2023-01-02"
"47214","2022","COM","2020","692","16","708","2023-01-02"
"47215","2022","COM","2020","3717","119","3836","2023-01-02"
"47216","2022","COM","2020","681","12","693","2023-01-02"
"47217","2022","COM","2020","913","15","928","2023-01-02"
"47218","2022","COM","2020","237","4","241","2023-01-02"
"47219","2022","COM","2020","180","2","182","2023-01-02"
"47220","2022","COM","2020","292","5","297","2023-01-02"
"47221","2022","COM","2020","602","14","616","2023-01-02"
"47222","2022","COM","2020","497","9","506","2023-01-02"
"47223","2022","COM","2020","201","6","207","2023-01-02"
"47224","2022","COM","2020","159","6","165","2023-01-02"
"47225","2022","COM","2020","2126","43","2169","2023-01-02"
"47226","2022","COM","2020","522","8","530","2023-01-02"
"47227","2022","COM","2020","180","2","182","2023-01-02"
"47228","2022","COM","2020","715","10","725","2023-01-02"
"47229","2022","COM","2020","223","5","228","2023-01-02"
"47230","2022","COM","2020","389","7","396","2023-01-02"
"47231","2022","COM","2020","175","2","177","2023-01-02"
"47232","2022","COM","2020","518","3","521","2023-01-02"
"47233","2022","COM","2020","3174","94","3268","2023-01-02"
"47234","2022","COM","2020","675","20","695","2023-01-02"
"47235","2022","COM","2020","472","7","479","2023-01-02"
"47236","2022","COM","2020","104","2","106","2023-01-02"
"47237","2022","COM","2020","505","11","516","2023-01-02"
"47238","2022","COM","2020","1548","51","1599","2023-01-02"
"47239","2022","COM","2020","853","15","868","2023-01-02"
"47240","2022","COM","2020","270","10","280","2023-01-02"
"47241","2022","COM","2020","680","18","698","2023-01-02"
"47242","2022","COM","2020","516","13","529","2023-01-02"
"47244","2022","COM","2020","387","5","392","2023-01-02"
"47245","2022","COM","2020","91","2","93","2023-01-02"
"47246","2022","COM","2020","1496","39","1535","2023-01-02"
"47247","2022","COM","2020","245","10","255","2023-01-02"
"47248","2022","COM","2020","567","10","577","2023-01-02"
"47249","2022","COM","2020","522","2","524","2023-01-02"
"47250","2022","COM","2020","118","4","122","2023-01-02"
"47251","2022","COM","2020","319","4","323","2023-01-02"
"47252","2022","COM","2020","6487","173","6660","2023-01-02"
"47253","2022","COM","2020","657","4","661","2023-01-02"
"47254","2022","COM","2020","306","8","314","2023-01-02"
"47255","2022","COM","2020","168","2","170","2023-01-02"
"47256","2022","COM","2020","104","4","108","2023-01-02"
"47257","2022","COM","2020","617","9","626","2023-01-02"
"47258","2022","COM","2020","310","11","321","2023-01-02"
"47259","2022","COM","2020","103","4","107","2023-01-02"
"47260","2022","COM","2020","396","5","401","2023-01-02"
"47262","2022","COM","2020","424","6","430","2023-01-02"
"47263","2022","COM","2020","606","15","621","2023-01-02"
"47264","2022","COM","2020","1090","19","1109","2023-01-02"
"47265","2022","COM","2020","372","8","380","2023-01-02"
"47266","2022","COM","2020","192","2","194","2023-01-02"
"47267","2022","COM","2020","289","2","291","2023-01-02"
"47269","2022","COM","2020","845","19","864","2023-01-02"
"47271","2022","COM","2020","356","3","359","2023-01-02"
"47272","2022","COM","2020","195","7","202","2023-01-02"
"47273","2022","COM","2020","187","6","193","2023-01-02"
"47274","2022","COM","2020","393","6","399","2023-01-02"
"47275","2022","COM","2020","201","1","202","2023-01-02"
"47276","2022","COM","2020","301","7","308","2023-01-02"
"47277","2022","COM","2020","342","1","343","2023-01-02"
"47278","2022","COM","2020","478","9","487","2023-01-02"
"47279","2022","COM","2020","359","5","364","2023-01-02"
"47280","2022","COM","2020","2367","53","2420","2023-01-02"
"47281","2022","COM","2020","252","1","253","2023-01-02"
"47282","2022","COM","2020","231","7","238","2023-01-02"
"47283","2022","COM","2020","1164","31","1195","2023-01-02"
"47284","2022","COM","2020","287","7","294","2023-01-02"
"47285","2022","COM","2020","897","17","914","2023-01-02"
"47286","2022","COM","2020","100","5","105","2023-01-02"
"47287","2022","COM","2020","258","8","266","2023-01-02"
"47288","2022","COM","2020","522","14","536","2023-01-02"
"47289","2022","COM","2020","510","7","517","2023-01-02"
"47290","2022","COM","2020","557","6","563","2023-01-02"
"47291","2022","COM","2020","628","16","644","2023-01-02"
"47292","2022","COM","2020","576","6","582","2023-01-02"
"47293","2022","COM","2020","382","18","400","2023-01-02"
"47294","2022","COM","2020","217","1","218","2023-01-02"
"47295","2022","COM","2020","305","6","311","2023-01-02"
"47296","2022","COM","2020","155","2","157","2023-01-02"
"47297","2022","COM","2020","141","3","144","2023-01-02"
"47298","2022","COM","2020","209","0","209","2023-01-02"
"47299","2022","COM","2020","173","2","175","2023-01-02"
"47300","2022","COM","2020","1169","19","1188","2023-01-02"
"47301","2022","COM","2020","1058","12","1070","2023-01-02"
"47302","2022","COM","2020","653","6","659","2023-01-02"
"47303","2022","COM","2020","226","3","229","2023-01-02"
"47304","2022","COM","2020","60","2","62","2023-01-02"
"47305","2022","COM","2020","382","6","388","2023-01-02"
"47306","2022","COM","2020","1059","19","1078","2023-01-02"
"47307","2022","COM","2020","200","5","205","2023-01-02"
"47308","2022","COM","2020","223","2","225","2023-01-02"
"47309","2022","COM","2020","456","4","460","2023-01-02"
"47310","2022","COM","2020","9213","158","9371","2023-01-02"
"47311","2022","COM","2020","135","2","137","2023-01-02"
"47312","2022","COM","2020","764","13","777","2023-01-02"
"47313","2022","COM","2020","140","1","141","2023-01-02"
"47314","2022","COM","2020","400","11","411","2023-01-02"
"47315","2022","COM","2020","911","25","936","2023-01-02"
"47316","2022","COM","2020","663","7","670","2023-01-02"
"47317","2022","COM","2020","550","5","555","2023-01-02"
"47318","2022","COM","2020","988","16","1004","2023-01-02"
"47319","2022","COM","2020","111","3","114","2023-01-02"
"47320","2022","COM","2020","397","2","399","2023-01-02"
"47321","2022","COM","2020","319","5","324","2023-01-02"
"47323","2022","COM","2020","21690","695","22385","2023-01-02"
"47324","2022","COM","2020","1275","32","1307","2023-01-02"
"47325","2022","COM","2020","458","6","464","2023-01-02"
"47326","2022","COM","2020","1676","35","1711","2023-01-02"
"47327","2022","COM","2020","388","11","399","2023-01-02"
"47328","2022","COM","2020","545","19","564","2023-01-02"
"48001","2022","COM","2020","164","1","165","2023-01-02"
"48002","2022","COM","2020","557","21","578","2023-01-02"
"48003","2022","COM","2020","257","6","263","2023-01-02"
"48004","2022","COM","2020","219","6","225","2023-01-02"
"48005","2022","COM","2020","327","4","331","2023-01-02"
"48007","2022","COM","2020","50","0","50","2023-01-02"
"48008","2022","COM","2020","191","8","199","2023-01-02"
"48009","2022","COM","2020","2295","98","2393","2023-01-02"
"48010","2022","COM","2020","365","6","371","2023-01-02"
"48012","2022","COM","2020","342","6","348","2023-01-02"
"48013","2022","COM","2020","986","41","1027","2023-01-02"
"48015","2022","COM","2020","176","8","184","2023-01-02"
"48016","2022","COM","2020","566","18","584","2023-01-02"
"48017","2022","COM","2020","1078","36","1114","2023-01-02"
"48018","2022","COM","2020","773","19","792","2023-01-02"
"48019","2022","COM","2020","204","7","211","2023-01-02"
"48020","2022","COM","2020","67","0","67","2023-01-02"
"48021","2022","COM","2020","162","5","167","2023-01-02"
"48025","2022","COM","2020","420","24","444","2023-01-02"
"48026","2022","COM","2020","266","1","267","2023-01-02"
"48027","2022","COM","2020","1062","30","1092","2023-01-02"
"48028","2022","COM","2020","145","7","152","2023-01-02"
"48029","2022","COM","2020","151","3","154","2023-01-02"
"48030","2022","COM","2020","389","7","396","2023-01-02"
"48031","2022","COM","2020","80","4","84","2023-01-02"
"48032","2022","COM","2020","220","6","226","2023-01-02"
"48034","2022","COM","2020","2099","98","2197","2023-01-02"
"48036","2022","COM","2020","125","2","127","2023-01-02"
"48037","2022","COM","2020","120","1","121","2023-01-02"
"48038","2022","COM","2020","545","7","552","2023-01-02"
"48039","2022","COM","2020","1452","44","1496","2023-01-02"
"48041","2022","COM","2020","77","2","79","2023-01-02"
"48042","2022","COM","2020","918","34","952","2023-01-02"
"48043","2022","COM","2020","524","7","531","2023-01-02"
"48044","2022","COM","2020","85","2","87","2023-01-02"
"48045","2022","COM","2020","291","9","300","2023-01-02"
"48046","2022","COM","2020","64","4","68","2023-01-02"
"48048","2022","COM","2020","63","2","65","2023-01-02"
"48050","2022","COM","2020","451","12","463","2023-01-02"
"48051","2022","COM","2020","686","48","734","2023-01-02"
"48053","2022","COM","2020","193","8","201","2023-01-02"
"48054","2022","COM","2020","48","5","53","2023-01-02"
"48055","2022","COM","2020","190","4","194","2023-01-02"
"48056","2022","COM","2020","411","8","419","2023-01-02"
"48058","2022","COM","2020","148","4","152","2023-01-02"
"48059","2022","COM","2020","306","8","314","2023-01-02"
"48061","2022","COM","2020","2082","54","2136","2023-01-02"
"48063","2022","COM","2020","231","3","234","2023-01-02"
"48064","2022","COM","2020","369","7","376","2023-01-02"
"48065","2022","COM","2020","80","0","80","2023-01-02"
"48067","2022","COM","2020","100","2","102","2023-01-02"
"48068","2022","COM","2020","160","6","166","2023-01-02"
"48069","2022","COM","2020","52","0","52","2023-01-02"
"48070","2022","COM","2020","751","18","769","2023-01-02"
"48071","2022","COM","2020","63","1","64","2023-01-02"
"48072","2022","COM","2020","236","6","242","2023-01-02"
"48073","2022","COM","2020","94","2","96","2023-01-02"
"48074","2022","COM","2020","226","11","237","2023-01-02"
"48075","2022","COM","2020","900","25","925","2023-01-02"
"48077","2022","COM","2020","47","2","49","2023-01-02"
"48079","2022","COM","2020","116","3","119","2023-01-02"
"48080","2022","COM","2020","2875","194","3069","2023-01-02"
"48081","2022","COM","2020","334","9","343","2023-01-02"
"48082","2022","COM","2020","100","2","102","2023-01-02"
"48083","2022","COM","2020","151","3","154","2023-01-02"
"48085","2022","COM","2020","93","4","97","2023-01-02"
"48086","2022","COM","2020","206","7","213","2023-01-02"
"48087","2022","COM","2020","264","10","274","2023-01-02"
"48088","2022","COM","2020","134","5","139","2023-01-02"
"48089","2022","COM","2020","497","10","507","2023-01-02"
"48090","2022","COM","2020","735","18","753","2023-01-02"
"48091","2022","COM","2020","46","3","49","2023-01-02"
"48092","2022","COM","2020","4713","243","4956","2023-01-02"
"48094","2022","COM","2020","944","28","972","2023-01-02"
"48095","2022","COM","2020","12336","807","13143","2023-01-02"
"48096","2022","COM","2020","794","113","907","2023-01-02"
"48097","2022","COM","2020","217","10","227","2023-01-02"
"48098","2022","COM","2020","97","4","101","2023-01-02"
"48099","2022","COM","2020","2091","46","2137","2023-01-02"
"48100","2022","COM","2020","127","1","128","2023-01-02"
"48103","2022","COM","2020","1176","69","1245","2023-01-02"
"48104","2022","COM","2020","564","33","597","2023-01-02"
"48105","2022","COM","2020","373","15","388","2023-01-02"
"48106","2022","COM","2020","95","7","102","2023-01-02"
"48107","2022","COM","2020","177","5","182","2023-01-02"
"48108","2022","COM","2020","76","2","78","2023-01-02"
"48110","2022","COM","2020","102","4","106","2023-01-02"
"48111","2022","COM","2020","235","5","240","2023-01-02"
"48112","2022","COM","2020","164","3","167","2023-01-02"
"48115","2022","COM","2020","166","4","170","2023-01-02"
"48116","2022","COM","2020","554","18","572","2023-01-02"
"48117","2022","COM","2020","123","4","127","2023-01-02"
"48119","2022","COM","2020","257","8","265","2023-01-02"
"48121","2022","COM","2020","231","10","241","2023-01-02"
"48123","2022","COM","2020","169","6","175","2023-01-02"
"48124","2022","COM","2020","103","1","104","2023-01-02"
"48126","2022","COM","2020","363","11","374","2023-01-02"
"48127","2022","COM","2020","1264","25","1289","2023-01-02"
"48128","2022","COM","2020","597","20","617","2023-01-02"
"48129","2022","COM","2020","227","4","231","2023-01-02"
"48130","2022","COM","2020","127","2","129","2023-01-02"
"48131","2022","COM","2020","132","7","139","2023-01-02"
"48132","2022","COM","2020","1378","33","1411","2023-01-02"
"48135","2022","COM","2020","190","2","192","2023-01-02"
"48136","2022","COM","2020","154","2","156","2023-01-02"
"48137","2022","COM","2020","612","20","632","2023-01-02"
"48138","2022","COM","2020","67","2","69","2023-01-02"
"48139","2022","COM","2020","253","2","255","2023-01-02"
"48140","2022","COM","2020","4220","594","4814","2023-01-02"
"48141","2022","COM","2020","105","6","111","2023-01-02"
"48144","2022","COM","2020","284","5","289","2023-01-02"
"48145","2022","COM","2020","153","7","160","2023-01-02"
"48146","2022","COM","2020","905","33","938","2023-01-02"
"48147","2022","COM","2020","640","50","690","2023-01-02"
"48148","2022","COM","2020","502","24","526","2023-01-02"
"48149","2022","COM","2020","35","2","37","2023-01-02"
"48150","2022","COM","2020","186","14","200","2023-01-02"
"48151","2022","COM","2020","60","3","63","2023-01-02"
"48152","2022","COM","2020","263","5","268","2023-01-02"
"48153","2022","COM","2020","88","5","93","2023-01-02"
"48155","2022","COM","2020","468","8","476","2023-01-02"
"48156","2022","COM","2020","860","23","883","2023-01-02"
"48157","2022","COM","2020","104","2","106","2023-01-02"
"48158","2022","COM","2020","98","5","103","2023-01-02"
"48160","2022","COM","2020","146","6","152","2023-01-02"
"48161","2022","COM","2020","64","2","66","2023-01-02"
"48163","2022","COM","2020","117","3","120","2023-01-02"
"48165","2022","COM","2020","187","9","196","2023-01-02"
"48166","2022","COM","2020","290","12","302","2023-01-02"
"48167","2022","COM","2020","37","1","38","2023-01-02"
"48168","2022","COM","2020","190","5","195","2023-01-02"
"48169","2022","COM","2020","207","11","218","2023-01-02"
"48170","2022","COM","2020","196","5","201","2023-01-02"
"48171","2022","COM","2020","193","2","195","2023-01-02"
"48173","2022","COM","2020","229","3","232","2023-01-02"
"48174","2022","COM","2020","139","4","143","2023-01-02"
"48175","2022","COM","2020","174","9","183","2023-01-02"
"48176","2022","COM","2020","91","4","95","2023-01-02"
"48177","2022","COM","2020","319","9","328","2023-01-02"
"48178","2022","COM","2020","223","7","230","2023-01-02"
"48179","2022","COM","2020","109","2","111","2023-01-02"
"48181","2022","COM","2020","62","4","66","2023-01-02"
"48182","2022","COM","2020","58","0","58","2023-01-02"
"48185","2022","COM","2020","166","5","171","2023-01-02"
"48187","2022","COM","2020","103","1","104","2023-01-02"
"48188","2022","COM","2020","246","4","250","2023-01-02"
"48190","2022","COM","2020","217","8","225","2023-01-02"
"48191","2022","COM","2020","95","3","98","2023-01-02"
"48192","2022","COM","2020","91","1","92","2023-01-02"
"48193","2022","COM","2020","216","0","216","2023-01-02"
"48194","2022","COM","2020","429","40","469","2023-01-02"
"48198","2022","COM","2020","570","16","586","2023-01-02"
"49002","2022","COM","2020","2947","49","2996","2023-01-02"
"49003","2022","COM","2020","1743","37","1780","2023-01-02"
"49007","2022","COM","2020","155876","3227","159103","2023-01-02"
"49008","2022","COM","2020","922","24","946","2023-01-02"
"49009","2022","COM","2020","460","4","464","2023-01-02"
"49010","2022","COM","2020","319","5","324","2023-01-02"
"49011","2022","COM","2020","422","7","429","2023-01-02"
"49012","2022","COM","2020","365","7","372","2023-01-02"
"49015","2022","COM","2020","14727","391","15118","2023-01-02"
"49017","2022","COM","2020","612","2","614","2023-01-02"
"49018","2022","COM","2020","11735","243","11978","2023-01-02"
"49020","2022","COM","2020","5528","107","5635","2023-01-02"
"49021","2022","COM","2020","7096","146","7242","2023-01-02"
"49022","2022","COM","2020","1359","29","1388","2023-01-02"
"49023","2022","COM","2020","23465","702","24167","2023-01-02"
"49026","2022","COM","2020","2784","90","2874","2023-01-02"
"49027","2022","COM","2020","2126","41","2167","2023-01-02"
"49028","2022","COM","2020","126","6","132","2023-01-02"
"49029","2022","COM","2020","1302","29","1331","2023-01-02"
"49030","2022","COM","2020","955","32","987","2023-01-02"
"49035","2022","COM","2020","6757","140","6897","2023-01-02"
"49036","2022","COM","2020","755","17","772","2023-01-02"
"49038","2022","COM","2020","234","4","238","2023-01-02"
"49041","2022","COM","2020","2046","36","2082","2023-01-02"
"49045","2022","COM","2020","600","13","613","2023-01-02"
"49048","2022","COM","2020","3129","41","3170","2023-01-02"
"49050","2022","COM","2020","10906","273","11179","2023-01-02"
"49053","2022","COM","2020","347","5","352","2023-01-02"
"49054","2022","COM","2020","2821","49","2870","2023-01-02"
"49055","2022","COM","2020","2362","36","2398","2023-01-02"
"49056","2022","COM","2020","267","3","270","2023-01-02"
"49057","2022","COM","2020","334","6","340","2023-01-02"
"49058","2022","COM","2020","883","7","890","2023-01-02"
"49060","2022","COM","2020","3471","79","3550","2023-01-02"
"49061","2022","COM","2020","795","15","810","2023-01-02"
"49063","2022","COM","2020","6475","174","6649","2023-01-02"
"49064","2022","COM","2020","394","12","406","2023-01-02"
"49067","2022","COM","2020","342","6","348","2023-01-02"
"49068","2022","COM","2020","1855","31","1886","2023-01-02"
"49069","2022","COM","2020","16468","308","16776","2023-01-02"
"49070","2022","COM","2020","692","10","702","2023-01-02"
"49076","2022","COM","2020","782","11","793","2023-01-02"
"49080","2022","COM","2020","8743","152","8895","2023-01-02"
"49082","2022","COM","2020","932","17","949","2023-01-02"
"49086","2022","COM","2020","3950","73","4023","2023-01-02"
"49089","2022","COM","2020","1052","28","1080","2023-01-02"
"49090","2022","COM","2020","995","8","1003","2023-01-02"
"49092","2022","COM","2020","21187","624","21811","2023-01-02"
"49099","2022","COM","2020","54357","1929","56286","2023-01-02"
"49100","2022","COM","2020","470","17","487","2023-01-02"
"49102","2022","COM","2020","341","5","346","2023-01-02"
"49107","2022","COM","2020","471","15","486","2023-01-02"
"49109","2022","COM","2020","1566","29","1595","2023-01-02"
"49110","2022","COM","2020","1907","33","1940","2023-01-02"
"49112","2022","COM","2020","961","27","988","2023-01-02"
"49113","2022","COM","2020","527","9","536","2023-01-02"
"49114","2022","COM","2020","142","4","146","2023-01-02"
"49120","2022","COM","2020","1405","29","1434","2023-01-02"
"49121","2022","COM","2020","464","8","472","2023-01-02"
"49123","2022","COM","2020","1746","56","1802","2023-01-02"
"49125","2022","COM","2020","11224","248","11472","2023-01-02"
"49127","2022","COM","2020","3343","74","3417","2023-01-02"
"49129","2022","COM","2020","4454","59","4513","2023-01-02"
"49130","2022","COM","2020","673","7","680","2023-01-02"
"49131","2022","COM","2020","720","7","727","2023-01-02"
"49132","2022","COM","2020","1548","17","1565","2023-01-02"
"49135","2022","COM","2020","2188","40","2228","2023-01-02"
"49138","2022","COM","2020","2574","52","2626","2023-01-02"
"49140","2022","COM","2020","1515","23","1538","2023-01-02"
"49155","2022","COM","2020","1423","40","1463","2023-01-02"
"49160","2022","COM","2020","2687","60","2747","2023-01-02"
"49161","2022","COM","2020","342","6","348","2023-01-02"
"49163","2022","COM","2020","2766","31","2797","2023-01-02"
"49167","2022","COM","2020","4614","109","4723","2023-01-02"
"49170","2022","COM","2020","814","12","826","2023-01-02"
"49171","2022","COM","2020","122","2","124","2023-01-02"
"49174","2022","COM","2020","1318","22","1340","2023-01-02"
"49176","2022","COM","2020","5201","77","5278","2023-01-02"
"49178","2022","COM","2020","882","21","903","2023-01-02"
"49180","2022","COM","2020","6759","106","6865","2023-01-02"
"49182","2022","COM","2020","893","16","909","2023-01-02"
"49183","2022","COM","2020","4908","79","4987","2023-01-02"
"49188","2022","COM","2020","836","15","851","2023-01-02"
"49192","2022","COM","2020","3204","79","3283","2023-01-02"
"49193","2022","COM","2020","3827","91","3918","2023-01-02"
"49194","2022","COM","2020","5860","92","5952","2023-01-02"
"49195","2022","COM","2020","1265","30","1295","2023-01-02"
"49200","2022","COM","2020","6334","172","6506","2023-01-02"
"49201","2022","COM","2020","2043","39","2082","2023-01-02"
"49205","2022","COM","2020","999","10","1009","2023-01-02"
"49209","2022","COM","2020","446","3","449","2023-01-02"
"49211","2022","COM","2020","1220","20","1240","2023-01-02"
"49214","2022","COM","2020","7791","151","7942","2023-01-02"
"49215","2022","COM","2020","3705","250","3955","2023-01-02"
"49216","2022","COM","2020","581","9","590","2023-01-02"
"49217","2022","COM","2020","770","10","780","2023-01-02"
"49218","2022","COM","2020","15732","306","16038","2023-01-02"
"49219","2022","COM","2020","423","6","429","2023-01-02"
"49220","2022","COM","2020","3669","45","3714","2023-01-02"
"49221","2022","COM","2020","808","23","831","2023-01-02"
"49222","2022","COM","2020","2028","45","2073","2023-01-02"
"49223","2022","COM","2020","5661","99","5760","2023-01-02"
"49224","2022","COM","2020","988","11","999","2023-01-02"
"49228","2022","COM","2020","5529","117","5646","2023-01-02"
"49231","2022","COM","2020","1443","38","1481","2023-01-02"
"49235","2022","COM","2020","408","6","414","2023-01-02"
"49236","2022","COM","2020","127","2","129","2023-01-02"
"49237","2022","COM","2020","129","2","131","2023-01-02"
"49240","2022","COM","2020","1000","31","1031","2023-01-02"
"49241","2022","COM","2020","2594","51","2645","2023-01-02"
"49244","2022","COM","2020","18083","476","18559","2023-01-02"
"49246","2022","COM","2020","12589","534","13123","2023-01-02"
"49247","2022","COM","2020","2448","42","2490","2023-01-02"
"49248","2022","COM","2020","8908","209","9117","2023-01-02"
"49253","2022","COM","2020","1154","23","1177","2023-01-02"
"49257","2022","COM","2020","1033","14","1047","2023-01-02"
"49259","2022","COM","2020","2307","56","2363","2023-01-02"
"49260","2022","COM","2020","1961","83","2044","2023-01-02"
"49261","2022","COM","2020","8480","167","8647","2023-01-02"
"49262","2022","COM","2020","649","24","673","2023-01-02"
"49266","2022","COM","2020","1247","29","1276","2023-01-02"
"49267","2022","COM","2020","9207","226","9433","2023-01-02"
"49269","2022","COM","2020","2873","61","2934","2023-01-02"
"49271","2022","COM","2020","2094","28","2122","2023-01-02"
"49272","2022","COM","2020","1097","15","1112","2023-01-02"
"49278","2022","COM","2020","3515","253","3768","2023-01-02"
"49283","2022","COM","2020","3706","40","3746","2023-01-02"
"49284","2022","COM","2020","1402","20","1422","2023-01-02"
"49288","2022","COM","2020","224","6","230","2023-01-02"
"49291","2022","COM","2020","375","4","379","2023-01-02"
"49292","2022","COM","2020","3455","48","3503","2023-01-02"
"49294","2022","COM","2020","2932","30","2962","2023-01-02"
"49298","2022","COM","2020","3749","65","3814","2023-01-02"
"49299","2022","COM","2020","3062","71","3133","2023-01-02"
"49301","2022","COM","2020","25519","576","26095","2023-01-02"
"49302","2022","COM","2020","449","5","454","2023-01-02"
"49306","2022","COM","2020","1668","36","1704","2023-01-02"
"49307","2022","COM","2020","16293","565","16858","2023-01-02"
"49308","2022","COM","2020","2172","54","2226","2023-01-02"
"49310","2022","COM","2020","601","19","620","2023-01-02"
"49311","2022","COM","2020","1328","27","1355","2023-01-02"
"49321","2022","COM","2020","390","8","398","2023-01-02"
"49323","2022","COM","2020","7534","302","7836","2023-01-02"
"49326","2022","COM","2020","829","19","848","2023-01-02"
"49328","2022","COM","2020","26154","958","27112","2023-01-02"
"49329","2022","COM","2020","1337","50","1387","2023-01-02"
"49330","2022","COM","2020","1174","16","1190","2023-01-02"
"49331","2022","COM","2020","17660","818","18478","2023-01-02"
"49332","2022","COM","2020","4212","116","4328","2023-01-02"
"49333","2022","COM","2020","2879","58","2937","2023-01-02"
"49334","2022","COM","2020","332","5","337","2023-01-02"
"49336","2022","COM","2020","872","17","889","2023-01-02"
"49338","2022","COM","2020","1399","20","1419","2023-01-02"
"49339","2022","COM","2020","1491","39","1530","2023-01-02"
"49341","2022","COM","2020","730","17","747","2023-01-02"
"49343","2022","COM","2020","3195","74","3269","2023-01-02"
"49344","2022","COM","2020","1252","23","1275","2023-01-02"
"49345","2022","COM","2020","5780","117","5897","2023-01-02"
"49347","2022","COM","2020","4470","72","4542","2023-01-02"
"49352","2022","COM","2020","1316","34","1350","2023-01-02"
"49353","2022","COM","2020","15056","185","15241","2023-01-02"
"49355","2022","COM","2020","3085","79","3164","2023-01-02"
"49358","2022","COM","2020","572","14","586","2023-01-02"
"49359","2022","COM","2020","574","16","590","2023-01-02"
"49361","2022","COM","2020","1859","28","1887","2023-01-02"
"49362","2022","COM","2020","1241","29","1270","2023-01-02"
"49364","2022","COM","2020","1122","21","1143","2023-01-02"
"49367","2022","COM","2020","5759","81","5840","2023-01-02"
"49368","2022","COM","2020","1993","39","2032","2023-01-02"
"49369","2022","COM","2020","1278","22","1300","2023-01-02"
"49370","2022","COM","2020","473","9","482","2023-01-02"
"49371","2022","COM","2020","1733","28","1761","2023-01-02"
"49373","2022","COM","2020","7748","169","7917","2023-01-02"
"49374","2022","COM","2020","1438","32","1470","2023-01-02"
"49377","2022","COM","2020","5642","89","5731","2023-01-02"
"49378","2022","COM","2020","2545","35","2580","2023-01-02"
"49381","2022","COM","2020","1821","31","1852","2023-01-02"
"50002","2022","COM","2020","4245","432","4677","2023-01-02"
"50003","2022","COM","2020","2869","64","2933","2023-01-02"
"50004","2022","COM","2020","552","3","555","2023-01-02"
"50006","2022","COM","2020","154","5","159","2023-01-02"
"50008","2022","COM","2020","439","19","458","2023-01-02"
"50013","2022","COM","2020","384","8","392","2023-01-02"
"50015","2022","COM","2020","641","13","654","2023-01-02"
"50016","2022","COM","2020","184","2","186","2023-01-02"
"50019","2022","COM","2020","415","6","421","2023-01-02"
"50021","2022","COM","2020","76","1","77","2023-01-02"
"50022","2022","COM","2020","110","3","113","2023-01-02"
"50023","2022","COM","2020","691","10","701","2023-01-02"
"50024","2022","COM","2020","166","3","169","2023-01-02"
"50025","2022","COM","2020","10277","508","10785","2023-01-02"
"50026","2022","COM","2020","78","1","79","2023-01-02"
"50027","2022","COM","2020","963","29","992","2023-01-02"
"50028","2022","COM","2020","106","3","109","2023-01-02"
"50029","2022","COM","2020","1176","65","1241","2023-01-02"
"50030","2022","COM","2020","553","9","562","2023-01-02"
"50031","2022","COM","2020","2214","54","2268","2023-01-02"
"50032","2022","COM","2020","1034","31","1065","2023-01-02"
"50033","2022","COM","2020","138","4","142","2023-01-02"
"50034","2022","COM","2020","560","19","579","2023-01-02"
"50036","2022","COM","2020","439","11","450","2023-01-02"
"50038","2022","COM","2020","430","11","441","2023-01-02"
"50039","2022","COM","2020","129","3","132","2023-01-02"
"50040","2022","COM","2020","119","6","125","2023-01-02"
"50041","2022","COM","2020","11257","319","11576","2023-01-02"
"50042","2022","COM","2020","442","6","448","2023-01-02"
"50044","2022","COM","2020","325","8","333","2023-01-02"
"50045","2022","COM","2020","610","22","632","2023-01-02"
"50046","2022","COM","2020","432","9","441","2023-01-02"
"50048","2022","COM","2020","555","9","564","2023-01-02"
"50049","2022","COM","2020","658","19","677","2023-01-02"
"50050","2022","COM","2020","135","5","140","2023-01-02"
"50052","2022","COM","2020","145","2","147","2023-01-02"
"50054","2022","COM","2020","191","4","195","2023-01-02"
"50055","2022","COM","2020","113","2","115","2023-01-02"
"50058","2022","COM","2020","1604","45","1649","2023-01-02"
"50059","2022","COM","2020","326","1","327","2023-01-02"
"50060","2022","COM","2020","445","8","453","2023-01-02"
"50062","2022","COM","2020","110","2","112","2023-01-02"
"50064","2022","COM","2020","180","6","186","2023-01-02"
"50066","2022","COM","2020","2396","79","2475","2023-01-02"
"50069","2022","COM","2020","345","11","356","2023-01-02"
"50070","2022","COM","2020","69","1","70","2023-01-02"
"50072","2022","COM","2020","210","6","216","2023-01-02"
"50074","2022","COM","2020","2168","145","2313","2023-01-02"
"50076","2022","COM","2020","3463","79","3542","2023-01-02"
"50077","2022","COM","2020","1027","43","1070","2023-01-02"
"50078","2022","COM","2020","421","7","428","2023-01-02"
"50079","2022","COM","2020","402","9","411","2023-01-02"
"50081","2022","COM","2020","779","29","808","2023-01-02"
"50082","2022","COM","2020","5847","89","5936","2023-01-02"
"50083","2022","COM","2020","638","7","645","2023-01-02"
"50084","2022","COM","2020","538","19","557","2023-01-02"
"50085","2022","COM","2020","1241","43","1284","2023-01-02"
"50086","2022","COM","2020","323","8","331","2023-01-02"
"50087","2022","COM","2020","2152","46","2198","2023-01-02"
"50088","2022","COM","2020","136","2","138","2023-01-02"
"50090","2022","COM","2020","610","10","620","2023-01-02"
"50092","2022","COM","2020","703","16","719","2023-01-02"
"50093","2022","COM","2020","425","9","434","2023-01-02"
"50094","2022","COM","2020","411","9","420","2023-01-02"
"50095","2022","COM","2020","1748","55","1803","2023-01-02"
"50096","2022","COM","2020","209","8","217","2023-01-02"
"50097","2022","COM","2020","121","2","123","2023-01-02"
"50098","2022","COM","2020","619","14","633","2023-01-02"
"50099","2022","COM","2020","10227","162","10389","2023-01-02"
"50101","2022","COM","2020","232","6","238","2023-01-02"
"50102","2022","COM","2020","748","16","764","2023-01-02"
"50105","2022","COM","2020","96","5","101","2023-01-02"
"50106","2022","COM","2020","268","5","273","2023-01-02"
"50108","2022","COM","2020","415","12","427","2023-01-02"
"50109","2022","COM","2020","1771","38","1809","2023-01-02"
"50110","2022","COM","2020","1035","19","1054","2023-01-02"
"50111","2022","COM","2020","1009","16","1025","2023-01-02"
"50112","2022","COM","2020","460","6","466","2023-01-02"
"50115","2022","COM","2020","384","11","395","2023-01-02"
"50117","2022","COM","2020","347","10","357","2023-01-02"
"50118","2022","COM","2020","324","4","328","2023-01-02"
"50120","2022","COM","2020","365","4","369","2023-01-02"
"50121","2022","COM","2020","241","4","245","2023-01-02"
"50124","2022","COM","2020","169","2","171","2023-01-02"
"50126","2022","COM","2020","135","6","141","2023-01-02"
"50129","2022","COM","2020","77789","2293","80082","2023-01-02"
"50130","2022","COM","2020","432","5","437","2023-01-02"
"50135","2022","COM","2020","226","3","229","2023-01-02"
"50137","2022","COM","2020","628","15","643","2023-01-02"
"50138","2022","COM","2020","554","9","563","2023-01-02"
"50139","2022","COM","2020","4076","151","4227","2023-01-02"
"50142","2022","COM","2020","1064","13","1077","2023-01-02"
"50143","2022","COM","2020","868","33","901","2023-01-02"
"50144","2022","COM","2020","530","4","534","2023-01-02"
"50145","2022","COM","2020","591","13","604","2023-01-02"
"50146","2022","COM","2020","237","2","239","2023-01-02"
"50147","2022","COM","2020","8380","1174","9554","2023-01-02"
"50148","2022","COM","2020","559","4","563","2023-01-02"
"50149","2022","COM","2020","1186","18","1204","2023-01-02"
"50150","2022","COM","2020","226","2","228","2023-01-02"
"50151","2022","COM","2020","2078","30","2108","2023-01-02"
"50152","2022","COM","2020","227","3","230","2023-01-02"
"50155","2022","COM","2020","296","13","309","2023-01-02"
"50156","2022","COM","2020","65","0","65","2023-01-02"
"50158","2022","COM","2020","277","8","285","2023-01-02"
"50159","2022","COM","2020","684","14","698","2023-01-02"
"50161","2022","COM","2020","601","3","604","2023-01-02"
"50162","2022","COM","2020","1623","43","1666","2023-01-02"
"50164","2022","COM","2020","1001","26","1027","2023-01-02"
"50165","2022","COM","2020","3081","73","3154","2023-01-02"
"50166","2022","COM","2020","326","15","341","2023-01-02"
"50167","2022","COM","2020","795","21","816","2023-01-02"
"50168","2022","COM","2020","2827","59","2886","2023-01-02"
"50169","2022","COM","2020","106","2","108","2023-01-02"
"50172","2022","COM","2020","349","8","357","2023-01-02"
"50174","2022","COM","2020","195","8","203","2023-01-02"
"50175","2022","COM","2020","190","8","198","2023-01-02"
"50176","2022","COM","2020","353","14","367","2023-01-02"
"50177","2022","COM","2020","376","5","381","2023-01-02"
"50178","2022","COM","2020","1272","33","1305","2023-01-02"
"50181","2022","COM","2020","338","13","351","2023-01-02"
"50182","2022","COM","2020","296","6","302","2023-01-02"
"50183","2022","COM","2020","350","6","356","2023-01-02"
"50184","2022","COM","2020","1767","22","1789","2023-01-02"
"50185","2022","COM","2020","1054","24","1078","2023-01-02"
"50186","2022","COM","2020","219","8","227","2023-01-02"
"50188","2022","COM","2020","1094","27","1121","2023-01-02"
"50190","2022","COM","2020","168","3","171","2023-01-02"
"50192","2022","COM","2020","130","0","130","2023-01-02"
"50193","2022","COM","2020","219","3","222","2023-01-02"
"50194","2022","COM","2020","372","6","378","2023-01-02"
"50195","2022","COM","2020","261","2","263","2023-01-02"
"50196","2022","COM","2020","483","9","492","2023-01-02"
"50197","2022","COM","2020","1980","26","2006","2023-01-02"
"50198","2022","COM","2020","486","11","497","2023-01-02"
"50199","2022","COM","2020","453","4","457","2023-01-02"
"50200","2022","COM","2020","806","12","818","2023-01-02"
"50205","2022","COM","2020","285","6","291","2023-01-02"
"50207","2022","COM","2020","172","5","177","2023-01-02"
"50208","2022","COM","2020","160","1","161","2023-01-02"
"50209","2022","COM","2020","1515","43","1558","2023-01-02"
"50210","2022","COM","2020","341","8","349","2023-01-02"
"50214","2022","COM","2020","281","6","287","2023-01-02"
"50215","2022","COM","2020","3241","70","3311","2023-01-02"
"50216","2022","COM","2020","801","94","895","2023-01-02"
"50217","2022","COM","2020","604","11","615","2023-01-02"
"50218","2022","COM","2020","12558","672","13230","2023-01-02"
"50219","2022","COM","2020","666","12","678","2023-01-02"
"50221","2022","COM","2020","63","0","63","2023-01-02"
"50222","2022","COM","2020","790","21","811","2023-01-02"
"50225","2022","COM","2020","146","1","147","2023-01-02"
"50227","2022","COM","2020","312","6","318","2023-01-02"
"50228","2022","COM","2020","1082","31","1113","2023-01-02"
"50229","2022","COM","2020","94","0","94","2023-01-02"
"50230","2022","COM","2020","897","29","926","2023-01-02"
"50231","2022","COM","2020","693","19","712","2023-01-02"
"50232","2022","COM","2020","477","17","494","2023-01-02"
"50233","2022","COM","2020","157","5","162","2023-01-02"
"50234","2022","COM","2020","75","0","75","2023-01-02"
"50235","2022","COM","2020","272","5","277","2023-01-02"
"50236","2022","COM","2020","3958","120","4078","2023-01-02"
"50237","2022","COM","2020","1266","23","1289","2023-01-02"
"50238","2022","COM","2020","457","6","463","2023-01-02"
"50239","2022","COM","2020","1793","45","1838","2023-01-02"
"50240","2022","COM","2020","558","8","566","2023-01-02"
"50241","2022","COM","2020","182","4","186","2023-01-02"
"50243","2022","COM","2020","473","15","488","2023-01-02"
"50246","2022","COM","2020","71","1","72","2023-01-02"
"50247","2022","COM","2020","190","5","195","2023-01-02"
"50251","2022","COM","2020","363","10","373","2023-01-02"
"50252","2022","COM","2020","914","19","933","2023-01-02"
"50253","2022","COM","2020","169","7","176","2023-01-02"
"50256","2022","COM","2020","3170","97","3267","2023-01-02"
"50258","2022","COM","2020","103","1","104","2023-01-02"
"50259","2022","COM","2020","640","25","665","2023-01-02"
"50260","2022","COM","2020","1683","39","1722","2023-01-02"
"50261","2022","COM","2020","167","2","169","2023-01-02"
"50262","2022","COM","2020","532","6","538","2023-01-02"
"50263","2022","COM","2020","370","10","380","2023-01-02"
"50265","2022","COM","2020","193","1","194","2023-01-02"
"50266","2022","COM","2020","430","3","433","2023-01-02"
"50267","2022","COM","2020","2240","54","2294","2023-01-02"
"50268","2022","COM","2020","248","2","250","2023-01-02"
"50269","2022","COM","2020","207","6","213","2023-01-02"
"50270","2022","COM","2020","401","12","413","2023-01-02"
"50271","2022","COM","2020","87","1","88","2023-01-02"
"50272","2022","COM","2020","1023","19","1042","2023-01-02"
"50273","2022","COM","2020","1413","20","1433","2023-01-02"
"50274","2022","COM","2020","1016","153","1169","2023-01-02"
"50275","2022","COM","2020","122","6","128","2023-01-02"
"50276","2022","COM","2020","593","21","614","2023-01-02"
"50277","2022","COM","2020","587","15","602","2023-01-02"
"50278","2022","COM","2020","276","6","282","2023-01-02"
"50279","2022","COM","2020","599","15","614","2023-01-02"
"50281","2022","COM","2020","781","19","800","2023-01-02"
"50282","2022","COM","2020","306","9","315","2023-01-02"
"50283","2022","COM","2020","76","1","77","2023-01-02"
"50285","2022","COM","2020","312","4","316","2023-01-02"
"50288","2022","COM","2020","1302","23","1325","2023-01-02"
"50289","2022","COM","2020","723","12","735","2023-01-02"
"50290","2022","COM","2020","334","8","342","2023-01-02"
"50291","2022","COM","2020","116","4","120","2023-01-02"
"50292","2022","COM","2020","2723","58","2781","2023-01-02"
"50294","2022","COM","2020","1325","38","1363","2023-01-02"
"50295","2022","COM","2020","145","2","147","2023-01-02"
"50296","2022","COM","2020","221","9","230","2023-01-02"
"50297","2022","COM","2020","1009","30","1039","2023-01-02"
"50298","2022","COM","2020","644","14","658","2023-01-02"
"50299","2022","COM","2020","220","7","227","2023-01-02"
"50300","2022","COM","2020","162","7","169","2023-01-02"
"50302","2022","COM","2020","286","7","293","2023-01-02"
"50304","2022","COM","2020","195","4","199","2023-01-02"
"50305","2022","COM","2020","727","16","743","2023-01-02"
"50310","2022","COM","2020","165","4","169","2023-01-02"
"50311","2022","COM","2020","225","8","233","2023-01-02"
"50312","2022","COM","2020","134","4","138","2023-01-02"
"50315","2022","COM","2020","247","7","254","2023-01-02"
"50317","2022","COM","2020","277","3","280","2023-01-02"
"50321","2022","COM","2020","490","12","502","2023-01-02"
"50324","2022","COM","2020","111","2","113","2023-01-02"
"50326","2022","COM","2020","234","1","235","2023-01-02"
"50327","2022","COM","2020","193","6","199","2023-01-02"
"50328","2022","COM","2020","765","13","778","2023-01-02"
"50332","2022","COM","2020","716","15","731","2023-01-02"
"50334","2022","COM","2020","273","3","276","2023-01-02"
"50335","2022","COM","2020","496","9","505","2023-01-02"
"50336","2022","COM","2020","221","3","224","2023-01-02"
"50338","2022","COM","2020","296","4","300","2023-01-02"
"50340","2022","COM","2020","188","4","192","2023-01-02"
"50341","2022","COM","2020","2051","126","2177","2023-01-02"
"50342","2022","COM","2020","799","27","826","2023-01-02"
"50345","2022","COM","2020","696","20","716","2023-01-02"
"50347","2022","COM","2020","239","5","244","2023-01-02"
"50349","2022","COM","2020","1393","35","1428","2023-01-02"
"50350","2022","COM","2020","525","6","531","2023-01-02"
"50351","2022","COM","2020","96","2","98","2023-01-02"
"50352","2022","COM","2020","337","7","344","2023-01-02"
"50353","2022","COM","2020","27","1","28","2023-01-02"
"50356","2022","COM","2020","785","21","806","2023-01-02"
"50357","2022","COM","2020","71","1","72","2023-01-02"
"50359","2022","COM","2020","2932","207","3139","2023-01-02"
"50360","2022","COM","2020","279","12","291","2023-01-02"
"50361","2022","COM","2020","244","5","249","2023-01-02"
"50362","2022","COM","2020","282","5","287","2023-01-02"
"50363","2022","COM","2020","1443","35","1478","2023-01-02"
"50364","2022","COM","2020","715","13","728","2023-01-02"
"50365","2022","COM","2020","500","11","511","2023-01-02"
"50368","2022","COM","2020","67","2","69","2023-01-02"
"50369","2022","COM","2020","824","25","849","2023-01-02"
"50370","2022","COM","2020","608","4","612","2023-01-02"
"50371","2022","COM","2020","404","13","417","2023-01-02"
"50372","2022","COM","2020","178","3","181","2023-01-02"
"50373","2022","COM","2020","87","4","91","2023-01-02"
"50374","2022","COM","2020","26","1","27","2023-01-02"
"50376","2022","COM","2020","378","13","391","2023-01-02"
"50378","2022","COM","2020","630","10","640","2023-01-02"
"50379","2022","COM","2020","161","3","164","2023-01-02"
"50382","2022","COM","2020","633","18","651","2023-01-02"
"50384","2022","COM","2020","225","7","232","2023-01-02"
"50387","2022","COM","2020","354","7","361","2023-01-02"
"50388","2022","COM","2020","1172","33","1205","2023-01-02"
"50389","2022","COM","2020","438","12","450","2023-01-02"
"50390","2022","COM","2020","154","3","157","2023-01-02"
"50391","2022","COM","2020","2635","74","2709","2023-01-02"
"50393","2022","COM","2020","2605","104","2709","2023-01-02"
"50394","2022","COM","2020","2244","30","2274","2023-01-02"
"50395","2022","COM","2020","277","4","281","2023-01-02"
"50397","2022","COM","2020","207","6","213","2023-01-02"
"50398","2022","COM","2020","200","2","202","2023-01-02"
"50399","2022","COM","2020","176","3","179","2023-01-02"
"50400","2022","COM","2020","3251","43","3294","2023-01-02"
"50401","2022","COM","2020","746","15","761","2023-01-02"
"50402","2022","COM","2020","3244","88","3332","2023-01-02"
"50403","2022","COM","2020","1429","37","1466","2023-01-02"
"50405","2022","COM","2020","240","8","248","2023-01-02"
"50407","2022","COM","2020","942","36","978","2023-01-02"
"50408","2022","COM","2020","576","13","589","2023-01-02"
"50409","2022","COM","2020","1915","206","2121","2023-01-02"
"50410","2022","COM","2020","4352","75","4427","2023-01-02"
"50411","2022","COM","2020","680","9","689","2023-01-02"
"50412","2022","COM","2020","2545","63","2608","2023-01-02"
"50413","2022","COM","2020","584","5","589","2023-01-02"
"50417","2022","COM","2020","1773","29","1802","2023-01-02"
"50419","2022","COM","2020","3195","72","3267","2023-01-02"
"50420","2022","COM","2020","854","23","877","2023-01-02"
"50421","2022","COM","2020","265","6","271","2023-01-02"
"50422","2022","COM","2020","193","0","193","2023-01-02"
"50423","2022","COM","2020","210","5","215","2023-01-02"
"50425","2022","COM","2020","1097","26","1123","2023-01-02"
"50426","2022","COM","2020","366","6","372","2023-01-02"
"50428","2022","COM","2020","512","6","518","2023-01-02"
"50429","2022","COM","2020","739","32","771","2023-01-02"
"50430","2022","COM","2020","41","3","44","2023-01-02"
"50431","2022","COM","2020","1059","12","1071","2023-01-02"
"50433","2022","COM","2020","1014","23","1037","2023-01-02"
"50435","2022","COM","2020","596","16","612","2023-01-02"
"50436","2022","COM","2020","1270","43","1313","2023-01-02"
"50437","2022","COM","2020","791","12","803","2023-01-02"
"50442","2022","COM","2020","249","5","254","2023-01-02"
"50443","2022","COM","2020","516","11","527","2023-01-02"
"50444","2022","COM","2020","2514","58","2572","2023-01-02"
"50445","2022","COM","2020","361","13","374","2023-01-02"
"50446","2022","COM","2020","548","13","561","2023-01-02"
"50447","2022","COM","2020","462","14","476","2023-01-02"
"50448","2022","COM","2020","650","17","667","2023-01-02"
"50450","2022","COM","2020","332","8","340","2023-01-02"
"50451","2022","COM","2020","129","1","130","2023-01-02"
"50452","2022","COM","2020","664","22","686","2023-01-02"
"50453","2022","COM","2020","788","18","806","2023-01-02"
"50454","2022","COM","2020","420","9","429","2023-01-02"
"50455","2022","COM","2020","968","20","988","2023-01-02"
"50456","2022","COM","2020","547","11","558","2023-01-02"
"50457","2022","COM","2020","189","6","195","2023-01-02"
"50461","2022","COM","2020","206","9","215","2023-01-02"
"50462","2022","COM","2020","354","8","362","2023-01-02"
"50463","2022","COM","2020","526","11","537","2023-01-02"
"50464","2022","COM","2020","636","5","641","2023-01-02"
"50467","2022","COM","2020","496","13","509","2023-01-02"
"50468","2022","COM","2020","762","17","779","2023-01-02"
"50469","2022","COM","2020","308","7","315","2023-01-02"
"50471","2022","COM","2020","273","5","278","2023-01-02"
"50472","2022","COM","2020","207","8","215","2023-01-02"
"50473","2022","COM","2020","385","7","392","2023-01-02"
"50474","2022","COM","2020","544","12","556","2023-01-02"
"50475","2022","COM","2020","964","20","984","2023-01-02"
"50476","2022","COM","2020","220","7","227","2023-01-02"
"50478","2022","COM","2020","419","6","425","2023-01-02"
"50479","2022","COM","2020","109","3","112","2023-01-02"
"50480","2022","COM","2020","770","15","785","2023-01-02"
"50481","2022","COM","2020","904","18","922","2023-01-02"
"50482","2022","COM","2020","161","3","164","2023-01-02"
"50483","2022","COM","2020","978","29","1007","2023-01-02"
"50484","2022","COM","2020","5769","308","6077","2023-01-02"
"50486","2022","COM","2020","625","9","634","2023-01-02"
"50487","2022","COM","2020","4896","103","4999","2023-01-02"
"50488","2022","COM","2020","636","8","644","2023-01-02"
"50489","2022","COM","2020","544","13","557","2023-01-02"
"50490","2022","COM","2020","358","13","371","2023-01-02"
"50491","2022","COM","2020","439","11","450","2023-01-02"
"50492","2022","COM","2020","2527","56","2583","2023-01-02"
"50493","2022","COM","2020","1471","46","1517","2023-01-02"
"50495","2022","COM","2020","75","5","80","2023-01-02"
"50496","2022","COM","2020","386","9","395","2023-01-02"
"50498","2022","COM","2020","801","24","825","2023-01-02"
"50499","2022","COM","2020","487","14","501","2023-01-02"
"50500","2022","COM","2020","653","12","665","2023-01-02"
"50502","2022","COM","2020","19206","906","20112","2023-01-02"
"50504","2022","COM","2020","207","5","212","2023-01-02"
"50505","2022","COM","2020","677","34","711","2023-01-02"
"50506","2022","COM","2020","476","11","487","2023-01-02"
"50507","2022","COM","2020","345","6","351","2023-01-02"
"50509","2022","COM","2020","707","17","724","2023-01-02"
"50510","2022","COM","2020","606","4","610","2023-01-02"
"50511","2022","COM","2020","136","0","136","2023-01-02"
"50512","2022","COM","2020","534","9","543","2023-01-02"
"50513","2022","COM","2020","186","2","188","2023-01-02"
"50514","2022","COM","2020","312","1","313","2023-01-02"
"50517","2022","COM","2020","170","5","175","2023-01-02"
"50518","2022","COM","2020","333","3","336","2023-01-02"
"50519","2022","COM","2020","587","8","595","2023-01-02"
"50521","2022","COM","2020","154","4","158","2023-01-02"
"50522","2022","COM","2020","251","7","258","2023-01-02"
"50523","2022","COM","2020","3021","46","3067","2023-01-02"
"50525","2022","COM","2020","334","2","336","2023-01-02"
"50528","2022","COM","2020","304","12","316","2023-01-02"
"50529","2022","COM","2020","79","2","81","2023-01-02"
"50531","2022","COM","2020","767","31","798","2023-01-02"
"50532","2022","COM","2020","4103","150","4253","2023-01-02"
"50533","2022","COM","2020","179","3","182","2023-01-02"
"50535","2022","COM","2020","917","22","939","2023-01-02"
"50536","2022","COM","2020","161","0","161","2023-01-02"
"50537","2022","COM","2020","413","19","432","2023-01-02"
"50538","2022","COM","2020","447","12","459","2023-01-02"
"50539","2022","COM","2020","1824","25","1849","2023-01-02"
"50540","2022","COM","2020","630","17","647","2023-01-02"
"50541","2022","COM","2020","1423","48","1471","2023-01-02"
"50542","2022","COM","2020","480","8","488","2023-01-02"
"50543","2022","COM","2020","1357","31","1388","2023-01-02"
"50546","2022","COM","2020","3304","69","3373","2023-01-02"
"50548","2022","COM","2020","118","3","121","2023-01-02"
"50549","2022","COM","2020","408","6","414","2023-01-02"
"50550","2022","COM","2020","3474","135","3609","2023-01-02"
"50551","2022","COM","2020","2076","39","2115","2023-01-02"
"50552","2022","COM","2020","329","6","335","2023-01-02"
"50553","2022","COM","2020","336","3","339","2023-01-02"
"50554","2022","COM","2020","1436","31","1467","2023-01-02"
"50556","2022","COM","2020","699","10","709","2023-01-02"
"50562","2022","COM","2020","1700","28","1728","2023-01-02"
"50563","2022","COM","2020","280","8","288","2023-01-02"
"50564","2022","COM","2020","1321","29","1350","2023-01-02"
"50565","2022","COM","2020","2835","56","2891","2023-01-02"
"50567","2022","COM","2020","882","25","907","2023-01-02"
"50568","2022","COM","2020","459","15","474","2023-01-02"
"50569","2022","COM","2020","445","13","458","2023-01-02"
"50570","2022","COM","2020","413","8","421","2023-01-02"
"50571","2022","COM","2020","34","1","35","2023-01-02"
"50572","2022","COM","2020","189","3","192","2023-01-02"
"50574","2022","COM","2020","268","12","280","2023-01-02"
"50575","2022","COM","2020","807","14","821","2023-01-02"
"50576","2022","COM","2020","947","31","978","2023-01-02"
"50577","2022","COM","2020","311","8","319","2023-01-02"
"50578","2022","COM","2020","79","1","80","2023-01-02"
"50579","2022","COM","2020","1433","29","1462","2023-01-02"
"50580","2022","COM","2020","471","16","487","2023-01-02"
"50582","2022","COM","2020","3113","62","3175","2023-01-02"
"50584","2022","COM","2020","397","8","405","2023-01-02"
"50585","2022","COM","2020","1159","26","1185","2023-01-02"
"50587","2022","COM","2020","16","1","17","2023-01-02"
"50588","2022","COM","2020","688","18","706","2023-01-02"
"50589","2022","COM","2020","283","12","295","2023-01-02"
"50590","2022","COM","2020","410","6","416","2023-01-02"
"50591","2022","COM","2020","1663","27","1690","2023-01-02"
"50592","2022","COM","2020","2237","45","2282","2023-01-02"
"50593","2022","COM","2020","590","10","600","2023-01-02"
"50594","2022","COM","2020","1032","23","1055","2023-01-02"
"50596","2022","COM","2020","329","10","339","2023-01-02"
"50597","2022","COM","2020","953","13","966","2023-01-02"
"50598","2022","COM","2020","266","3","269","2023-01-02"
"50599","2022","COM","2020","1596","36","1632","2023-01-02"
"50601","2022","COM","2020","4434","57","4491","2023-01-02"
"50603","2022","COM","2020","772","23","795","2023-01-02"
"50604","2022","COM","2020","746","19","765","2023-01-02"
"50606","2022","COM","2020","515","7","522","2023-01-02"
"50607","2022","COM","2020","396","6","402","2023-01-02"
"50609","2022","COM","2020","122","3","125","2023-01-02"
"50610","2022","COM","2020","208","5","213","2023-01-02"
"50612","2022","COM","2020","747","84","831","2023-01-02"
"50613","2022","COM","2020","395","9","404","2023-01-02"
"50615","2022","COM","2020","6802","262","7064","2023-01-02"
"50616","2022","COM","2020","1935","65","2000","2023-01-02"
"50617","2022","COM","2020","334","2","336","2023-01-02"
"50618","2022","COM","2020","233","11","244","2023-01-02"
"50619","2022","COM","2020","328","10","338","2023-01-02"
"50621","2022","COM","2020","71","0","71","2023-01-02"
"50624","2022","COM","2020","474","24","498","2023-01-02"
"50626","2022","COM","2020","379","8","387","2023-01-02"
"50628","2022","COM","2020","155","4","159","2023-01-02"
"50629","2022","COM","2020","741","6","747","2023-01-02"
"50633","2022","COM","2020","118","3","121","2023-01-02"
"50634","2022","COM","2020","88","1","89","2023-01-02"
"50637","2022","COM","2020","320","3","323","2023-01-02"
"50639","2022","COM","2020","3849","64","3913","2023-01-02"
"50641","2022","COM","2020","652","20","672","2023-01-02"
"50643","2022","COM","2020","777","24","801","2023-01-02"
"50647","2022","COM","2020","1151","44","1195","2023-01-02"
"50648","2022","COM","2020","1182","30","1212","2023-01-02"
"51001","2022","COM","2020","165","4","169","2023-01-02"
"51002","2022","COM","2020","1387","23","1410","2023-01-02"
"51003","2022","COM","2020","280","5","285","2023-01-02"
"51004","2022","COM","2020","117","4","121","2023-01-02"
"51005","2022","COM","2020","175","3","178","2023-01-02"
"51006","2022","COM","2020","148","4","152","2023-01-02"
"51007","2022","COM","2020","965","25","990","2023-01-02"
"51008","2022","COM","2020","214","6","220","2023-01-02"
"51009","2022","COM","2020","812","10","822","2023-01-02"
"51010","2022","COM","2020","141","4","145","2023-01-02"
"51012","2022","COM","2020","72","0","72","2023-01-02"
"51013","2022","COM","2020","98","5","103","2023-01-02"
"51014","2022","COM","2020","291","8","299","2023-01-02"
"51015","2022","COM","2020","110","1","111","2023-01-02"
"51016","2022","COM","2020","239","4","243","2023-01-02"
"51017","2022","COM","2020","326","6","332","2023-01-02"
"51018","2022","COM","2020","896","11","907","2023-01-02"
"51019","2022","COM","2020","253","7","260","2023-01-02"
"51020","2022","COM","2020","53","3","56","2023-01-02"
"51022","2022","COM","2020","192","5","197","2023-01-02"
"51023","2022","COM","2020","269","5","274","2023-01-02"
"51025","2022","COM","2020","1093","10","1103","2023-01-02"
"51027","2022","COM","2020","300","31","331","2023-01-02"
"51028","2022","COM","2020","1008","18","1026","2023-01-02"
"51029","2022","COM","2020","1752","159","1911","2023-01-02"
"51030","2022","COM","2020","5250","88","5338","2023-01-02"
"51031","2022","COM","2020","275","12","287","2023-01-02"
"51032","2022","COM","2020","416","5","421","2023-01-02"
"51033","2022","COM","2020","249","3","252","2023-01-02"
"51034","2022","COM","2020","21","0","21","2023-01-02"
"51035","2022","COM","2020","247","3","250","2023-01-02"
"51036","2022","COM","2020","498","11","509","2023-01-02"
"51037","2022","COM","2020","347","3","350","2023-01-02"
"51038","2022","COM","2020","180","1","181","2023-01-02"
"51039","2022","COM","2020","92","4","96","2023-01-02"
"51040","2022","COM","2020","247","3","250","2023-01-02"
"51041","2022","COM","2020","100","4","104","2023-01-02"
"51042","2022","COM","2020","386","7","393","2023-01-02"
"51043","2022","COM","2020","2384","27","2411","2023-01-02"
"51044","2022","COM","2020","782","16","798","2023-01-02"
"51045","2022","COM","2020","102","0","102","2023-01-02"
"51046","2022","COM","2020","992","18","1010","2023-01-02"
"51047","2022","COM","2020","44","3","47","2023-01-02"
"51048","2022","COM","2020","168","0","168","2023-01-02"
"51049","2022","COM","2020","579","4","583","2023-01-02"
"51050","2022","COM","2020","138","2","140","2023-01-02"
"51051","2022","COM","2020","243","3","246","2023-01-02"
"51052","2022","COM","2020","599","4","603","2023-01-02"
"51053","2022","COM","2020","74","1","75","2023-01-02"
"51054","2022","COM","2020","1290","14","1304","2023-01-02"
"51055","2022","COM","2020","7148","109","7257","2023-01-02"
"51056","2022","COM","2020","242","3","245","2023-01-02"
"51057","2022","COM","2020","76","0","76","2023-01-02"
"51058","2022","COM","2020","3513","78","3591","2023-01-02"
"51059","2022","COM","2020","370","6","376","2023-01-02"
"51060","2022","COM","2020","162","3","165","2023-01-02"
"51061","2022","COM","2020","118","2","120","2023-01-02"
"51062","2022","COM","2020","94","3","97","2023-01-02"
"51063","2022","COM","2020","166","2","168","2023-01-02"
"51065","2022","COM","2020","623","13","636","2023-01-02"
"51066","2022","COM","2020","324","3","327","2023-01-02"
"51068","2022","COM","2020","199","2","201","2023-01-02"
"51069","2022","COM","2020","117","1","118","2023-01-02"
"51070","2022","COM","2020","230","0","230","2023-01-02"
"51071","2022","COM","2020","199","4","203","2023-01-02"
"51072","2022","COM","2020","225","2","227","2023-01-02"
"51073","2022","COM","2020","223","4","227","2023-01-02"
"51074","2022","COM","2020","1780","32","1812","2023-01-02"
"51075","2022","COM","2020","1432","33","1465","2023-01-02"
"51076","2022","COM","2020","435","9","444","2023-01-02"
"51077","2022","COM","2020","176","3","179","2023-01-02"
"51078","2022","COM","2020","562","8","570","2023-01-02"
"51079","2022","COM","2020","853","24","877","2023-01-02"
"51080","2022","COM","2020","192","1","193","2023-01-02"
"51081","2022","COM","2020","330","5","335","2023-01-02"
"51082","2022","COM","2020","93","2","95","2023-01-02"
"51083","2022","COM","2020","79","3","82","2023-01-02"
"51084","2022","COM","2020","80","1","81","2023-01-02"
"51085","2022","COM","2020","377","3","380","2023-01-02"
"51086","2022","COM","2020","331","12","343","2023-01-02"
"51087","2022","COM","2020","215","8","223","2023-01-02"
"51088","2022","COM","2020","453","8","461","2023-01-02"
"51089","2022","COM","2020","68","3","71","2023-01-02"
"51090","2022","COM","2020","312","12","324","2023-01-02"
"51091","2022","COM","2020","137","7","144","2023-01-02"
"51092","2022","COM","2020","351","9","360","2023-01-02"
"51093","2022","COM","2020","442","11","453","2023-01-02"
"51094","2022","COM","2020","180","4","184","2023-01-02"
"51095","2022","COM","2020","91","0","91","2023-01-02"
"51097","2022","COM","2020","177","4","181","2023-01-02"
"51098","2022","COM","2020","136","5","141","2023-01-02"
"51099","2022","COM","2020","320","9","329","2023-01-02"
"51100","2022","COM","2020","108","2","110","2023-01-02"
"51101","2022","COM","2020","692","9","701","2023-01-02"
"51102","2022","COM","2020","477","10","487","2023-01-02"
"51103","2022","COM","2020","139","3","142","2023-01-02"
"51104","2022","COM","2020","136","4","140","2023-01-02"
"51105","2022","COM","2020","1449","25","1474","2023-01-02"
"51106","2022","COM","2020","127","5","132","2023-01-02"
"51107","2022","COM","2020","341","2","343","2023-01-02"
"51108","2022","COM","2020","44336","1145","45481","2023-01-02"
"51109","2022","COM","2020","190","2","192","2023-01-02"
"51110","2022","COM","2020","57","0","57","2023-01-02"
"51111","2022","COM","2020","149","7","156","2023-01-02"
"51112","2022","COM","2020","438","6","444","2023-01-02"
"51113","2022","COM","2020","122","2","124","2023-01-02"
"51115","2022","COM","2020","583","3","586","2023-01-02"
"51116","2022","COM","2020","282","4","286","2023-01-02"
"51117","2022","COM","2020","322","8","330","2023-01-02"
"51118","2022","COM","2020","1585","27","1612","2023-01-02"
"51119","2022","COM","2020","510","7","517","2023-01-02"
"51120","2022","COM","2020","152","0","152","2023-01-02"
"51121","2022","COM","2020","251","3","254","2023-01-02"
"51122","2022","COM","2020","117","4","121","2023-01-02"
"51124","2022","COM","2020","49","3","52","2023-01-02"
"51125","2022","COM","2020","53","1","54","2023-01-02"
"51126","2022","COM","2020","46","3","49","2023-01-02"
"51127","2022","COM","2020","86","0","86","2023-01-02"
"51128","2022","COM","2020","54","2","56","2023-01-02"
"51129","2022","COM","2020","254","9","263","2023-01-02"
"51130","2022","COM","2020","236","5","241","2023-01-02"
"51132","2022","COM","2020","116","0","116","2023-01-02"
"51133","2022","COM","2020","63","0","63","2023-01-02"
"51134","2022","COM","2020","244","8","252","2023-01-02"
"51135","2022","COM","2020","76","0","76","2023-01-02"
"51136","2022","COM","2020","629","16","645","2023-01-02"
"51137","2022","COM","2020","218","4","222","2023-01-02"
"51138","2022","COM","2020","35","1","36","2023-01-02"
"51139","2022","COM","2020","313","13","326","2023-01-02"
"51140","2022","COM","2020","376","8","384","2023-01-02"
"51141","2022","COM","2020","776","15","791","2023-01-02"
"51142","2022","COM","2020","330","10","340","2023-01-02"
"51143","2022","COM","2020","59","0","59","2023-01-02"
"51144","2022","COM","2020","601","11","612","2023-01-02"
"51145","2022","COM","2020","224","5","229","2023-01-02"
"51146","2022","COM","2020","110","3","113","2023-01-02"
"51147","2022","COM","2020","327","12","339","2023-01-02"
"51148","2022","COM","2020","147","2","149","2023-01-02"
"51149","2022","COM","2020","446","14","460","2023-01-02"
"51150","2022","COM","2020","83","1","84","2023-01-02"
"51151","2022","COM","2020","173","3","176","2023-01-02"
"51152","2022","COM","2020","535","10","545","2023-01-02"
"51153","2022","COM","2020","1035","22","1057","2023-01-02"
"51154","2022","COM","2020","217","3","220","2023-01-02"
"51155","2022","COM","2020","614","9","623","2023-01-02"
"51156","2022","COM","2020","122","1","123","2023-01-02"
"51157","2022","COM","2020","78","0","78","2023-01-02"
"51158","2022","COM","2020","570","10","580","2023-01-02"
"51160","2022","COM","2020","1353","47","1400","2023-01-02"
"51161","2022","COM","2020","755","14","769","2023-01-02"
"51162","2022","COM","2020","638","8","646","2023-01-02"
"51163","2022","COM","2020","264","4","268","2023-01-02"
"51164","2022","COM","2020","145","3","148","2023-01-02"
"51165","2022","COM","2020","1023","30","1053","2023-01-02"
"51166","2022","COM","2020","67","2","69","2023-01-02"
"51167","2022","COM","2020","150","3","153","2023-01-02"
"51168","2022","COM","2020","220","6","226","2023-01-02"
"51169","2022","COM","2020","97","5","102","2023-01-02"
"51170","2022","COM","2020","110","2","112","2023-01-02"
"51171","2022","COM","2020","1503","26","1529","2023-01-02"
"51172","2022","COM","2020","6459","78","6537","2023-01-02"
"51173","2022","COM","2020","128","1","129","2023-01-02"
"51174","2022","COM","2020","62","0","62","2023-01-02"
"51175","2022","COM","2020","213","7","220","2023-01-02"
"51176","2022","COM","2020","145","7","152","2023-01-02"
"51177","2022","COM","2020","206","3","209","2023-01-02"
"51178","2022","COM","2020","81","2","83","2023-01-02"
"51179","2022","COM","2020","165","0","165","2023-01-02"
"51181","2022","COM","2020","403","11","414","2023-01-02"
"51182","2022","COM","2020","91","2","93","2023-01-02"
"51183","2022","COM","2020","1243","17","1260","2023-01-02"
"51184","2022","COM","2020","388","13","401","2023-01-02"
"51185","2022","COM","2020","285","1","286","2023-01-02"
"51186","2022","COM","2020","48","0","48","2023-01-02"
"51187","2022","COM","2020","289","7","296","2023-01-02"
"51188","2022","COM","2020","213","8","221","2023-01-02"
"51190","2022","COM","2020","71","0","71","2023-01-02"
"51191","2022","COM","2020","61","3","64","2023-01-02"
"51192","2022","COM","2020","346","5","351","2023-01-02"
"51193","2022","COM","2020","2361","92","2453","2023-01-02"
"51194","2022","COM","2020","466","7","473","2023-01-02"
"51195","2022","COM","2020","815","22","837","2023-01-02"
"51196","2022","COM","2020","879","12","891","2023-01-02"
"51197","2022","COM","2020","81","2","83","2023-01-02"
"51198","2022","COM","2020","671","5","676","2023-01-02"
"51199","2022","COM","2020","409","6","415","2023-01-02"
"51200","2022","COM","2020","370","12","382","2023-01-02"
"51201","2022","COM","2020","124","4","128","2023-01-02"
"51202","2022","COM","2020","750","12","762","2023-01-02"
"51203","2022","COM","2020","225","2","227","2023-01-02"
"51204","2022","COM","2020","1346","26","1372","2023-01-02"
"51205","2022","COM","2020","272","4","276","2023-01-02"
"51206","2022","COM","2020","114","2","116","2023-01-02"
"51208","2022","COM","2020","116","2","118","2023-01-02"
"51210","2022","COM","2020","1492","25","1517","2023-01-02"
"51211","2022","COM","2020","68","0","68","2023-01-02"
"51212","2022","COM","2020","158","1","159","2023-01-02"
"51213","2022","COM","2020","55","3","58","2023-01-02"
"51214","2022","COM","2020","137","8","145","2023-01-02"
"51215","2022","COM","2020","123","3","126","2023-01-02"
"51216","2022","COM","2020","258","4","262","2023-01-02"
"51217","2022","COM","2020","2916","44","2960","2023-01-02"
"51218","2022","COM","2020","130","1","131","2023-01-02"
"51219","2022","COM","2020","214","4","218","2023-01-02"
"51220","2022","COM","2020","141","6","147","2023-01-02"
"51222","2022","COM","2020","95","3","98","2023-01-02"
"51223","2022","COM","2020","58","1","59","2023-01-02"
"51224","2022","COM","2020","169","5","174","2023-01-02"
"51225","2022","COM","2020","320","5","325","2023-01-02"
"51226","2022","COM","2020","58","1","59","2023-01-02"
"51227","2022","COM","2020","481","21","502","2023-01-02"
"51228","2022","COM","2020","83","0","83","2023-01-02"
"51229","2022","COM","2020","120","6","126","2023-01-02"
"51230","2022","COM","2020","22362","474","22836","2023-01-02"
"51231","2022","COM","2020","657","15","672","2023-01-02"
"51232","2022","COM","2020","419","6","425","2023-01-02"
"51233","2022","COM","2020","66","3","69","2023-01-02"
"51234","2022","COM","2020","633","11","644","2023-01-02"
"51235","2022","COM","2020","241","10","251","2023-01-02"
"51236","2022","COM","2020","137","5","142","2023-01-02"
"51237","2022","COM","2020","1817","30","1847","2023-01-02"
"51238","2022","COM","2020","464","3","467","2023-01-02"
"51239","2022","COM","2020","104","1","105","2023-01-02"
"51240","2022","COM","2020","121","3","124","2023-01-02"
"51241","2022","COM","2020","80","1","81","2023-01-02"
"51242","2022","COM","2020","4868","108","4976","2023-01-02"
"51243","2022","COM","2020","305","9","314","2023-01-02"
"51244","2022","COM","2020","240","7","247","2023-01-02"
"51245","2022","COM","2020","578","10","588","2023-01-02"
"51246","2022","COM","2020","222","5","227","2023-01-02"
"51247","2022","COM","2020","144","3","147","2023-01-02"
"51248","2022","COM","2020","2171","41","2212","2023-01-02"
"51249","2022","COM","2020","391","6","397","2023-01-02"
"51250","2022","COM","2020","5721","54","5775","2023-01-02"
"51251","2022","COM","2020","174","5","179","2023-01-02"
"51252","2022","COM","2020","519","6","525","2023-01-02"
"51253","2022","COM","2020","224","5","229","2023-01-02"
"51254","2022","COM","2020","230","2","232","2023-01-02"
"51255","2022","COM","2020","12","0","12","2023-01-02"
"51256","2022","COM","2020","331","8","339","2023-01-02"
"51258","2022","COM","2020","207","13","220","2023-01-02"
"51259","2022","COM","2020","191","6","197","2023-01-02"
"51260","2022","COM","2020","75","3","78","2023-01-02"
"51262","2022","COM","2020","1787","34","1821","2023-01-02"
"51263","2022","COM","2020","376","7","383","2023-01-02"
"51264","2022","COM","2020","507","15","522","2023-01-02"
"51265","2022","COM","2020","596","12","608","2023-01-02"
"51266","2022","COM","2020","532","16","548","2023-01-02"
"51267","2022","COM","2020","176","1","177","2023-01-02"
"51268","2022","COM","2020","184","4","188","2023-01-02"
"51269","2022","COM","2020","277","1","278","2023-01-02"
"51270","2022","COM","2020","239","5","244","2023-01-02"
"51272","2022","COM","2020","457","7","464","2023-01-02"
"51273","2022","COM","2020","71","0","71","2023-01-02"
"51274","2022","COM","2020","117","3","120","2023-01-02"
"51275","2022","COM","2020","187","2","189","2023-01-02"
"51276","2022","COM","2020","143","7","150","2023-01-02"
"51277","2022","COM","2020","272","7","279","2023-01-02"
"51278","2022","COM","2020","276","5","281","2023-01-02"
"51279","2022","COM","2020","184","5","189","2023-01-02"
"51280","2022","COM","2020","24","0","24","2023-01-02"
"51281","2022","COM","2020","619","12","631","2023-01-02"
"51282","2022","COM","2020","1850","48","1898","2023-01-02"
"51283","2022","COM","2020","139","7","146","2023-01-02"
"51284","2022","COM","2020","303","1","304","2023-01-02"
"51285","2022","COM","2020","139","4","143","2023-01-02"
"51286","2022","COM","2020","240","7","247","2023-01-02"
"51287","2022","COM","2020","669","15","684","2023-01-02"
"51288","2022","COM","2020","238","7","245","2023-01-02"
"51289","2022","COM","2020","434","9","443","2023-01-02"
"51290","2022","COM","2020","281","6","287","2023-01-02"
"51291","2022","COM","2020","1392","33","1425","2023-01-02"
"51292","2022","COM","2020","122","4","126","2023-01-02"
"51293","2022","COM","2020","483","7","490","2023-01-02"
"51294","2022","COM","2020","80","0","80","2023-01-02"
"51295","2022","COM","2020","303","2","305","2023-01-02"
"51296","2022","COM","2020","77","0","77","2023-01-02"
"51298","2022","COM","2020","433","3","436","2023-01-02"
"51299","2022","COM","2020","946","13","959","2023-01-02"
"51300","2022","COM","2020","94","2","96","2023-01-02"
"51301","2022","COM","2020","107","9","116","2023-01-02"
"51302","2022","COM","2020","94","1","95","2023-01-02"
"51303","2022","COM","2020","547","10","557","2023-01-02"
"51304","2022","COM","2020","172","4","176","2023-01-02"
"51305","2022","COM","2020","127","2","129","2023-01-02"
"51306","2022","COM","2020","103","3","106","2023-01-02"
"51307","2022","COM","2020","227","3","230","2023-01-02"
"51308","2022","COM","2020","1843","56","1899","2023-01-02"
"51309","2022","COM","2020","112","4","116","2023-01-02"
"51310","2022","COM","2020","221","3","224","2023-01-02"
"51311","2022","COM","2020","207","2","209","2023-01-02"
"51312","2022","COM","2020","938","29","967","2023-01-02"
"51313","2022","COM","2020","331","11","342","2023-01-02"
"51314","2022","COM","2020","235","4","239","2023-01-02"
"51315","2022","COM","2020","145","1","146","2023-01-02"
"51316","2022","COM","2020","272","5","277","2023-01-02"
"51317","2022","COM","2020","52","0","52","2023-01-02"
"51318","2022","COM","2020","568","16","584","2023-01-02"
"51319","2022","COM","2020","103","3","106","2023-01-02"
"51320","2022","COM","2020","307","8","315","2023-01-02"
"51321","2022","COM","2020","84","2","86","2023-01-02"
"51322","2022","COM","2020","122","1","123","2023-01-02"
"51323","2022","COM","2020","106","6","112","2023-01-02"
"51324","2022","COM","2020","113","0","113","2023-01-02"
"51325","2022","COM","2020","108","1","109","2023-01-02"
"51326","2022","COM","2020","1093","14","1107","2023-01-02"
"51327","2022","COM","2020","177","2","179","2023-01-02"
"51328","2022","COM","2020","1109","24","1133","2023-01-02"
"51329","2022","COM","2020","1380","19","1399","2023-01-02"
"51333","2022","COM","2020","680","15","695","2023-01-02"
"51334","2022","COM","2020","463","17","480","2023-01-02"
"51336","2022","COM","2020","58","1","59","2023-01-02"
"51337","2022","COM","2020","269","2","271","2023-01-02"
"51338","2022","COM","2020","629","16","645","2023-01-02"
"51339","2022","COM","2020","562","15","577","2023-01-02"
"51340","2022","COM","2020","541","14","555","2023-01-02"
"51341","2022","COM","2020","34","2","36","2023-01-02"
"51342","2022","COM","2020","243","7","250","2023-01-02"
"51343","2022","COM","2020","623","21","644","2023-01-02"
"51344","2022","COM","2020","1474","20","1494","2023-01-02"
"51345","2022","COM","2020","286","2","288","2023-01-02"
"51346","2022","COM","2020","1152","18","1170","2023-01-02"
"51348","2022","COM","2020","109","1","110","2023-01-02"
"51349","2022","COM","2020","170","5","175","2023-01-02"
"51350","2022","COM","2020","127","5","132","2023-01-02"
"51351","2022","COM","2020","112","1","113","2023-01-02"
"51352","2022","COM","2020","852","19","871","2023-01-02"
"51353","2022","COM","2020","47","2","49","2023-01-02"
"51354","2022","COM","2020","279","9","288","2023-01-02"
"51355","2022","COM","2020","49","0","49","2023-01-02"
"51356","2022","COM","2020","153","5","158","2023-01-02"
"51357","2022","COM","2020","623","14","637","2023-01-02"
"51358","2022","COM","2020","583","10","593","2023-01-02"
"51359","2022","COM","2020","210","3","213","2023-01-02"
"51360","2022","COM","2020","298","2","300","2023-01-02"
"51361","2022","COM","2020","166","1","167","2023-01-02"
"51362","2022","COM","2020","603","19","622","2023-01-02"
"51363","2022","COM","2020","263","7","270","2023-01-02"
"51364","2022","COM","2020","67","1","68","2023-01-02"
"51365","2022","COM","2020","905","16","921","2023-01-02"
"51367","2022","COM","2020","1028","35","1063","2023-01-02"
"51368","2022","COM","2020","47","3","50","2023-01-02"
"51369","2022","COM","2020","312","15","327","2023-01-02"
"51370","2022","COM","2020","191","10","201","2023-01-02"
"51371","2022","COM","2020","59","1","60","2023-01-02"
"51372","2022","COM","2020","542","11","553","2023-01-02"
"51373","2022","COM","2020","90","4","94","2023-01-02"
"51374","2022","COM","2020","26","0","26","2023-01-02"
"51375","2022","COM","2020","354","6","360","2023-01-02"
"51376","2022","COM","2020","154","2","156","2023-01-02"
"51377","2022","COM","2020","48","0","48","2023-01-02"
"51378","2022","COM","2020","347","5","352","2023-01-02"
"51379","2022","COM","2020","509","8","517","2023-01-02"
"51380","2022","COM","2020","3561","48","3609","2023-01-02"
"51381","2022","COM","2020","624","10","634","2023-01-02"
"51382","2022","COM","2020","113","4","117","2023-01-02"
"51384","2022","COM","2020","394","12","406","2023-01-02"
"51386","2022","COM","2020","141","2","143","2023-01-02"
"51387","2022","COM","2020","291","3","294","2023-01-02"
"51388","2022","COM","2020","5163","50","5213","2023-01-02"
"51389","2022","COM","2020","813","7","820","2023-01-02"
"51390","2022","COM","2020","783","10","793","2023-01-02"
"51391","2022","COM","2020","2105","62","2167","2023-01-02"
"51392","2022","COM","2020","193","5","198","2023-01-02"
"51393","2022","COM","2020","299","7","306","2023-01-02"
"51395","2022","COM","2020","95","1","96","2023-01-02"
"51396","2022","COM","2020","139","3","142","2023-01-02"
"51397","2022","COM","2020","137","2","139","2023-01-02"
"51398","2022","COM","2020","187","2","189","2023-01-02"
"51399","2022","COM","2020","542","9","551","2023-01-02"
"51402","2022","COM","2020","266","7","273","2023-01-02"
"51403","2022","COM","2020","530","9","539","2023-01-02"
"51404","2022","COM","2020","107","4","111","2023-01-02"
"51406","2022","COM","2020","155","1","156","2023-01-02"
"51407","2022","COM","2020","409","7","416","2023-01-02"
"51409","2022","COM","2020","375","8","383","2023-01-02"
"51410","2022","COM","2020","657","10","667","2023-01-02"
"51412","2022","COM","2020","59","2","61","2023-01-02"
"51413","2022","COM","2020","887","18","905","2023-01-02"
"51414","2022","COM","2020","148","5","153","2023-01-02"
"51415","2022","COM","2020","202","0","202","2023-01-02"
"51416","2022","COM","2020","545","3","548","2023-01-02"
"51417","2022","COM","2020","372","3","375","2023-01-02"
"51418","2022","COM","2020","460","4","464","2023-01-02"
"51419","2022","COM","2020","126","1","127","2023-01-02"
"51420","2022","COM","2020","81","0","81","2023-01-02"
"51421","2022","COM","2020","103","3","106","2023-01-02"
"51422","2022","COM","2020","478","10","488","2023-01-02"
"51423","2022","COM","2020","1723","15","1738","2023-01-02"
"51424","2022","COM","2020","207","1","208","2023-01-02"
"51425","2022","COM","2020","380","14","394","2023-01-02"
"51426","2022","COM","2020","66","3","69","2023-01-02"
"51428","2022","COM","2020","491","9","500","2023-01-02"
"51429","2022","COM","2020","208","3","211","2023-01-02"
"51430","2022","COM","2020","85","2","87","2023-01-02"
"51431","2022","COM","2020","1207","18","1225","2023-01-02"
"51432","2022","COM","2020","828","19","847","2023-01-02"
"51433","2022","COM","2020","246","5","251","2023-01-02"
"51434","2022","COM","2020","746","20","766","2023-01-02"
"51435","2022","COM","2020","181","2","183","2023-01-02"
"51436","2022","COM","2020","929","17","946","2023-01-02"
"51437","2022","COM","2020","94","0","94","2023-01-02"
"51438","2022","COM","2020","71","1","72","2023-01-02"
"51439","2022","COM","2020","486","6","492","2023-01-02"
"51440","2022","COM","2020","1739","17","1756","2023-01-02"
"51441","2022","COM","2020","105","2","107","2023-01-02"
"51442","2022","COM","2020","132","0","132","2023-01-02"
"51443","2022","COM","2020","116","3","119","2023-01-02"
"51444","2022","COM","2020","505","10","515","2023-01-02"
"51445","2022","COM","2020","198","3","201","2023-01-02"
"51446","2022","COM","2020","435","8","443","2023-01-02"
"51447","2022","COM","2020","484","13","497","2023-01-02"
"51448","2022","COM","2020","553","10","563","2023-01-02"
"51449","2022","COM","2020","1026","15","1041","2023-01-02"
"51450","2022","COM","2020","425","8","433","2023-01-02"
"51451","2022","COM","2020","85","4","89","2023-01-02"
"51452","2022","COM","2020","32","0","32","2023-01-02"
"51453","2022","COM","2020","1044","31","1075","2023-01-02"
"51454","2022","COM","2020","180318","2969","183287","2023-01-02"
"51455","2022","COM","2020","221","3","224","2023-01-02"
"51456","2022","COM","2020","59","1","60","2023-01-02"
"51457","2022","COM","2020","281","18","299","2023-01-02"
"51458","2022","COM","2020","62","0","62","2023-01-02"
"51459","2022","COM","2020","108","1","109","2023-01-02"
"51460","2022","COM","2020","194","5","199","2023-01-02"
"51461","2022","COM","2020","1020","22","1042","2023-01-02"
"51463","2022","COM","2020","162","5","167","2023-01-02"
"51464","2022","COM","2020","310","17","327","2023-01-02"
"51465","2022","COM","2020","162","2","164","2023-01-02"
"51466","2022","COM","2020","216","5","221","2023-01-02"
"51468","2022","COM","2020","362","12","374","2023-01-02"
"51469","2022","COM","2020","111","5","116","2023-01-02"
"51470","2022","COM","2020","3","0","3","2023-01-02"
"51471","2022","COM","2020","372","3","375","2023-01-02"
"51472","2022","COM","2020","1028","26","1054","2023-01-02"
"51473","2022","COM","2020","100","6","106","2023-01-02"
"51474","2022","COM","2020","3392","39","3431","2023-01-02"
"51475","2022","COM","2020","61","1","62","2023-01-02"
"51476","2022","COM","2020","821","13","834","2023-01-02"
"51477","2022","COM","2020","335","4","339","2023-01-02"
"51478","2022","COM","2020","422","12","434","2023-01-02"
"51479","2022","COM","2020","243","5","248","2023-01-02"
"51480","2022","COM","2020","137","3","140","2023-01-02"
"51482","2022","COM","2020","683","13","696","2023-01-02"
"51483","2022","COM","2020","539","7","546","2023-01-02"
"51484","2022","COM","2020","272","5","277","2023-01-02"
"51485","2022","COM","2020","332","9","341","2023-01-02"
"51486","2022","COM","2020","378","4","382","2023-01-02"
"51487","2022","COM","2020","347","6","353","2023-01-02"
"51488","2022","COM","2020","316","35","351","2023-01-02"
"51489","2022","COM","2020","31","3","34","2023-01-02"
"51490","2022","COM","2020","199","2","201","2023-01-02"
"51491","2022","COM","2020","88","3","91","2023-01-02"
"51492","2022","COM","2020","1414","35","1449","2023-01-02"
"51493","2022","COM","2020","109","4","113","2023-01-02"
"51495","2022","COM","2020","74","0","74","2023-01-02"
"51496","2022","COM","2020","267","8","275","2023-01-02"
"51497","2022","COM","2020","41","0","41","2023-01-02"
"51498","2022","COM","2020","64","1","65","2023-01-02"
"51499","2022","COM","2020","159","7","166","2023-01-02"
"51500","2022","COM","2020","117","2","119","2023-01-02"
"51501","2022","COM","2020","194","8","202","2023-01-02"
"51502","2022","COM","2020","115","0","115","2023-01-02"
"51503","2022","COM","2020","84","1","85","2023-01-02"
"51504","2022","COM","2020","801","13","814","2023-01-02"
"51505","2022","COM","2020","500","5","505","2023-01-02"
"51506","2022","COM","2020","5448","75","5523","2023-01-02"
"51507","2022","COM","2020","4166","111","4277","2023-01-02"
"51508","2022","COM","2020","203","3","206","2023-01-02"
"51509","2022","COM","2020","308","9","317","2023-01-02"
"51510","2022","COM","2020","124","0","124","2023-01-02"
"51511","2022","COM","2020","117","2","119","2023-01-02"
"51512","2022","COM","2020","101","2","103","2023-01-02"
"51513","2022","COM","2020","508","9","517","2023-01-02"
"51514","2022","COM","2020","108","1","109","2023-01-02"
"51515","2022","COM","2020","336","8","344","2023-01-02"
"51516","2022","COM","2020","47","0","47","2023-01-02"
"51517","2022","COM","2020","118","4","122","2023-01-02"
"51518","2022","COM","2020","611","24","635","2023-01-02"
"51519","2022","COM","2020","38","2","40","2023-01-02"
"51520","2022","COM","2020","76","1","77","2023-01-02"
"51521","2022","COM","2020","223","3","226","2023-01-02"
"51522","2022","COM","2020","431","5","436","2023-01-02"
"51523","2022","COM","2020","269","4","273","2023-01-02"
"51524","2022","COM","2020","289","3","292","2023-01-02"
"51525","2022","COM","2020","2023","86","2109","2023-01-02"
"51526","2022","COM","2020","387","10","397","2023-01-02"
"51527","2022","COM","2020","270","4","274","2023-01-02"
"51528","2022","COM","2020","127","0","127","2023-01-02"
"51529","2022","COM","2020","427","5","432","2023-01-02"
"51530","2022","COM","2020","686","12","698","2023-01-02"
"51531","2022","COM","2020","1779","31","1810","2023-01-02"
"51532","2022","COM","2020","568","15","583","2023-01-02"
"51533","2022","COM","2020","100","6","106","2023-01-02"
"51534","2022","COM","2020","211","4","215","2023-01-02"
"51535","2022","COM","2020","4775","106","4881","2023-01-02"
"51536","2022","COM","2020","1796","38","1834","2023-01-02"
"51537","2022","COM","2020","178","4","182","2023-01-02"
"51538","2022","COM","2020","111","0","111","2023-01-02"
"51539","2022","COM","2020","74","0","74","2023-01-02"
"51542","2022","COM","2020","193","0","193","2023-01-02"
"51543","2022","COM","2020","69","7","76","2023-01-02"
"51544","2022","COM","2020","646","18","664","2023-01-02"
"51545","2022","COM","2020","487","16","503","2023-01-02"
"51546","2022","COM","2020","510","150","660","2023-01-02"
"51547","2022","COM","2020","140","2","142","2023-01-02"
"51548","2022","COM","2020","357","242","599","2023-01-02"
"51549","2022","COM","2020","123","3","126","2023-01-02"
"51550","2022","COM","2020","267","11","278","2023-01-02"
"51551","2022","COM","2020","200","6","206","2023-01-02"
"51552","2022","COM","2020","270","4","274","2023-01-02"
"51553","2022","COM","2020","250","5","255","2023-01-02"
"51555","2022","COM","2020","157","0","157","2023-01-02"
"51556","2022","COM","2020","293","4","297","2023-01-02"
"51557","2022","COM","2020","464","9","473","2023-01-02"
"51558","2022","COM","2020","141","3","144","2023-01-02"
"51559","2022","COM","2020","3881","36","3917","2023-01-02"
"51560","2022","COM","2020","107","3","110","2023-01-02"
"51562","2022","COM","2020","2180","36","2216","2023-01-02"
"51563","2022","COM","2020","105","2","107","2023-01-02"
"51564","2022","COM","2020","603","17","620","2023-01-02"
"51565","2022","COM","2020","102","0","102","2023-01-02"
"51566","2022","COM","2020","293","2","295","2023-01-02"
"51567","2022","COM","2020","518","6","524","2023-01-02"
"51568","2022","COM","2020","307","7","314","2023-01-02"
"51569","2022","COM","2020","506","69","575","2023-01-02"
"51570","2022","COM","2020","106","2","108","2023-01-02"
"51571","2022","COM","2020","951","10","961","2023-01-02"
"51572","2022","COM","2020","233","11","244","2023-01-02"
"51573","2022","COM","2020","10456","135","10591","2023-01-02"
"51574","2022","COM","2020","138","2","140","2023-01-02"
"51576","2022","COM","2020","1386","13","1399","2023-01-02"
"51577","2022","COM","2020","154","3","157","2023-01-02"
"51578","2022","COM","2020","91","1","92","2023-01-02"
"51579","2022","COM","2020","177","3","180","2023-01-02"
"51580","2022","COM","2020","440","5","445","2023-01-02"
"51581","2022","COM","2020","255","2","257","2023-01-02"
"51582","2022","COM","2020","566","10","576","2023-01-02"
"51583","2022","COM","2020","192","0","192","2023-01-02"
"51584","2022","COM","2020","144","2","146","2023-01-02"
"51585","2022","COM","2020","786","62","848","2023-01-02"
"51586","2022","COM","2020","183","5","188","2023-01-02"
"51587","2022","COM","2020","232","5","237","2023-01-02"
"51588","2022","COM","2020","282","6","288","2023-01-02"
"51589","2022","COM","2020","172","1","173","2023-01-02"
"51590","2022","COM","2020","368","9","377","2023-01-02"
"51591","2022","COM","2020","172","3","175","2023-01-02"
"51592","2022","COM","2020","298","6","304","2023-01-02"
"51594","2022","COM","2020","64","0","64","2023-01-02"
"51595","2022","COM","2020","153","2","155","2023-01-02"
"51596","2022","COM","2020","358","2","360","2023-01-02"
"51597","2022","COM","2020","331","7","338","2023-01-02"
"51598","2022","COM","2020","489","9","498","2023-01-02"
"51599","2022","COM","2020","334","5","339","2023-01-02"
"51600","2022","COM","2020","98","1","99","2023-01-02"
"51601","2022","COM","2020","158","3","161","2023-01-02"
"51602","2022","COM","2020","64","0","64","2023-01-02"
"51603","2022","COM","2020","210","2","212","2023-01-02"
"51604","2022","COM","2020","257","3","260","2023-01-02"
"51605","2022","COM","2020","525","10","535","2023-01-02"
"51607","2022","COM","2020","202","2","204","2023-01-02"
"51608","2022","COM","2020","84","5","89","2023-01-02"
"51609","2022","COM","2020","844","14","858","2023-01-02"
"51610","2022","COM","2020","388","6","394","2023-01-02"
"51611","2022","COM","2020","286","4","290","2023-01-02"
"51612","2022","COM","2020","3244","200","3444","2023-01-02"
"51613","2022","COM","2020","1031","16","1047","2023-01-02"
"51614","2022","COM","2020","953","21","974","2023-01-02"
"51616","2022","COM","2020","230","3","233","2023-01-02"
"51617","2022","COM","2020","599","17","616","2023-01-02"
"51618","2022","COM","2020","190","3","193","2023-01-02"
"51619","2022","COM","2020","111","3","114","2023-01-02"
"51620","2022","COM","2020","169","5","174","2023-01-02"
"51621","2022","COM","2020","516","8","524","2023-01-02"
"51622","2022","COM","2020","402","9","411","2023-01-02"
"51623","2022","COM","2020","287","46","333","2023-01-02"
"51624","2022","COM","2020","642","7","649","2023-01-02"
"51625","2022","COM","2020","280","4","284","2023-01-02"
"51626","2022","COM","2020","121","5","126","2023-01-02"
"51627","2022","COM","2020","326","11","337","2023-01-02"
"51628","2022","COM","2020","122","4","126","2023-01-02"
"51629","2022","COM","2020","925","23","948","2023-01-02"
"51630","2022","COM","2020","330","5","335","2023-01-02"
"51631","2022","COM","2020","271","4","275","2023-01-02"
"51632","2022","COM","2020","230","7","237","2023-01-02"
"51633","2022","COM","2020","296","15","311","2023-01-02"
"51634","2022","COM","2020","281","9","290","2023-01-02"
"51635","2022","COM","2020","109","0","109","2023-01-02"
"51636","2022","COM","2020","538","12","550","2023-01-02"
"51637","2022","COM","2020","210","3","213","2023-01-02"
"51638","2022","COM","2020","204","6","210","2023-01-02"
"51639","2022","COM","2020","42","1","43","2023-01-02"
"51640","2022","COM","2020","211","1","212","2023-01-02"
"51641","2022","COM","2020","197","5","202","2023-01-02"
"51642","2022","COM","2020","110","4","114","2023-01-02"
"51643","2022","COM","2020","549","5","554","2023-01-02"
"51644","2022","COM","2020","317","9","326","2023-01-02"
"51645","2022","COM","2020","109","2","111","2023-01-02"
"51646","2022","COM","2020","82","3","85","2023-01-02"
"51647","2022","COM","2020","826","24","850","2023-01-02"
"51648","2022","COM","2020","383","9","392","2023-01-02"
"51649","2022","COM","2020","11458","220","11678","2023-01-02"
"51650","2022","COM","2020","47","1","48","2023-01-02"
"51652","2022","COM","2020","57","0","57","2023-01-02"
"51654","2022","COM","2020","258","2","260","2023-01-02"
"51655","2022","COM","2020","291","5","296","2023-01-02"
"51656","2022","COM","2020","456","19","475","2023-01-02"
"51657","2022","COM","2020","252","0","252","2023-01-02"
"51658","2022","COM","2020","104","0","104","2023-01-02"
"51659","2022","COM","2020","48","1","49","2023-01-02"
"51660","2022","COM","2020","2644","28","2672","2023-01-02"
"51662","2022","COM","2020","4951","71","5022","2023-01-02"
"51663","2022","COM","2020","1694","15","1709","2023-01-02"
"52001","2022","COM","2020","313","8","321","2023-01-02"
"52002","2022","COM","2020","23","0","23","2023-01-02"
"52003","2022","COM","2020","148","2","150","2023-01-02"
"52004","2022","COM","2020","13","0","13","2023-01-02"
"52005","2022","COM","2020","34","4","38","2023-01-02"
"52006","2022","COM","2020","357","4","361","2023-01-02"
"52007","2022","COM","2020","88","2","90","2023-01-02"
"52008","2022","COM","2020","867","11","878","2023-01-02"
"52009","2022","COM","2020","103","1","104","2023-01-02"
"52011","2022","COM","2020","93","0","93","2023-01-02"
"52012","2022","COM","2020","29","2","31","2023-01-02"
"52013","2022","COM","2020","125","2","127","2023-01-02"
"52014","2022","COM","2020","189","5","194","2023-01-02"
"52015","2022","COM","2020","85","0","85","2023-01-02"
"52016","2022","COM","2020","68","2","70","2023-01-02"
"52017","2022","COM","2020","723","13","736","2023-01-02"
"52019","2022","COM","2020","88","4","92","2023-01-02"
"52021","2022","COM","2020","270","3","273","2023-01-02"
"52022","2022","COM","2020","185","3","188","2023-01-02"
"52023","2022","COM","2020","151","5","156","2023-01-02"
"52025","2022","COM","2020","87","2","89","2023-01-02"
"52027","2022","COM","2020","71","2","73","2023-01-02"
"52028","2022","COM","2020","55","0","55","2023-01-02"
"52029","2022","COM","2020","132","4","136","2023-01-02"
"52030","2022","COM","2020","52","3","55","2023-01-02"
"52031","2022","COM","2020","367","10","377","2023-01-02"
"52033","2022","COM","2020","104","4","108","2023-01-02"
"52034","2022","COM","2020","145","5","150","2023-01-02"
"52035","2022","COM","2020","183","3","186","2023-01-02"
"52037","2022","COM","2020","368","8","376","2023-01-02"
"52038","2022","COM","2020","64","0","64","2023-01-02"
"52039","2022","COM","2020","87","0","87","2023-01-02"
"52040","2022","COM","2020","51","0","51","2023-01-02"
"52042","2022","COM","2020","108","6","114","2023-01-02"
"52043","2022","COM","2020","54","1","55","2023-01-02"
"52044","2022","COM","2020","544","11","555","2023-01-02"
"52045","2022","COM","2020","1794","31","1825","2023-01-02"
"52047","2022","COM","2020","103","0","103","2023-01-02"
"52050","2022","COM","2020","1332","31","1363","2023-01-02"
"52051","2022","COM","2020","82","4","86","2023-01-02"
"52053","2022","COM","2020","68","0","68","2023-01-02"
"52055","2022","COM","2020","116","1","117","2023-01-02"
"52056","2022","COM","2020","183","8","191","2023-01-02"
"52057","2022","COM","2020","102","4","106","2023-01-02"
"52058","2022","COM","2020","1827","32","1859","2023-01-02"
"52059","2022","COM","2020","145","0","145","2023-01-02"
"52060","2022","COM","2020","1971","53","2024","2023-01-02"
"52061","2022","COM","2020","294","2","296","2023-01-02"
"52062","2022","COM","2020","159","3","162","2023-01-02"
"52063","2022","COM","2020","94","0","94","2023-01-02"
"52064","2022","COM","2020","770","34","804","2023-01-02"
"52065","2022","COM","2020","65","2","67","2023-01-02"
"52066","2022","COM","2020","63","3","66","2023-01-02"
"52067","2022","COM","2020","72","0","72","2023-01-02"
"52069","2022","COM","2020","138","2","140","2023-01-02"
"52070","2022","COM","2020","120","3","123","2023-01-02"
"52072","2022","COM","2020","379","11","390","2023-01-02"
"52074","2022","COM","2020","670","20","690","2023-01-02"
"52075","2022","COM","2020","175","6","181","2023-01-02"
"52076","2022","COM","2020","436","6","442","2023-01-02"
"52079","2022","COM","2020","642","9","651","2023-01-02"
"52082","2022","COM","2020","155","5","160","2023-01-02"
"52083","2022","COM","2020","738","14","752","2023-01-02"
"52084","2022","COM","2020","43","0","43","2023-01-02"
"52085","2022","COM","2020","26","2","28","2023-01-02"
"52087","2022","COM","2020","198","20","218","2023-01-02"
"52088","2022","COM","2020","650","16","666","2023-01-02"
"52089","2022","COM","2020","72","0","72","2023-01-02"
"52090","2022","COM","2020","101","1","102","2023-01-02"
"52091","2022","COM","2020","85","6","91","2023-01-02"
"52092","2022","COM","2020","106","2","108","2023-01-02"
"52093","2022","COM","2020","2406","55","2461","2023-01-02"
"52094","2022","COM","2020","179","2","181","2023-01-02"
"52095","2022","COM","2020","192","2","194","2023-01-02"
"52097","2022","COM","2020","49","1","50","2023-01-02"
"52099","2022","COM","2020","764","7","771","2023-01-02"
"52101","2022","COM","2020","40","1","41","2023-01-02"
"52102","2022","COM","2020","416","6","422","2023-01-02"
"52103","2022","COM","2020","119","2","121","2023-01-02"
"52104","2022","COM","2020","1024","24","1048","2023-01-02"
"52105","2022","COM","2020","296","6","302","2023-01-02"
"52106","2022","COM","2020","119","2","121","2023-01-02"
"52107","2022","COM","2020","218","4","222","2023-01-02"
"52108","2022","COM","2020","147","4","151","2023-01-02"
"52109","2022","COM","2020","6","0","6","2023-01-02"
"52110","2022","COM","2020","156","3","159","2023-01-02"
"52113","2022","COM","2020","256","5","261","2023-01-02"
"52114","2022","COM","2020","1573","19","1592","2023-01-02"
"52115","2022","COM","2020","98","2","100","2023-01-02"
"52116","2022","COM","2020","48","2","50","2023-01-02"
"52118","2022","COM","2020","276","6","282","2023-01-02"
"52119","2022","COM","2020","345","9","354","2023-01-02"
"52120","2022","COM","2020","182","7","189","2023-01-02"
"52121","2022","COM","2020","21770","1196","22966","2023-01-02"
"52122","2022","COM","2020","115","1","116","2023-01-02"
"52123","2022","COM","2020","1305","25","1330","2023-01-02"
"52124","2022","COM","2020","76","0","76","2023-01-02"
"52125","2022","COM","2020","1046","174","1220","2023-01-02"
"52126","2022","COM","2020","157","4","161","2023-01-02"
"52127","2022","COM","2020","78","4","82","2023-01-02"
"52128","2022","COM","2020","146","3","149","2023-01-02"
"52129","2022","COM","2020","117","0","117","2023-01-02"
"52130","2022","COM","2020","190","2","192","2023-01-02"
"52131","2022","COM","2020","79","2","81","2023-01-02"
"52132","2022","COM","2020","164","3","167","2023-01-02"
"52133","2022","COM","2020","70","0","70","2023-01-02"
"52134","2022","COM","2020","218","1","219","2023-01-02"
"52135","2022","COM","2020","87","2","89","2023-01-02"
"52136","2022","COM","2020","108","0","108","2023-01-02"
"52137","2022","COM","2020","21","0","21","2023-01-02"
"52138","2022","COM","2020","64","1","65","2023-01-02"
"52140","2022","COM","2020","693","16","709","2023-01-02"
"52141","2022","COM","2020","295","6","301","2023-01-02"
"52142","2022","COM","2020","73","1","74","2023-01-02"
"52145","2022","COM","2020","119","5","124","2023-01-02"
"52146","2022","COM","2020","160","3","163","2023-01-02"
"52147","2022","COM","2020","90","2","92","2023-01-02"
"52149","2022","COM","2020","90","2","92","2023-01-02"
"52151","2022","COM","2020","148","2","150","2023-01-02"
"52155","2022","COM","2020","522","12","534","2023-01-02"
"52156","2022","COM","2020","407","8","415","2023-01-02"
"52157","2022","COM","2020","12","1","13","2023-01-02"
"52158","2022","COM","2020","281","3","284","2023-01-02"
"52159","2022","COM","2020","26","1","27","2023-01-02"
"52160","2022","COM","2020","63","3","66","2023-01-02"
"52161","2022","COM","2020","72","0","72","2023-01-02"
"52162","2022","COM","2020","197","2","199","2023-01-02"
"52163","2022","COM","2020","387","4","391","2023-01-02"
"52164","2022","COM","2020","197","5","202","2023-01-02"
"52165","2022","COM","2020","196","5","201","2023-01-02"
"52167","2022","COM","2020","263","3","266","2023-01-02"
"52168","2022","COM","2020","62","3","65","2023-01-02"
"52169","2022","COM","2020","77","2","79","2023-01-02"
"52170","2022","COM","2020","168","7","175","2023-01-02"
"52171","2022","COM","2020","241","2","243","2023-01-02"
"52172","2022","COM","2020","282","7","289","2023-01-02"
"52173","2022","COM","2020","76","2","78","2023-01-02"
"52174","2022","COM","2020","37","1","38","2023-01-02"
"52175","2022","COM","2020","392","4","396","2023-01-02"
"52177","2022","COM","2020","780","34","814","2023-01-02"
"52178","2022","COM","2020","361","9","370","2023-01-02"
"52179","2022","COM","2020","19","2","21","2023-01-02"
"52181","2022","COM","2020","91","1","92","2023-01-02"
"52182","2022","COM","2020","2017","49","2066","2023-01-02"
"52183","2022","COM","2020","39","1","40","2023-01-02"
"52184","2022","COM","2020","58","5","63","2023-01-02"
"52185","2022","COM","2020","64","0","64","2023-01-02"
"52187","2022","COM","2020","159","4","163","2023-01-02"
"52189","2022","COM","2020","407","11","418","2023-01-02"
"52190","2022","COM","2020","291","7","298","2023-01-02"
"52193","2022","COM","2020","298","12","310","2023-01-02"
"52194","2022","COM","2020","2029","37","2066","2023-01-02"
"52195","2022","COM","2020","36","0","36","2023-01-02"
"52196","2022","COM","2020","96","4","100","2023-01-02"
"52197","2022","COM","2020","1285","80","1365","2023-01-02"
"52198","2022","COM","2020","67","2","69","2023-01-02"
"52199","2022","COM","2020","51","2","53","2023-01-02"
"52200","2022","COM","2020","74","5","79","2023-01-02"
"52201","2022","COM","2020","69","0","69","2023-01-02"
"52203","2022","COM","2020","146","2","148","2023-01-02"
"52204","2022","COM","2020","63","4","67","2023-01-02"
"52205","2022","COM","2020","688","17","705","2023-01-02"
"52206","2022","COM","2020","154","4","158","2023-01-02"
"52207","2022","COM","2020","95","3","98","2023-01-02"
"52208","2022","COM","2020","151","3","154","2023-01-02"
"52211","2022","COM","2020","1406","24","1430","2023-01-02"
"52212","2022","COM","2020","306","4","310","2023-01-02"
"52213","2022","COM","2020","129","4","133","2023-01-02"
"52214","2022","COM","2020","31","1","32","2023-01-02"
"52216","2022","COM","2020","50","1","51","2023-01-02"
"52217","2022","COM","2020","86","4","90","2023-01-02"
"52218","2022","COM","2020","50","0","50","2023-01-02"
"52219","2022","COM","2020","18","0","18","2023-01-02"
"52220","2022","COM","2020","142","1","143","2023-01-02"
"52221","2022","COM","2020","121","2","123","2023-01-02"
"52222","2022","COM","2020","34","0","34","2023-01-02"
"52223","2022","COM","2020","66","2","68","2023-01-02"
"52227","2022","COM","2020","206","10","216","2023-01-02"
"52228","2022","COM","2020","75","1","76","2023-01-02"
"52229","2022","COM","2020","153","1","154","2023-01-02"
"52230","2022","COM","2020","283","5","288","2023-01-02"
"52231","2022","COM","2020","89","2","91","2023-01-02"
"52232","2022","COM","2020","64","0","64","2023-01-02"
"52233","2022","COM","2020","103","2","105","2023-01-02"
"52234","2022","COM","2020","41","3","44","2023-01-02"
"52235","2022","COM","2020","248","4","252","2023-01-02"
"52237","2022","COM","2020","274","9","283","2023-01-02"
"52240","2022","COM","2020","190","7","197","2023-01-02"
"52242","2022","COM","2020","964","16","980","2023-01-02"
"52243","2022","COM","2020","122","1","123","2023-01-02"
"52244","2022","COM","2020","753","11","764","2023-01-02"
"52245","2022","COM","2020","61","5","66","2023-01-02"
"52246","2022","COM","2020","583","12","595","2023-01-02"
"52247","2022","COM","2020","204","8","212","2023-01-02"
"52248","2022","COM","2020","547","17","564","2023-01-02"
"52249","2022","COM","2020","147","0","147","2023-01-02"
"52250","2022","COM","2020","3001","69","3070","2023-01-02"
"52251","2022","COM","2020","983","35","1018","2023-01-02"
"52253","2022","COM","2020","210","3","213","2023-01-02"
"52254","2022","COM","2020","86","1","87","2023-01-02"
"52256","2022","COM","2020","75","2","77","2023-01-02"
"52257","2022","COM","2020","105","2","107","2023-01-02"
"52258","2022","COM","2020","309","2","311","2023-01-02"
"52260","2022","COM","2020","123","2","125","2023-01-02"
"52264","2022","COM","2020","61","2","63","2023-01-02"
"52265","2022","COM","2020","1286","27","1313","2023-01-02"
"52266","2022","COM","2020","65","1","66","2023-01-02"
"52267","2022","COM","2020","222","3","225","2023-01-02"
"52269","2022","COM","2020","7682","399","8081","2023-01-02"
"52271","2022","COM","2020","203","6","209","2023-01-02"
"52272","2022","COM","2020","114","1","115","2023-01-02"
"52273","2022","COM","2020","122","1","123","2023-01-02"
"52274","2022","COM","2020","289","9","298","2023-01-02"
"52275","2022","COM","2020","71","2","73","2023-01-02"
"52276","2022","COM","2020","232","8","240","2023-01-02"
"52277","2022","COM","2020","58","1","59","2023-01-02"
"52278","2022","COM","2020","69","0","69","2023-01-02"
"52280","2022","COM","2020","197","3","200","2023-01-02"
"52282","2022","COM","2020","335","5","340","2023-01-02"
"52284","2022","COM","2020","90","1","91","2023-01-02"
"52285","2022","COM","2020","75","2","77","2023-01-02"
"52286","2022","COM","2020","75","0","75","2023-01-02"
"52287","2022","COM","2020","89","2","91","2023-01-02"
"52288","2022","COM","2020","117","3","120","2023-01-02"
"52289","2022","COM","2020","314","12","326","2023-01-02"
"52290","2022","COM","2020","129","2","131","2023-01-02"
"52291","2022","COM","2020","61","0","61","2023-01-02"
"52292","2022","COM","2020","712","10","722","2023-01-02"
"52294","2022","COM","2020","694","11","705","2023-01-02"
"52295","2022","COM","2020","94","0","94","2023-01-02"
"52297","2022","COM","2020","276","10","286","2023-01-02"
"52298","2022","COM","2020","72","1","73","2023-01-02"
"52300","2022","COM","2020","161","2","163","2023-01-02"
"52301","2022","COM","2020","61","1","62","2023-01-02"
"52302","2022","COM","2020","185","3","188","2023-01-02"
"52303","2022","COM","2020","96","1","97","2023-01-02"
"52304","2022","COM","2020","52","1","53","2023-01-02"
"52305","2022","COM","2020","555","5","560","2023-01-02"
"52306","2022","COM","2020","449","10","459","2023-01-02"
"52307","2022","COM","2020","213","9","222","2023-01-02"
"52308","2022","COM","2020","400","4","404","2023-01-02"
"52310","2022","COM","2020","99","2","101","2023-01-02"
"52311","2022","COM","2020","224","4","228","2023-01-02"
"52312","2022","COM","2020","56","3","59","2023-01-02"
"52313","2022","COM","2020","141","1","142","2023-01-02"
"52315","2022","COM","2020","339","1","340","2023-01-02"
"52316","2022","COM","2020","70","2","72","2023-01-02"
"52318","2022","COM","2020","244","6","250","2023-01-02"
"52319","2022","COM","2020","69","1","70","2023-01-02"
"52320","2022","COM","2020","92","3","95","2023-01-02"
"52321","2022","COM","2020","180","3","183","2023-01-02"
"52322","2022","COM","2020","132","4","136","2023-01-02"
"52325","2022","COM","2020","117","5","122","2023-01-02"
"52326","2022","COM","2020","41","0","41","2023-01-02"
"52327","2022","COM","2020","453","9","462","2023-01-02"
"52328","2022","COM","2020","32","1","33","2023-01-02"
"52330","2022","COM","2020","67","2","69","2023-01-02"
"52331","2022","COM","2020","2225","56","2281","2023-01-02"
"52332","2022","COM","2020","1819","54","1873","2023-01-02"
"52335","2022","COM","2020","114","1","115","2023-01-02"
"52336","2022","COM","2020","138","3","141","2023-01-02"
"52337","2022","COM","2020","56","0","56","2023-01-02"
"52341","2022","COM","2020","131","2","133","2023-01-02"
"52342","2022","COM","2020","26","1","27","2023-01-02"
"52344","2022","COM","2020","30","1","31","2023-01-02"
"52346","2022","COM","2020","385","6","391","2023-01-02"
"52347","2022","COM","2020","231","4","235","2023-01-02"
"52348","2022","COM","2020","571","21","592","2023-01-02"
"52349","2022","COM","2020","302","8","310","2023-01-02"
"52350","2022","COM","2020","66","0","66","2023-01-02"
"52352","2022","COM","2020","65","5","70","2023-01-02"
"52353","2022","COM","2020","3567","61","3628","2023-01-02"
"52354","2022","COM","2020","83","0","83","2023-01-02"
"52355","2022","COM","2020","151","4","155","2023-01-02"
"52356","2022","COM","2020","108","4","112","2023-01-02"
"52357","2022","COM","2020","175","1","176","2023-01-02"
"52358","2022","COM","2020","94","0","94","2023-01-02"
"52359","2022","COM","2020","145","2","147","2023-01-02"
"52360","2022","COM","2020","166","4","170","2023-01-02"
"52362","2022","COM","2020","137","2","139","2023-01-02"
"52363","2022","COM","2020","98","7","105","2023-01-02"
"52364","2022","COM","2020","102","3","105","2023-01-02"
"52365","2022","COM","2020","343","3","346","2023-01-02"
"52366","2022","COM","2020","76","1","77","2023-01-02"
"52367","2022","COM","2020","41","1","42","2023-01-02"
"52369","2022","COM","2020","69","0","69","2023-01-02"
"52370","2022","COM","2020","255","5","260","2023-01-02"
"52371","2022","COM","2020","138","2","140","2023-01-02"
"52372","2022","COM","2020","83","6","89","2023-01-02"
"52373","2022","COM","2020","32","1","33","2023-01-02"
"52374","2022","COM","2020","272","5","277","2023-01-02"
"52375","2022","COM","2020","54","0","54","2023-01-02"
"52376","2022","COM","2020","108","2","110","2023-01-02"
"52377","2022","COM","2020","287","8","295","2023-01-02"
"52378","2022","COM","2020","45","2","47","2023-01-02"
"52380","2022","COM","2020","387","4","391","2023-01-02"
"52383","2022","COM","2020","292","7","299","2023-01-02"
"52384","2022","COM","2020","112","0","112","2023-01-02"
"52385","2022","COM","2020","30","1","31","2023-01-02"
"52386","2022","COM","2020","507","5","512","2023-01-02"
"52388","2022","COM","2020","152","2","154","2023-01-02"
"52390","2022","COM","2020","59","1","60","2023-01-02"
"52391","2022","COM","2020","307","9","316","2023-01-02"
"52392","2022","COM","2020","116","2","118","2023-01-02"
"52393","2022","COM","2020","56","0","56","2023-01-02"
"52394","2022","COM","2020","211","9","220","2023-01-02"
"52395","2022","COM","2020","56","0","56","2023-01-02"
"52396","2022","COM","2020","137","3","140","2023-01-02"
"52397","2022","COM","2020","68","1","69","2023-01-02"
"52398","2022","COM","2020","622","13","635","2023-01-02"
"52399","2022","COM","2020","101","7","108","2023-01-02"
"52400","2022","COM","2020","157","0","157","2023-01-02"
"52401","2022","COM","2020","359","12","371","2023-01-02"
"52403","2022","COM","2020","80","1","81","2023-01-02"
"52405","2022","COM","2020","1149","19","1168","2023-01-02"
"52406","2022","COM","2020","199","5","204","2023-01-02"
"52407","2022","COM","2020","276","7","283","2023-01-02"
"52411","2022","COM","2020","1327","40","1367","2023-01-02"
"52413","2022","COM","2020","106","2","108","2023-01-02"
"52414","2022","COM","2020","760","11","771","2023-01-02"
"52415","2022","COM","2020","120","0","120","2023-01-02"
"52416","2022","COM","2020","62","1","63","2023-01-02"
"52419","2022","COM","2020","127","4","131","2023-01-02"
"52420","2022","COM","2020","129","0","129","2023-01-02"
"52421","2022","COM","2020","454","15","469","2023-01-02"
"52422","2022","COM","2020","259","5","264","2023-01-02"
"52423","2022","COM","2020","652","13","665","2023-01-02"
"52424","2022","COM","2020","69","0","69","2023-01-02"
"52425","2022","COM","2020","192","2","194","2023-01-02"
"52426","2022","COM","2020","130","1","131","2023-01-02"
"52428","2022","COM","2020","64","1","65","2023-01-02"
"52429","2022","COM","2020","565","11","576","2023-01-02"
"52431","2022","COM","2020","166","2","168","2023-01-02"
"52432","2022","COM","2020","1398","29","1427","2023-01-02"
"52433","2022","COM","2020","89","1","90","2023-01-02"
"52436","2022","COM","2020","50","1","51","2023-01-02"
"52437","2022","COM","2020","25","0","25","2023-01-02"
"52438","2022","COM","2020","108","2","110","2023-01-02"
"52439","2022","COM","2020","73","1","74","2023-01-02"
"52440","2022","COM","2020","375","6","381","2023-01-02"
"52442","2022","COM","2020","345","10","355","2023-01-02"
"52443","2022","COM","2020","33","0","33","2023-01-02"
"52444","2022","COM","2020","347","9","356","2023-01-02"
"52445","2022","COM","2020","68","2","70","2023-01-02"
"52446","2022","COM","2020","234","2","236","2023-01-02"
"52447","2022","COM","2020","182","2","184","2023-01-02"
"52448","2022","COM","2020","23085","481","23566","2023-01-02"
"52449","2022","COM","2020","1115","31","1146","2023-01-02"
"52450","2022","COM","2020","129","4","133","2023-01-02"
"52452","2022","COM","2020","108","0","108","2023-01-02"
"52453","2022","COM","2020","130","1","131","2023-01-02"
"52455","2022","COM","2020","235","6","241","2023-01-02"
"52456","2022","COM","2020","627","17","644","2023-01-02"
"52457","2022","COM","2020","172","2","174","2023-01-02"
"52459","2022","COM","2020","108","2","110","2023-01-02"
"52461","2022","COM","2020","382","10","392","2023-01-02"
"52463","2022","COM","2020","44","1","45","2023-01-02"
"52464","2022","COM","2020","49","2","51","2023-01-02"
"52465","2022","COM","2020","129","0","129","2023-01-02"
"52467","2022","COM","2020","58","2","60","2023-01-02"
"52468","2022","COM","2020","110","4","114","2023-01-02"
"52469","2022","COM","2020","733","16","749","2023-01-02"
"52470","2022","COM","2020","368","14","382","2023-01-02"
"52472","2022","COM","2020","142","0","142","2023-01-02"
"52473","2022","COM","2020","91","1","92","2023-01-02"
"52474","2022","COM","2020","34","0","34","2023-01-02"
"52475","2022","COM","2020","56","6","62","2023-01-02"
"52476","2022","COM","2020","82","3","85","2023-01-02"
"52479","2022","COM","2020","653","16","669","2023-01-02"
"52480","2022","COM","2020","351","7","358","2023-01-02"
"52482","2022","COM","2020","97","2","99","2023-01-02"
"52483","2022","COM","2020","68","1","69","2023-01-02"
"52484","2022","COM","2020","361","15","376","2023-01-02"
"52486","2022","COM","2020","62","2","64","2023-01-02"
"52487","2022","COM","2020","65","3","68","2023-01-02"
"52488","2022","COM","2020","273","2","275","2023-01-02"
"52489","2022","COM","2020","35","1","36","2023-01-02"
"52490","2022","COM","2020","668","20","688","2023-01-02"
"52491","2022","COM","2020","116","5","121","2023-01-02"
"52492","2022","COM","2020","554","12","566","2023-01-02"
"52493","2022","COM","2020","29","0","29","2023-01-02"
"52494","2022","COM","2020","216","8","224","2023-01-02"
"52495","2022","COM","2020","84","1","85","2023-01-02"
"52497","2022","COM","2020","434","10","444","2023-01-02"
"52499","2022","COM","2020","44","0","44","2023-01-02"
"52500","2022","COM","2020","620","8","628","2023-01-02"
"52502","2022","COM","2020","66","0","66","2023-01-02"
"52503","2022","COM","2020","25","0","25","2023-01-02"
"52504","2022","COM","2020","260","5","265","2023-01-02"
"52505","2022","COM","2020","34","0","34","2023-01-02"
"52506","2022","COM","2020","92","1","93","2023-01-02"
"52507","2022","COM","2020","55","0","55","2023-01-02"
"52510","2022","COM","2020","368","10","378","2023-01-02"
"52511","2022","COM","2020","55","2","57","2023-01-02"
"52512","2022","COM","2020","510","13","523","2023-01-02"
"52513","2022","COM","2020","61","1","62","2023-01-02"
"52514","2022","COM","2020","345","11","356","2023-01-02"
"52515","2022","COM","2020","106","3","109","2023-01-02"
"52516","2022","COM","2020","50","4","54","2023-01-02"
"52517","2022","COM","2020","134","1","135","2023-01-02"
"52518","2022","COM","2020","102","2","104","2023-01-02"
"52519","2022","COM","2020","46","0","46","2023-01-02"
"52520","2022","COM","2020","153","3","156","2023-01-02"
"52522","2022","COM","2020","336","10","346","2023-01-02"
"52523","2022","COM","2020","68","4","72","2023-01-02"
"52524","2022","COM","2020","228","3","231","2023-01-02"
"52525","2022","COM","2020","71","1","72","2023-01-02"
"52526","2022","COM","2020","78","1","79","2023-01-02"
"52528","2022","COM","2020","145","1","146","2023-01-02"
"52529","2022","COM","2020","980","16","996","2023-01-02"
"52534","2022","COM","2020","1482","32","1514","2023-01-02"
"52535","2022","COM","2020","722","12","734","2023-01-02"
"52536","2022","COM","2020","46","0","46","2023-01-02"
"52538","2022","COM","2020","265","3","268","2023-01-02"
"52539","2022","COM","2020","67","0","67","2023-01-02"
"52540","2022","COM","2020","21","0","21","2023-01-02"
"52541","2022","COM","2020","210","4","214","2023-01-02"
"52542","2022","COM","2020","51","2","53","2023-01-02"
"52543","2022","COM","2020","515","10","525","2023-01-02"
"52544","2022","COM","2020","277","2","279","2023-01-02"
"52545","2022","COM","2020","107","2","109","2023-01-02"
"52546","2022","COM","2020","16","0","16","2023-01-02"
"52547","2022","COM","2020","204","9","213","2023-01-02"
"52548","2022","COM","2020","91","2","93","2023-01-02"
"52549","2022","COM","2020","27","0","27","2023-01-02"
"52550","2022","COM","2020","2780","105","2885","2023-01-02"
"53001","2022","COM","2020","1844","59","1903","2023-01-02"
"53002","2022","COM","2020","608","14","622","2023-01-02"
"53003","2022","COM","2020","2625","68","2693","2023-01-02"
"53005","2022","COM","2020","2321","60","2381","2023-01-02"
"53007","2022","COM","2020","2831","74","2905","2023-01-02"
"53008","2022","COM","2020","1827","51","1878","2023-01-02"
"53009","2022","COM","2020","670","14","684","2023-01-02"
"53010","2022","COM","2020","466","12","478","2023-01-02"
"53011","2022","COM","2020","884","19","903","2023-01-02"
"53012","2022","COM","2020","466","24","490","2023-01-02"
"53013","2022","COM","2020","558","15","573","2023-01-02"
"53015","2022","COM","2020","1941","42","1983","2023-01-02"
"53016","2022","COM","2020","1217","17","1234","2023-01-02"
"53017","2022","COM","2020","959","28","987","2023-01-02"
"53018","2022","COM","2020","1305","32","1337","2023-01-02"
"53019","2022","COM","2020","118","3","121","2023-01-02"
"53021","2022","COM","2020","1020","35","1055","2023-01-02"
"53022","2022","COM","2020","509","13","522","2023-01-02"
"53023","2022","COM","2020","557","12","569","2023-01-02"
"53025","2022","COM","2020","1095","11","1106","2023-01-02"
"53026","2022","COM","2020","535","9","544","2023-01-02"
"53027","2022","COM","2020","204","3","207","2023-01-02"
"53028","2022","COM","2020","569","11","580","2023-01-02"
"53029","2022","COM","2020","1254","31","1285","2023-01-02"
"53030","2022","COM","2020","320","4","324","2023-01-02"
"53031","2022","COM","2020","493","2","495","2023-01-02"
"53033","2022","COM","2020","115","4","119","2023-01-02"
"53034","2022","COM","2020","6187","194","6381","2023-01-02"
"53035","2022","COM","2020","592","9","601","2023-01-02"
"53036","2022","COM","2020","1062","21","1083","2023-01-02"
"53037","2022","COM","2020","725","27","752","2023-01-02"
"53038","2022","COM","2020","139","4","143","2023-01-02"
"53039","2022","COM","2020","1732","33","1765","2023-01-02"
"53040","2022","COM","2020","628","12","640","2023-01-02"
"53041","2022","COM","2020","278","5","283","2023-01-02"
"53042","2022","COM","2020","842","11","853","2023-01-02"
"53043","2022","COM","2020","564","11","575","2023-01-02"
"53045","2022","COM","2020","677","19","696","2023-01-02"
"53046","2022","COM","2020","306","3","309","2023-01-02"
"53047","2022","COM","2020","269","4","273","2023-01-02"
"53048","2022","COM","2020","1144","32","1176","2023-01-02"
"53049","2022","COM","2020","708","8","716","2023-01-02"
"53051","2022","COM","2020","607","8","615","2023-01-02"
"53052","2022","COM","2020","285","7","292","2023-01-02"
"53053","2022","COM","2020","500","19","519","2023-01-02"
"53054","2022","COM","2020","6313","162","6475","2023-01-02"
"53055","2022","COM","2020","600","15","615","2023-01-02"
"53056","2022","COM","2020","967","25","992","2023-01-02"
"53057","2022","COM","2020","506","8","514","2023-01-02"
"53058","2022","COM","2020","328","13","341","2023-01-02"
"53059","2022","COM","2020","416","6","422","2023-01-02"
"53061","2022","COM","2020","458","6","464","2023-01-02"
"53062","2022","COM","2020","16845","690","17535","2023-01-02"
"53063","2022","COM","2020","451","15","466","2023-01-02"
"53064","2022","COM","2020","973","25","998","2023-01-02"
"53066","2022","COM","2020","1386","33","1419","2023-01-02"
"53067","2022","COM","2020","407","12","419","2023-01-02"
"53068","2022","COM","2020","150","0","150","2023-01-02"
"53069","2022","COM","2020","154","4","158","2023-01-02"
"53071","2022","COM","2020","484","23","507","2023-01-02"
"53072","2022","COM","2020","1279","28","1307","2023-01-02"
"53073","2022","COM","2020","888","22","910","2023-01-02"
"53074","2022","COM","2020","843","36","879","2023-01-02"
"53075","2022","COM","2020","283","3","286","2023-01-02"
"53076","2022","COM","2020","323","10","333","2023-01-02"
"53077","2022","COM","2020","3229","73","3302","2023-01-02"
"53078","2022","COM","2020","860","18","878","2023-01-02"
"53079","2022","COM","2020","378","8","386","2023-01-02"
"53080","2022","COM","2020","135","1","136","2023-01-02"
"53082","2022","COM","2020","638","13","651","2023-01-02"
"53083","2022","COM","2020","828","28","856","2023-01-02"
"53084","2022","COM","2020","4456","155","4611","2023-01-02"
"53085","2022","COM","2020","195","2","197","2023-01-02"
"53086","2022","COM","2020","635","13","648","2023-01-02"
"53087","2022","COM","2020","208","5","213","2023-01-02"
"53088","2022","COM","2020","827","28","855","2023-01-02"
"53089","2022","COM","2020","513","5","518","2023-01-02"
"53090","2022","COM","2020","164","5","169","2023-01-02"
"53091","2022","COM","2020","447","15","462","2023-01-02"
"53093","2022","COM","2020","278","1","279","2023-01-02"
"53094","2022","COM","2020","2251","40","2291","2023-01-02"
"53096","2022","COM","2020","5641","105","5746","2023-01-02"
"53097","2022","COM","2020","8667","229","8896","2023-01-02"
"53098","2022","COM","2020","427","9","436","2023-01-02"
"53099","2022","COM","2020","1089","33","1122","2023-01-02"
"53100","2022","COM","2020","1167","14","1181","2023-01-02"
"53101","2022","COM","2020","835","11","846","2023-01-02"
"53102","2022","COM","2020","167","1","168","2023-01-02"
"53103","2022","COM","2020","2122","59","2181","2023-01-02"
"53104","2022","COM","2020","1337","29","1366","2023-01-02"
"53105","2022","COM","2020","230","6","236","2023-01-02"
"53106","2022","COM","2020","518","12","530","2023-01-02"
"53107","2022","COM","2020","2543","53","2596","2023-01-02"
"53108","2022","COM","2020","571","6","577","2023-01-02"
"53109","2022","COM","2020","621","17","638","2023-01-02"
"53110","2022","COM","2020","990","19","1009","2023-01-02"
"53111","2022","COM","2020","463","14","477","2023-01-02"
"53112","2022","COM","2020","376","10","386","2023-01-02"
"53113","2022","COM","2020","616","11","627","2023-01-02"
"53114","2022","COM","2020","193","2","195","2023-01-02"
"53115","2022","COM","2020","312","10","322","2023-01-02"
"53116","2022","COM","2020","720","17","737","2023-01-02"
"53117","2022","COM","2020","502","5","507","2023-01-02"
"53118","2022","COM","2020","229","2","231","2023-01-02"
"53119","2022","COM","2020","4415","160","4575","2023-01-02"
"53120","2022","COM","2020","456","10","466","2023-01-02"
"53121","2022","COM","2020","1375","29","1404","2023-01-02"
"53122","2022","COM","2020","758","16","774","2023-01-02"
"53123","2022","COM","2020","1421","25","1446","2023-01-02"
"53124","2022","COM","2020","1389","43","1432","2023-01-02"
"53125","2022","COM","2020","1137","27","1164","2023-01-02"
"53126","2022","COM","2020","1080","23","1103","2023-01-02"
"53127","2022","COM","2020","2239","57","2296","2023-01-02"
"53128","2022","COM","2020","349","11","360","2023-01-02"
"53129","2022","COM","2020","375","10","385","2023-01-02"
"53130","2022","COM","2020","49617","2552","52169","2023-01-02"
"53131","2022","COM","2020","194","2","196","2023-01-02"
"53132","2022","COM","2020","283","11","294","2023-01-02"
"53133","2022","COM","2020","710","17","727","2023-01-02"
"53134","2022","COM","2020","179","1","180","2023-01-02"
"53135","2022","COM","2020","731","23","754","2023-01-02"
"53136","2022","COM","2020","1201","39","1240","2023-01-02"
"53137","2022","COM","2020","2740","52","2792","2023-01-02"
"53139","2022","COM","2020","411","8","419","2023-01-02"
"53140","2022","COM","2020","4365","116","4481","2023-01-02"
"53141","2022","COM","2020","1152","32","1184","2023-01-02"
"53142","2022","COM","2020","291","5","296","2023-01-02"
"53143","2022","COM","2020","514","13","527","2023-01-02"
"53144","2022","COM","2020","755","25","780","2023-01-02"
"53145","2022","COM","2020","544","14","558","2023-01-02"
"53146","2022","COM","2020","1902","36","1938","2023-01-02"
"53147","2022","COM","2020","12805","690","13495","2023-01-02"
"53148","2022","COM","2020","237","1","238","2023-01-02"
"53150","2022","COM","2020","894","29","923","2023-01-02"
"53151","2022","COM","2020","1120","16","1136","2023-01-02"
"53152","2022","COM","2020","2788","74","2862","2023-01-02"
"53153","2022","COM","2020","629","11","640","2023-01-02"
"53154","2022","COM","2020","903","21","924","2023-01-02"
"53155","2022","COM","2020","1347","23","1370","2023-01-02"
"53156","2022","COM","2020","252","7","259","2023-01-02"
"53157","2022","COM","2020","1337","55","1392","2023-01-02"
"53158","2022","COM","2020","1036","13","1049","2023-01-02"
"53160","2022","COM","2020","375","7","382","2023-01-02"
"53161","2022","COM","2020","3191","59","3250","2023-01-02"
"53162","2022","COM","2020","986","18","1004","2023-01-02"
"53163","2022","COM","2020","779","4","783","2023-01-02"
"53164","2022","COM","2020","345","8","353","2023-01-02"
"53165","2022","COM","2020","353","7","360","2023-01-02"
"53168","2022","COM","2020","1220","26","1246","2023-01-02"
"53169","2022","COM","2020","412","9","421","2023-01-02"
"53170","2022","COM","2020","1151","22","1173","2023-01-02"
"53172","2022","COM","2020","402","8","410","2023-01-02"
"53173","2022","COM","2020","180","6","186","2023-01-02"
"53174","2022","COM","2020","836","24","860","2023-01-02"
"53175","2022","COM","2020","1383","48","1431","2023-01-02"
"53176","2022","COM","2020","539","8","547","2023-01-02"
"53177","2022","COM","2020","302","6","308","2023-01-02"
"53178","2022","COM","2020","231","10","241","2023-01-02"
"53179","2022","COM","2020","352","5","357","2023-01-02"
"53180","2022","COM","2020","642","24","666","2023-01-02"
"53181","2022","COM","2020","806","10","816","2023-01-02"
"53182","2022","COM","2020","1795","28","1823","2023-01-02"
"53184","2022","COM","2020","163","5","168","2023-01-02"
"53185","2022","COM","2020","2295","84","2379","2023-01-02"
"53186","2022","COM","2020","2131","61","2192","2023-01-02"
"53187","2022","COM","2020","228","13","241","2023-01-02"
"53188","2022","COM","2020","2521","59","2580","2023-01-02"
"53189","2022","COM","2020","106","0","106","2023-01-02"
"53190","2022","COM","2020","468","10","478","2023-01-02"
"53191","2022","COM","2020","251","2","253","2023-01-02"
"53192","2022","COM","2020","315","5","320","2023-01-02"
"53193","2022","COM","2020","565","11","576","2023-01-02"
"53195","2022","COM","2020","509","10","519","2023-01-02"
"53196","2022","COM","2020","351","12","363","2023-01-02"
"53197","2022","COM","2020","903","23","926","2023-01-02"
"53198","2022","COM","2020","227","7","234","2023-01-02"
"53199","2022","COM","2020","216","4","220","2023-01-02"
"53200","2022","COM","2020","1159","57","1216","2023-01-02"
"53201","2022","COM","2020","7381","259","7640","2023-01-02"
"53202","2022","COM","2020","303","4","307","2023-01-02"
"53203","2022","COM","2020","526","13","539","2023-01-02"
"53204","2022","COM","2020","388","12","400","2023-01-02"
"53206","2022","COM","2020","196","10","206","2023-01-02"
"53208","2022","COM","2020","497","14","511","2023-01-02"
"53209","2022","COM","2020","557","14","571","2023-01-02"
"53210","2022","COM","2020","1545","30","1575","2023-01-02"
"53211","2022","COM","2020","1429","32","1461","2023-01-02"
"53212","2022","COM","2020","437","8","445","2023-01-02"
"53213","2022","COM","2020","490","9","499","2023-01-02"
"53214","2022","COM","2020","163","4","167","2023-01-02"
"53216","2022","COM","2020","987","25","1012","2023-01-02"
"53218","2022","COM","2020","791","25","816","2023-01-02"
"53219","2022","COM","2020","1396","38","1434","2023-01-02"
"53220","2022","COM","2020","380","8","388","2023-01-02"
"53221","2022","COM","2020","396","9","405","2023-01-02"
"53222","2022","COM","2020","365","8","373","2023-01-02"
"53223","2022","COM","2020","328","9","337","2023-01-02"
"53224","2022","COM","2020","1186","31","1217","2023-01-02"
"53225","2022","COM","2020","517","9","526","2023-01-02"
"53226","2022","COM","2020","817","31","848","2023-01-02"
"53228","2022","COM","2020","561","13","574","2023-01-02"
"53229","2022","COM","2020","1650","47","1697","2023-01-02"
"53230","2022","COM","2020","235","6","241","2023-01-02"
"53232","2022","COM","2020","312","3","315","2023-01-02"
"53233","2022","COM","2020","339","2","341","2023-01-02"
"53234","2022","COM","2020","353","8","361","2023-01-02"
"53235","2022","COM","2020","228","4","232","2023-01-02"
"53236","2022","COM","2020","170","1","171","2023-01-02"
"53237","2022","COM","2020","452","12","464","2023-01-02"
"53238","2022","COM","2020","519","9","528","2023-01-02"
"53240","2022","COM","2020","434","6","440","2023-01-02"
"53242","2022","COM","2020","258","3","261","2023-01-02"
"53243","2022","COM","2020","1782","39","1821","2023-01-02"
"53245","2022","COM","2020","923","23","946","2023-01-02"
"53246","2022","COM","2020","1785","35","1820","2023-01-02"
"53247","2022","COM","2020","2298","48","2346","2023-01-02"
"53248","2022","COM","2020","140","3","143","2023-01-02"
"53249","2022","COM","2020","1120","13","1133","2023-01-02"
"53250","2022","COM","2020","407","5","412","2023-01-02"
"53251","2022","COM","2020","466","8","474","2023-01-02"
"53253","2022","COM","2020","519","4","523","2023-01-02"
"53255","2022","COM","2020","1251","16","1267","2023-01-02"
"53256","2022","COM","2020","169","4","173","2023-01-02"
"53257","2022","COM","2020","316","8","324","2023-01-02"
"53258","2022","COM","2020","908","27","935","2023-01-02"
"53259","2022","COM","2020","345","7","352","2023-01-02"
"53260","2022","COM","2020","397","1","398","2023-01-02"
"53261","2022","COM","2020","168","3","171","2023-01-02"
"53262","2022","COM","2020","1093","31","1124","2023-01-02"
"53263","2022","COM","2020","274","8","282","2023-01-02"
"53264","2022","COM","2020","191","3","194","2023-01-02"
"53265","2022","COM","2020","767","15","782","2023-01-02"
"53266","2022","COM","2020","226","4","230","2023-01-02"
"53267","2022","COM","2020","1165","32","1197","2023-01-02"
"53269","2022","COM","2020","613","5","618","2023-01-02"
"53270","2022","COM","2020","108","9","117","2023-01-02"
"53271","2022","COM","2020","2713","42","2755","2023-01-02"
"53272","2022","COM","2020","188","1","189","2023-01-02"
"53273","2022","COM","2020","1083","22","1105","2023-01-02"
"53276","2022","COM","2020","930","16","946","2023-01-02"
"54001","2022","COM","2020","306","5","311","2023-01-02"
"54002","2022","COM","2020","229","4","233","2023-01-02"
"54003","2022","COM","2020","92","5","97","2023-01-02"
"54004","2022","COM","2020","178","2","180","2023-01-02"
"54005","2022","COM","2020","110","1","111","2023-01-02"
"54006","2022","COM","2020","445","7","452","2023-01-02"
"54007","2022","COM","2020","531","4","535","2023-01-02"
"54008","2022","COM","2020","470","13","483","2023-01-02"
"54009","2022","COM","2020","166","3","169","2023-01-02"
"54010","2022","COM","2020","500","12","512","2023-01-02"
"54011","2022","COM","2020","647","10","657","2023-01-02"
"54012","2022","COM","2020","354","5","359","2023-01-02"
"54013","2022","COM","2020","86","2","88","2023-01-02"
"54014","2022","COM","2020","255","14","269","2023-01-02"
"54015","2022","COM","2020","258","6","264","2023-01-02"
"54016","2022","COM","2020","287","8","295","2023-01-02"
"54017","2022","COM","2020","75","1","76","2023-01-02"
"54018","2022","COM","2020","273","7","280","2023-01-02"
"54019","2022","COM","2020","78","1","79","2023-01-02"
"54020","2022","COM","2020","447","8","455","2023-01-02"
"54021","2022","COM","2020","233","1","234","2023-01-02"
"54022","2022","COM","2020","563","11","574","2023-01-02"
"54023","2022","COM","2020","248","2","250","2023-01-02"
"54024","2022","COM","2020","363","6","369","2023-01-02"
"54025","2022","COM","2020","1620","208","1828","2023-01-02"
"54026","2022","COM","2020","176","3","179","2023-01-02"
"54027","2022","COM","2020","878","13","891","2023-01-02"
"54028","2022","COM","2020","2669","19","2688","2023-01-02"
"54029","2022","COM","2020","2465","47","2512","2023-01-02"
"54030","2022","COM","2020","81","0","81","2023-01-02"
"54031","2022","COM","2020","260","4","264","2023-01-02"
"54032","2022","COM","2020","188","4","192","2023-01-02"
"54033","2022","COM","2020","134","0","134","2023-01-02"
"54034","2022","COM","2020","215","4","219","2023-01-02"
"54035","2022","COM","2020","388","4","392","2023-01-02"
"54036","2022","COM","2020","1174","29","1203","2023-01-02"
"54037","2022","COM","2020","424","4","428","2023-01-02"
"54038","2022","COM","2020","750","18","768","2023-01-02"
"54039","2022","COM","2020","4160","61","4221","2023-01-02"
"54040","2022","COM","2020","1559","32","1591","2023-01-02"
"54041","2022","COM","2020","138","7","145","2023-01-02"
"54042","2022","COM","2020","279","2","281","2023-01-02"
"54043","2022","COM","2020","1442","17","1459","2023-01-02"
"54044","2022","COM","2020","197","2","199","2023-01-02"
"54045","2022","COM","2020","427","8","435","2023-01-02"
"54046","2022","COM","2020","394","7","401","2023-01-02"
"54047","2022","COM","2020","260","5","265","2023-01-02"
"54048","2022","COM","2020","344","3","347","2023-01-02"
"54049","2022","COM","2020","529","14","543","2023-01-02"
"54050","2022","COM","2020","66","0","66","2023-01-02"
"54051","2022","COM","2020","1284","28","1312","2023-01-02"
"54052","2022","COM","2020","149","2","151","2023-01-02"
"54053","2022","COM","2020","156","6","162","2023-01-02"
"54054","2022","COM","2020","1530","18","1548","2023-01-02"
"54055","2022","COM","2020","330","4","334","2023-01-02"
"54056","2022","COM","2020","144","3","147","2023-01-02"
"54057","2022","COM","2020","73","1","74","2023-01-02"
"54058","2022","COM","2020","87","0","87","2023-01-02"
"54059","2022","COM","2020","752","10","762","2023-01-02"
"54060","2022","COM","2020","1484","19","1503","2023-01-02"
"54061","2022","COM","2020","586","10","596","2023-01-02"
"54062","2022","COM","2020","652","10","662","2023-01-02"
"54063","2022","COM","2020","174","4","178","2023-01-02"
"54064","2022","COM","2020","318","5","323","2023-01-02"
"54065","2022","COM","2020","1086","19","1105","2023-01-02"
"54066","2022","COM","2020","410","2","412","2023-01-02"
"54067","2022","COM","2020","765","17","782","2023-01-02"
"54068","2022","COM","2020","92","3","95","2023-01-02"
"54069","2022","COM","2020","471","9","480","2023-01-02"
"54070","2022","COM","2020","179","0","179","2023-01-02"
"54071","2022","COM","2020","161","1","162","2023-01-02"
"54072","2022","COM","2020","262","5","267","2023-01-02"
"54073","2022","COM","2020","923","16","939","2023-01-02"
"54074","2022","COM","2020","37","0","37","2023-01-02"
"54075","2022","COM","2020","119","2","121","2023-01-02"
"54076","2022","COM","2020","3944","47","3991","2023-01-02"
"54077","2022","COM","2020","1053","12","1065","2023-01-02"
"54078","2022","COM","2020","56","1","57","2023-01-02"
"54079","2022","COM","2020","4642","27","4669","2023-01-02"
"54080","2022","COM","2020","1031","17","1048","2023-01-02"
"54081","2022","COM","2020","419","6","425","2023-01-02"
"54082","2022","COM","2020","169","3","172","2023-01-02"
"54083","2022","COM","2020","175","3","178","2023-01-02"
"54084","2022","COM","2020","943","15","958","2023-01-02"
"54085","2022","COM","2020","88","2","90","2023-01-02"
"54086","2022","COM","2020","354","10","364","2023-01-02"
"54087","2022","COM","2020","149","0","149","2023-01-02"
"54088","2022","COM","2020","242","2","244","2023-01-02"
"54089","2022","COM","2020","1406","20","1426","2023-01-02"
"54090","2022","COM","2020","4147","43","4190","2023-01-02"
"54091","2022","COM","2020","400","4","404","2023-01-02"
"54092","2022","COM","2020","65","1","66","2023-01-02"
"54093","2022","COM","2020","170","2","172","2023-01-02"
"54094","2022","COM","2020","171","3","174","2023-01-02"
"54095","2022","COM","2020","46","0","46","2023-01-02"
"54096","2022","COM","2020","438","9","447","2023-01-02"
"54097","2022","COM","2020","98","3","101","2023-01-02"
"54098","2022","COM","2020","167","3","170","2023-01-02"
"54099","2022","COM","2020","8041","228","8269","2023-01-02"
"54100","2022","COM","2020","776","12","788","2023-01-02"
"54101","2022","COM","2020","128","1","129","2023-01-02"
"54102","2022","COM","2020","609","16","625","2023-01-02"
"54103","2022","COM","2020","222","2","224","2023-01-02"
"54104","2022","COM","2020","257","2","259","2023-01-02"
"54105","2022","COM","2020","525","15","540","2023-01-02"
"54106","2022","COM","2020","63","1","64","2023-01-02"
"54107","2022","COM","2020","74","4","78","2023-01-02"
"54108","2022","COM","2020","144","6","150","2023-01-02"
"54109","2022","COM","2020","931","13","944","2023-01-02"
"54110","2022","COM","2020","560","12","572","2023-01-02"
"54111","2022","COM","2020","2803","18","2821","2023-01-02"
"54112","2022","COM","2020","718","8","726","2023-01-02"
"54113","2022","COM","2020","1528","16","1544","2023-01-02"
"54114","2022","COM","2020","326","5","331","2023-01-02"
"54115","2022","COM","2020","6633","60","6693","2023-01-02"
"54116","2022","COM","2020","2148","39","2187","2023-01-02"
"54117","2022","COM","2020","116","3","119","2023-01-02"
"54118","2022","COM","2020","605","10","615","2023-01-02"
"54119","2022","COM","2020","89","2","91","2023-01-02"
"54120","2022","COM","2020","328","7","335","2023-01-02"
"54121","2022","COM","2020","190","3","193","2023-01-02"
"54122","2022","COM","2020","726","17","743","2023-01-02"
"54123","2022","COM","2020","1719","12","1731","2023-01-02"
"54124","2022","COM","2020","46","3","49","2023-01-02"
"54125","2022","COM","2020","489","7","496","2023-01-02"
"54126","2022","COM","2020","223","1","224","2023-01-02"
"54127","2022","COM","2020","621","21","642","2023-01-02"
"54128","2022","COM","2020","708","8","716","2023-01-02"
"54129","2022","COM","2020","1600","25","1625","2023-01-02"
"54130","2022","COM","2020","179","1","180","2023-01-02"
"54131","2022","COM","2020","496","10","506","2023-01-02"
"54132","2022","COM","2020","59","1","60","2023-01-02"
"54133","2022","COM","2020","117","4","121","2023-01-02"
"54134","2022","COM","2020","242","7","249","2023-01-02"
"54135","2022","COM","2020","1443","20","1463","2023-01-02"
"54136","2022","COM","2020","2377","33","2410","2023-01-02"
"54137","2022","COM","2020","513","15","528","2023-01-02"
"54138","2022","COM","2020","2773","56","2829","2023-01-02"
"54139","2022","COM","2020","373","5","378","2023-01-02"
"54140","2022","COM","2020","92","0","92","2023-01-02"
"54141","2022","COM","2020","153","2","155","2023-01-02"
"54142","2022","COM","2020","154","3","157","2023-01-02"
"54143","2022","COM","2020","385","6","391","2023-01-02"
"54144","2022","COM","2020","382","6","388","2023-01-02"
"54145","2022","COM","2020","939","12","951","2023-01-02"
"54146","2022","COM","2020","292","3","295","2023-01-02"
"54147","2022","COM","2020","108","2","110","2023-01-02"
"54148","2022","COM","2020","645","9","654","2023-01-02"
"54149","2022","COM","2020","1565","23","1588","2023-01-02"
"54150","2022","COM","2020","3106","30","3136","2023-01-02"
"54151","2022","COM","2020","1051","28","1079","2023-01-02"
"54152","2022","COM","2020","3124","41","3165","2023-01-02"
"54153","2022","COM","2020","56","2","58","2023-01-02"
"54154","2022","COM","2020","476","21","497","2023-01-02"
"54155","2022","COM","2020","402","8","410","2023-01-02"
"54156","2022","COM","2020","484","16","500","2023-01-02"
"54157","2022","COM","2020","4712","38","4750","2023-01-02"
"54158","2022","COM","2020","141","2","143","2023-01-02"
"54159","2022","COM","2020","9733","190","9923","2023-01-02"
"54160","2022","COM","2020","404","8","412","2023-01-02"
"54161","2022","COM","2020","314","10","324","2023-01-02"
"54162","2022","COM","2020","1158","17","1175","2023-01-02"
"54163","2022","COM","2020","260","1","261","2023-01-02"
"54164","2022","COM","2020","88","2","90","2023-01-02"
"54165","2022","COM","2020","572","11","583","2023-01-02"
"54166","2022","COM","2020","30","2","32","2023-01-02"
"54167","2022","COM","2020","1943","43","1986","2023-01-02"
"54168","2022","COM","2020","302","2","304","2023-01-02"
"54169","2022","COM","2020","97","3","100","2023-01-02"
"54170","2022","COM","2020","72","1","73","2023-01-02"
"54171","2022","COM","2020","1141","20","1161","2023-01-02"
"54172","2022","COM","2020","288","6","294","2023-01-02"
"54173","2022","COM","2020","218","4","222","2023-01-02"
"54174","2022","COM","2020","4454","58","4512","2023-01-02"
"54175","2022","COM","2020","373","3","376","2023-01-02"
"54176","2022","COM","2020","1098","24","1122","2023-01-02"
"54177","2022","COM","2020","254","3","257","2023-01-02"
"54178","2022","COM","2020","198","3","201","2023-01-02"
"54179","2022","COM","2020","303","4","307","2023-01-02"
"54180","2022","COM","2020","70","2","72","2023-01-02"
"54181","2022","COM","2020","690","17","707","2023-01-02"
"54182","2022","COM","2020","324","11","335","2023-01-02"
"54183","2022","COM","2020","74","0","74","2023-01-02"
"54184","2022","COM","2020","8841","196","9037","2023-01-02"
"54185","2022","COM","2020","59","1","60","2023-01-02"
"54186","2022","COM","2020","1109","21","1130","2023-01-02"
"54187","2022","COM","2020","111","0","111","2023-01-02"
"54188","2022","COM","2020","1365","10","1375","2023-01-02"
"54189","2022","COM","2020","600","7","607","2023-01-02"
"54190","2022","COM","2020","111","3","114","2023-01-02"
"54191","2022","COM","2020","102","2","104","2023-01-02"
"54192","2022","COM","2020","313","4","317","2023-01-02"
"54193","2022","COM","2020","71","2","73","2023-01-02"
"54194","2022","COM","2020","510","9","519","2023-01-02"
"54195","2022","COM","2020","189","4","193","2023-01-02"
"54196","2022","COM","2020","1724","108","1832","2023-01-02"
"54197","2022","COM","2020","2205","21","2226","2023-01-02"
"54198","2022","COM","2020","303","4","307","2023-01-02"
"54199","2022","COM","2020","384","10","394","2023-01-02"
"54200","2022","COM","2020","160","1","161","2023-01-02"
"54201","2022","COM","2020","306","3","309","2023-01-02"
"54202","2022","COM","2020","373","10","383","2023-01-02"
"54203","2022","COM","2020","140","3","143","2023-01-02"
"54204","2022","COM","2020","92","2","94","2023-01-02"
"54205","2022","COM","2020","2619","29","2648","2023-01-02"
"54206","2022","COM","2020","394","5","399","2023-01-02"
"54207","2022","COM","2020","95","6","101","2023-01-02"
"54208","2022","COM","2020","289","5","294","2023-01-02"
"54209","2022","COM","2020","64","0","64","2023-01-02"
"54210","2022","COM","2020","215","2","217","2023-01-02"
"54211","2022","COM","2020","196","3","199","2023-01-02"
"54212","2022","COM","2020","411","13","424","2023-01-02"
"54213","2022","COM","2020","371","5","376","2023-01-02"
"54214","2022","COM","2020","705","9","714","2023-01-02"
"54215","2022","COM","2020","6543","67","6610","2023-01-02"
"54216","2022","COM","2020","124","0","124","2023-01-02"
"54217","2022","COM","2020","170","2","172","2023-01-02"
"54218","2022","COM","2020","53","1","54","2023-01-02"
"54219","2022","COM","2020","82","0","82","2023-01-02"
"54220","2022","COM","2020","77","0","77","2023-01-02"
"54221","2022","COM","2020","230","1","231","2023-01-02"
"54222","2022","COM","2020","1330","23","1353","2023-01-02"
"54223","2022","COM","2020","208","1","209","2023-01-02"
"54224","2022","COM","2020","123","1","124","2023-01-02"
"54225","2022","COM","2020","180","3","183","2023-01-02"
"54226","2022","COM","2020","172","2","174","2023-01-02"
"54227","2022","COM","2020","1349","16","1365","2023-01-02"
"54228","2022","COM","2020","70","3","73","2023-01-02"
"54229","2022","COM","2020","367","6","373","2023-01-02"
"54230","2022","COM","2020","52","0","52","2023-01-02"
"54231","2022","COM","2020","179","3","182","2023-01-02"
"54232","2022","COM","2020","2672","50","2722","2023-01-02"
"54233","2022","COM","2020","34","2","36","2023-01-02"
"54234","2022","COM","2020","2907","43","2950","2023-01-02"
"54235","2022","COM","2020","420","9","429","2023-01-02"
"54236","2022","COM","2020","360","8","368","2023-01-02"
"54237","2022","COM","2020","95","1","96","2023-01-02"
"54238","2022","COM","2020","268","1","269","2023-01-02"
"54239","2022","COM","2020","141","1","142","2023-01-02"
"54240","2022","COM","2020","54","0","54","2023-01-02"
"54241","2022","COM","2020","75","3","78","2023-01-02"
"54242","2022","COM","2020","274","3","277","2023-01-02"
"54243","2022","COM","2020","217","7","224","2023-01-02"
"54244","2022","COM","2020","110","3","113","2023-01-02"
"54245","2022","COM","2020","62","0","62","2023-01-02"
"54246","2022","COM","2020","65","6","71","2023-01-02"
"54247","2022","COM","2020","178","4","182","2023-01-02"
"54248","2022","COM","2020","100","0","100","2023-01-02"
"54249","2022","COM","2020","253","3","256","2023-01-02"
"54250","2022","COM","2020","736","6","742","2023-01-02"
"54251","2022","COM","2020","129","1","130","2023-01-02"
"54252","2022","COM","2020","507","6","513","2023-01-02"
"54253","2022","COM","2020","775","12","787","2023-01-02"
"54254","2022","COM","2020","3416","42","3458","2023-01-02"
"54255","2022","COM","2020","83","6","89","2023-01-02"
"54256","2022","COM","2020","307","8","315","2023-01-02"
"54257","2022","COM","2020","5346","82","5428","2023-01-02"
"54258","2022","COM","2020","146","2","148","2023-01-02"
"54259","2022","COM","2020","231","3","234","2023-01-02"
"54260","2022","COM","2020","937","15","952","2023-01-02"
"54261","2022","COM","2020","4330","56","4386","2023-01-02"
"54262","2022","COM","2020","196","0","196","2023-01-02"
"54263","2022","COM","2020","6245","57","6302","2023-01-02"
"54264","2022","COM","2020","320","0","320","2023-01-02"
"54265","2022","COM","2020","2091","40","2131","2023-01-02"
"54266","2022","COM","2020","404","10","414","2023-01-02"
"54268","2022","COM","2020","138","4","142","2023-01-02"
"54269","2022","COM","2020","345","7","352","2023-01-02"
"54270","2022","COM","2020","3860","65","3925","2023-01-02"
"54271","2022","COM","2020","121","6","127","2023-01-02"
"54272","2022","COM","2020","464","3","467","2023-01-02"
"54273","2022","COM","2020","8190","179","8369","2023-01-02"
"54274","2022","COM","2020","9396","224","9620","2023-01-02"
"54275","2022","COM","2020","184","6","190","2023-01-02"
"54276","2022","COM","2020","787","7","794","2023-01-02"
"54277","2022","COM","2020","372","2","374","2023-01-02"
"54278","2022","COM","2020","101","1","102","2023-01-02"
"54279","2022","COM","2020","990","20","1010","2023-01-02"
"54280","2022","COM","2020","6583","53","6636","2023-01-02"
"54281","2022","COM","2020","894","16","910","2023-01-02"
"54282","2022","COM","2020","161","4","165","2023-01-02"
"54283","2022","COM","2020","286","6","292","2023-01-02"
"54284","2022","COM","2020","1121","21","1142","2023-01-02"
"54285","2022","COM","2020","55","1","56","2023-01-02"
"54286","2022","COM","2020","1580","32","1612","2023-01-02"
"54287","2022","COM","2020","268","1","269","2023-01-02"
"54288","2022","COM","2020","495","4","499","2023-01-02"
"54289","2022","COM","2020","362","10","372","2023-01-02"
"54290","2022","COM","2020","210","4","214","2023-01-02"
"54291","2022","COM","2020","294","2","296","2023-01-02"
"54292","2022","COM","2020","184","3","187","2023-01-02"
"54293","2022","COM","2020","84","4","88","2023-01-02"
"54294","2022","COM","2020","144","2","146","2023-01-02"
"54295","2022","COM","2020","971","110","1081","2023-01-02"
"54296","2022","COM","2020","432","3","435","2023-01-02"
"54297","2022","COM","2020","304","3","307","2023-01-02"
"54298","2022","COM","2020","155","1","156","2023-01-02"
"54299","2022","COM","2020","227","6","233","2023-01-02"
"54300","2022","COM","2020","6548","109","6657","2023-01-02"
"54301","2022","COM","2020","127","1","128","2023-01-02"
"54302","2022","COM","2020","737","17","754","2023-01-02"
"54303","2022","COM","2020","366","3","369","2023-01-02"
"54304","2022","COM","2020","14445","186","14631","2023-01-02"
"54305","2022","COM","2020","2380","48","2428","2023-01-02"
"54306","2022","COM","2020","339","5","344","2023-01-02"
"54307","2022","COM","2020","167","4","171","2023-01-02"
"54308","2022","COM","2020","147","3","150","2023-01-02"
"54309","2022","COM","2020","393","3","396","2023-01-02"
"54310","2022","COM","2020","3","0","3","2023-01-02"
"54311","2022","COM","2020","593","8","601","2023-01-02"
"54312","2022","COM","2020","487","4","491","2023-01-02"
"54313","2022","COM","2020","231","1","232","2023-01-02"
"54314","2022","COM","2020","3845","61","3906","2023-01-02"
"54315","2022","COM","2020","905","11","916","2023-01-02"
"54316","2022","COM","2020","303","5","308","2023-01-02"
"54317","2022","COM","2020","132","6","138","2023-01-02"
"54318","2022","COM","2020","5749","70","5819","2023-01-02"
"54320","2022","COM","2020","325","4","329","2023-01-02"
"54321","2022","COM","2020","2367","27","2394","2023-01-02"
"54322","2022","COM","2020","5223","62","5285","2023-01-02"
"54323","2022","COM","2020","15117","240","15357","2023-01-02"
"54324","2022","COM","2020","87","1","88","2023-01-02"
"54325","2022","COM","2020","79","8","87","2023-01-02"
"54326","2022","COM","2020","219","10","229","2023-01-02"
"54327","2022","COM","2020","628","14","642","2023-01-02"
"54328","2022","COM","2020","6128","91","6219","2023-01-02"
"54329","2022","COM","2020","17858","302","18160","2023-01-02"
"54330","2022","COM","2020","423","9","432","2023-01-02"
"54331","2022","COM","2020","279","6","285","2023-01-02"
"54332","2022","COM","2020","1530","16","1546","2023-01-02"
"54333","2022","COM","2020","250","14","264","2023-01-02"
"54334","2022","COM","2020","560","11","571","2023-01-02"
"54335","2022","COM","2020","408","4","412","2023-01-02"
"54336","2022","COM","2020","915","11","926","2023-01-02"
"54337","2022","COM","2020","129","3","132","2023-01-02"
"54338","2022","COM","2020","992","13","1005","2023-01-02"
"54339","2022","COM","2020","8036","294","8330","2023-01-02"
"54340","2022","COM","2020","340","4","344","2023-01-02"
"54343","2022","COM","2020","188","6","194","2023-01-02"
"54344","2022","COM","2020","215","4","219","2023-01-02"
"54345","2022","COM","2020","341","5","346","2023-01-02"
"54346","2022","COM","2020","249","3","252","2023-01-02"
"54348","2022","COM","2020","237","9","246","2023-01-02"
"54349","2022","COM","2020","166","2","168","2023-01-02"
"54350","2022","COM","2020","700","8","708","2023-01-02"
"54351","2022","COM","2020","1685","15","1700","2023-01-02"
"54352","2022","COM","2020","824","9","833","2023-01-02"
"54353","2022","COM","2020","901","15","916","2023-01-02"
"54354","2022","COM","2020","48","0","48","2023-01-02"
"54355","2022","COM","2020","92","1","93","2023-01-02"
"54356","2022","COM","2020","67","2","69","2023-01-02"
"54357","2022","COM","2020","9816","115","9931","2023-01-02"
"54358","2022","COM","2020","279","5","284","2023-01-02"
"54359","2022","COM","2020","244","3","247","2023-01-02"
"54360","2022","COM","2020","337","8","345","2023-01-02"
"54362","2022","COM","2020","1282","7","1289","2023-01-02"
"54363","2022","COM","2020","274","6","280","2023-01-02"
"54364","2022","COM","2020","1288","19","1307","2023-01-02"
"54365","2022","COM","2020","325","10","335","2023-01-02"
"54366","2022","COM","2020","1982","18","2000","2023-01-02"
"54367","2022","COM","2020","2265","66","2331","2023-01-02"
"54368","2022","COM","2020","174","3","177","2023-01-02"
"54369","2022","COM","2020","611","8","619","2023-01-02"
"54370","2022","COM","2020","225","2","227","2023-01-02"
"54371","2022","COM","2020","1065","20","1085","2023-01-02"
"54372","2022","COM","2020","516","3","519","2023-01-02"
"54373","2022","COM","2020","611","4","615","2023-01-02"
"54374","2022","COM","2020","521","9","530","2023-01-02"
"54375","2022","COM","2020","1087","16","1103","2023-01-02"
"54376","2022","COM","2020","407","7","414","2023-01-02"
"54377","2022","COM","2020","160","0","160","2023-01-02"
"54378","2022","COM","2020","470","7","477","2023-01-02"
"54379","2022","COM","2020","96","0","96","2023-01-02"
"54380","2022","COM","2020","403","10","413","2023-01-02"
"54381","2022","COM","2020","54","2","56","2023-01-02"
"54382","2022","COM","2020","9020","110","9130","2023-01-02"
"54383","2022","COM","2020","1122","11","1133","2023-01-02"
"54385","2022","COM","2020","1081","24","1105","2023-01-02"
"54386","2022","COM","2020","93","1","94","2023-01-02"
"54387","2022","COM","2020","153","0","153","2023-01-02"
"54388","2022","COM","2020","74","2","76","2023-01-02"
"54389","2022","COM","2020","101","2","103","2023-01-02"
"54390","2022","COM","2020","101","2","103","2023-01-02"
"54391","2022","COM","2020","1568","25","1593","2023-01-02"
"54392","2022","COM","2020","312","2","314","2023-01-02"
"54393","2022","COM","2020","533","9","542","2023-01-02"
"54394","2022","COM","2020","246","5","251","2023-01-02"
"54395","2022","COM","2020","104403","1482","105885","2023-01-02"
"54396","2022","COM","2020","224","8","232","2023-01-02"
"54397","2022","COM","2020","6629","55","6684","2023-01-02"
"54398","2022","COM","2020","97","1","98","2023-01-02"
"54399","2022","COM","2020","250","1","251","2023-01-02"
"54400","2022","COM","2020","1139","22","1161","2023-01-02"
"54401","2022","COM","2020","121","5","126","2023-01-02"
"54402","2022","COM","2020","413","11","424","2023-01-02"
"54403","2022","COM","2020","1188","35","1223","2023-01-02"
"54404","2022","COM","2020","267","5","272","2023-01-02"
"54405","2022","COM","2020","524","0","524","2023-01-02"
"54406","2022","COM","2020","278","7","285","2023-01-02"
"54407","2022","COM","2020","95","3","98","2023-01-02"
"54408","2022","COM","2020","228","3","231","2023-01-02"
"54409","2022","COM","2020","190","3","193","2023-01-02"
"54410","2022","COM","2020","516","3","519","2023-01-02"
"54411","2022","COM","2020","219","6","225","2023-01-02"
"54412","2022","COM","2020","39","3","42","2023-01-02"
"54413","2022","COM","2020","151","1","152","2023-01-02"
"54414","2022","COM","2020","653","8","661","2023-01-02"
"54415","2022","COM","2020","4053","56","4109","2023-01-02"
"54416","2022","COM","2020","179","1","180","2023-01-02"
"54417","2022","COM","2020","239","6","245","2023-01-02"
"54418","2022","COM","2020","171","1","172","2023-01-02"
"54419","2022","COM","2020","74","0","74","2023-01-02"
"54420","2022","COM","2020","87","1","88","2023-01-02"
"54421","2022","COM","2020","313","5","318","2023-01-02"
"54422","2022","COM","2020","69","1","70","2023-01-02"
"54423","2022","COM","2020","339","10","349","2023-01-02"
"54424","2022","COM","2020","44","1","45","2023-01-02"
"54425","2022","COM","2020","2476","20","2496","2023-01-02"
"54426","2022","COM","2020","474","6","480","2023-01-02"
"54427","2022","COM","2020","95","1","96","2023-01-02"
"54428","2022","COM","2020","851","11","862","2023-01-02"
"54429","2022","COM","2020","297","2","299","2023-01-02"
"54430","2022","COM","2020","4857","51","4908","2023-01-02"
"54431","2022","COM","2020","14357","193","14550","2023-01-02"
"54432","2022","COM","2020","1813","39","1852","2023-01-02"
"54433","2022","COM","2020","228","7","235","2023-01-02"
"54434","2022","COM","2020","250","2","252","2023-01-02"
"54435","2022","COM","2020","365","5","370","2023-01-02"
"54436","2022","COM","2020","152","4","156","2023-01-02"
"54437","2022","COM","2020","1149","19","1168","2023-01-02"
"54438","2022","COM","2020","55","0","55","2023-01-02"
"54439","2022","COM","2020","5135","65","5200","2023-01-02"
"54440","2022","COM","2020","122","0","122","2023-01-02"
"54441","2022","COM","2020","231","5","236","2023-01-02"
"54442","2022","COM","2020","96","2","98","2023-01-02"
"54443","2022","COM","2020","38","0","38","2023-01-02"
"54444","2022","COM","2020","224","3","227","2023-01-02"
"54445","2022","COM","2020","101","0","101","2023-01-02"
"54446","2022","COM","2020","64","2","66","2023-01-02"
"54447","2022","COM","2020","74","3","77","2023-01-02"
"54449","2022","COM","2020","1049","16","1065","2023-01-02"
"54450","2022","COM","2020","144","1","145","2023-01-02"
"54451","2022","COM","2020","3799","73","3872","2023-01-02"
"54452","2022","COM","2020","73","2","75","2023-01-02"
"54453","2022","COM","2020","159","1","160","2023-01-02"
"54455","2022","COM","2020","156","4","160","2023-01-02"
"54456","2022","COM","2020","604","10","614","2023-01-02"
"54457","2022","COM","2020","43","0","43","2023-01-02"
"54458","2022","COM","2020","109","1","110","2023-01-02"
"54459","2022","COM","2020","2308","25","2333","2023-01-02"
"54460","2022","COM","2020","151","3","154","2023-01-02"
"54461","2022","COM","2020","69","2","71","2023-01-02"
"54462","2022","COM","2020","2851","34","2885","2023-01-02"
"54463","2022","COM","2020","229","2","231","2023-01-02"
"54464","2022","COM","2020","106","0","106","2023-01-02"
"54465","2022","COM","2020","761","11","772","2023-01-02"
"54466","2022","COM","2020","402","5","407","2023-01-02"
"54467","2022","COM","2020","188","3","191","2023-01-02"
"54468","2022","COM","2020","111","2","113","2023-01-02"
"54469","2022","COM","2020","414","5","419","2023-01-02"
"54470","2022","COM","2020","75","2","77","2023-01-02"
"54471","2022","COM","2020","72","1","73","2023-01-02"
"54472","2022","COM","2020","853","12","865","2023-01-02"
"54473","2022","COM","2020","285","6","291","2023-01-02"
"54474","2022","COM","2020","198","0","198","2023-01-02"
"54475","2022","COM","2020","154","6","160","2023-01-02"
"54476","2022","COM","2020","414","10","424","2023-01-02"
"54477","2022","COM","2020","162","3","165","2023-01-02"
"54478","2022","COM","2020","150","1","151","2023-01-02"
"54479","2022","COM","2020","99","1","100","2023-01-02"
"54480","2022","COM","2020","56","1","57","2023-01-02"
"54481","2022","COM","2020","98","3","101","2023-01-02"
"54482","2022","COM","2020","10046","93","10139","2023-01-02"
"54483","2022","COM","2020","7383","69","7452","2023-01-02"
"54484","2022","COM","2020","183","7","190","2023-01-02"
"54485","2022","COM","2020","309","5","314","2023-01-02"
"54486","2022","COM","2020","345","6","351","2023-01-02"
"54487","2022","COM","2020","63","0","63","2023-01-02"
"54488","2022","COM","2020","34","0","34","2023-01-02"
"54489","2022","COM","2020","152","4","156","2023-01-02"
"54490","2022","COM","2020","1464","23","1487","2023-01-02"
"54491","2022","COM","2020","335","4","339","2023-01-02"
"54492","2022","COM","2020","154","3","157","2023-01-02"
"54493","2022","COM","2020","2362","37","2399","2023-01-02"
"54494","2022","COM","2020","101","0","101","2023-01-02"
"54495","2022","COM","2020","4220","59","4279","2023-01-02"
"54496","2022","COM","2020","374","4","378","2023-01-02"
"54497","2022","COM","2020","107","3","110","2023-01-02"
"54498","2022","COM","2020","5111","66","5177","2023-01-02"
"54499","2022","COM","2020","110","4","114","2023-01-02"
"54500","2022","COM","2020","182","3","185","2023-01-02"
"54501","2022","COM","2020","101","0","101","2023-01-02"
"54502","2022","COM","2020","242","1","243","2023-01-02"
"54504","2022","COM","2020","657","15","672","2023-01-02"
"54505","2022","COM","2020","724","8","732","2023-01-02"
"54507","2022","COM","2020","102","2","104","2023-01-02"
"54508","2022","COM","2020","239","5","244","2023-01-02"
"54509","2022","COM","2020","996","5","1001","2023-01-02"
"54510","2022","COM","2020","305","6","311","2023-01-02"
"54511","2022","COM","2020","111","4","115","2023-01-02"
"54512","2022","COM","2020","106","2","108","2023-01-02"
"54513","2022","COM","2020","646","3","649","2023-01-02"
"54514","2022","COM","2020","622","15","637","2023-01-02"
"54515","2022","COM","2020","250","0","250","2023-01-02"
"54516","2022","COM","2020","18","1","19","2023-01-02"
"54517","2022","COM","2020","202","2","204","2023-01-02"
"54518","2022","COM","2020","1113","6","1119","2023-01-02"
"54519","2022","COM","2020","594","8","602","2023-01-02"
"54520","2022","COM","2020","382","8","390","2023-01-02"
"54521","2022","COM","2020","1968","19","1987","2023-01-02"
"54522","2022","COM","2020","135","2","137","2023-01-02"
"54523","2022","COM","2020","423","1","424","2023-01-02"
"54524","2022","COM","2020","90","2","92","2023-01-02"
"54525","2022","COM","2020","654","9","663","2023-01-02"
"54526","2022","COM","2020","8941","283","9224","2023-01-02"
"54527","2022","COM","2020","664","25","689","2023-01-02"
"54528","2022","COM","2020","15857","250","16107","2023-01-02"
"54529","2022","COM","2020","28","0","28","2023-01-02"
"54530","2022","COM","2020","88","4","92","2023-01-02"
"54531","2022","COM","2020","59","0","59","2023-01-02"
"54532","2022","COM","2020","163","3","166","2023-01-02"
"54533","2022","COM","2020","2620","31","2651","2023-01-02"
"54534","2022","COM","2020","523","20","543","2023-01-02"
"54535","2022","COM","2020","198","6","204","2023-01-02"
"54536","2022","COM","2020","2422","24","2446","2023-01-02"
"54537","2022","COM","2020","692","30","722","2023-01-02"
"54538","2022","COM","2020","371","3","374","2023-01-02"
"54539","2022","COM","2020","230","13","243","2023-01-02"
"54540","2022","COM","2020","569","5","574","2023-01-02"
"54541","2022","COM","2020","165","2","167","2023-01-02"
"54542","2022","COM","2020","2315","36","2351","2023-01-02"
"54543","2022","COM","2020","147","4","151","2023-01-02"
"54544","2022","COM","2020","139","2","141","2023-01-02"
"54545","2022","COM","2020","211","4","215","2023-01-02"
"54546","2022","COM","2020","929","8","937","2023-01-02"
"54547","2022","COM","2020","29723","316","30039","2023-01-02"
"54548","2022","COM","2020","523","10","533","2023-01-02"
"54549","2022","COM","2020","3600","41","3641","2023-01-02"
"54550","2022","COM","2020","320","8","328","2023-01-02"
"54551","2022","COM","2020","59","2","61","2023-01-02"
"54552","2022","COM","2020","65","1","66","2023-01-02"
"54553","2022","COM","2020","146","4","150","2023-01-02"
"54554","2022","COM","2020","78","1","79","2023-01-02"
"54555","2022","COM","2020","87","0","87","2023-01-02"
"54556","2022","COM","2020","108","3","111","2023-01-02"
"54557","2022","COM","2020","2318","97","2415","2023-01-02"
"54558","2022","COM","2020","280","5","285","2023-01-02"
"54559","2022","COM","2020","311","2","313","2023-01-02"
"54560","2022","COM","2020","52","0","52","2023-01-02"
"54561","2022","COM","2020","44","3","47","2023-01-02"
"54562","2022","COM","2020","147","2","149","2023-01-02"
"54563","2022","COM","2020","1361","18","1379","2023-01-02"
"54564","2022","COM","2020","141","4","145","2023-01-02"
"54565","2022","COM","2020","235","2","237","2023-01-02"
"54566","2022","COM","2020","150","1","151","2023-01-02"
"54567","2022","COM","2020","356","11","367","2023-01-02"
"54568","2022","COM","2020","263","12","275","2023-01-02"
"54569","2022","COM","2020","191","4","195","2023-01-02"
"54570","2022","COM","2020","340","5","345","2023-01-02"
"54571","2022","COM","2020","592","7","599","2023-01-02"
"54572","2022","COM","2020","690","5","695","2023-01-02"
"54573","2022","COM","2020","165","0","165","2023-01-02"
"54574","2022","COM","2020","549","19","568","2023-01-02"
"54575","2022","COM","2020","1538","31","1569","2023-01-02"
"54576","2022","COM","2020","121","1","122","2023-01-02"
"54577","2022","COM","2020","141","1","142","2023-01-02"
"54578","2022","COM","2020","14305","298","14603","2023-01-02"
"54579","2022","COM","2020","333","7","340","2023-01-02"
"54580","2022","COM","2020","10098","108","10206","2023-01-02"
"54581","2022","COM","2020","298","9","307","2023-01-02"
"54582","2022","COM","2020","185","1","186","2023-01-02"
"54583","2022","COM","2020","420","8","428","2023-01-02"
"54584","2022","COM","2020","1021","22","1043","2023-01-02"
"54585","2022","COM","2020","494","7","501","2023-01-02"
"54586","2022","COM","2020","741","11","752","2023-01-02"
"54587","2022","COM","2020","190","3","193","2023-01-02"
"54588","2022","COM","2020","393","9","402","2023-01-02"
"54589","2022","COM","2020","127","5","132","2023-01-02"
"54590","2022","COM","2020","660","19","679","2023-01-02"
"54591","2022","COM","2020","332","12","344","2023-01-02"
"54592","2022","COM","2020","262","3","265","2023-01-02"
"54593","2022","COM","2020","431","9","440","2023-01-02"
"54594","2022","COM","2020","166","1","167","2023-01-02"
"54595","2022","COM","2020","564","6","570","2023-01-02"
"54596","2022","COM","2020","969","7","976","2023-01-02"
"54597","2022","COM","2020","443","3","446","2023-01-02"
"54598","2022","COM","2020","270","7","277","2023-01-02"
"54599","2022","COM","2020","109","0","109","2023-01-02"
"54600","2022","COM","2020","124","2","126","2023-01-02"
"54601","2022","COM","2020","101","3","104","2023-01-02"
"54602","2022","COM","2020","148","0","148","2023-01-02"
"55001","2022","COM","2020","285","9","294","2023-01-02"
"55002","2022","COM","2020","101","3","104","2023-01-02"
"55004","2022","COM","2020","81","0","81","2023-01-02"
"55005","2022","COM","2020","36","1","37","2023-01-02"
"55007","2022","COM","2020","242","2","244","2023-01-02"
"55008","2022","COM","2020","144","5","149","2023-01-02"
"55009","2022","COM","2020","536","19","555","2023-01-02"
"55010","2022","COM","2020","2617","71","2688","2023-01-02"
"55011","2022","COM","2020","256","3","259","2023-01-02"
"55012","2022","COM","2020","422","8","430","2023-01-02"
"55013","2022","COM","2020","466","8","474","2023-01-02"
"55014","2022","COM","2020","360","7","367","2023-01-02"
"55015","2022","COM","2020","489","11","500","2023-01-02"
"55017","2022","COM","2020","118","5","123","2023-01-02"
"55018","2022","COM","2020","40","2","42","2023-01-02"
"55021","2022","COM","2020","68","5","73","2023-01-02"
"55022","2022","COM","2020","141","7","148","2023-01-02"
"55023","2022","COM","2020","120","1","121","2023-01-02"
"55024","2022","COM","2020","161","3","164","2023-01-02"
"55025","2022","COM","2020","276","2","278","2023-01-02"
"55026","2022","COM","2020","129","5","134","2023-01-02"
"55027","2022","COM","2020","160","3","163","2023-01-02"
"55028","2022","COM","2020","110","4","114","2023-01-02"
"55029","2022","COM","2020","14592","543","15135","2023-01-02"
"55031","2022","COM","2020","378","5","383","2023-01-02"
"55032","2022","COM","2020","44","0","44","2023-01-02"
"55033","2022","COM","2020","19","1","20","2023-01-02"
"55034","2022","COM","2020","113","1","114","2023-01-02"
"55035","2022","COM","2020","145","6","151","2023-01-02"
"55036","2022","COM","2020","93","1","94","2023-01-02"
"55037","2022","COM","2020","139","3","142","2023-01-02"
"55038","2022","COM","2020","38","2","40","2023-01-02"
"55039","2022","COM","2020","0","0","0","2023-01-02"
"55040","2022","COM","2020","253","6","259","2023-01-02"
"55041","2022","COM","2020","607","16","623","2023-01-02"
"55042","2022","COM","2020","527","12","539","2023-01-02"
"55043","2022","COM","2020","3020","53","3073","2023-01-02"
"55044","2022","COM","2020","31","3","34","2023-01-02"
"55045","2022","COM","2020","551","9","560","2023-01-02"
"55046","2022","COM","2020","131","4","135","2023-01-02"
"55047","2022","COM","2020","159","6","165","2023-01-02"
"55048","2022","COM","2020","38","0","38","2023-01-02"
"55049","2022","COM","2020","422","1","423","2023-01-02"
"55050","2022","COM","2020","0","0","0","2023-01-02"
"55051","2022","COM","2020","121","0","121","2023-01-02"
"55053","2022","COM","2020","368","2","370","2023-01-02"
"55054","2022","COM","2020","61","4","65","2023-01-02"
"55055","2022","COM","2020","13","1","14","2023-01-02"
"55057","2022","COM","2020","77","2","79","2023-01-02"
"55058","2022","COM","2020","326","10","336","2023-01-02"
"55059","2022","COM","2020","190","7","197","2023-01-02"
"55060","2022","COM","2020","353","13","366","2023-01-02"
"55061","2022","COM","2020","237","6","243","2023-01-02"
"55062","2022","COM","2020","109","1","110","2023-01-02"
"55063","2022","COM","2020","2448","40","2488","2023-01-02"
"55064","2022","COM","2020","109","0","109","2023-01-02"
"55065","2022","COM","2020","117","0","117","2023-01-02"
"55066","2022","COM","2020","129","2","131","2023-01-02"
"55067","2022","COM","2020","99","1","100","2023-01-02"
"55068","2022","COM","2020","107","0","107","2023-01-02"
"55069","2022","COM","2020","227","7","234","2023-01-02"
"55070","2022","COM","2020","119","6","125","2023-01-02"
"55071","2022","COM","2020","181","3","184","2023-01-02"
"55072","2022","COM","2020","107","1","108","2023-01-02"
"55073","2022","COM","2020","683","51","734","2023-01-02"
"55075","2022","COM","2020","175","4","179","2023-01-02"
"55076","2022","COM","2020","174","4","178","2023-01-02"
"55077","2022","COM","2020","263","9","272","2023-01-02"
"55078","2022","COM","2020","296","8","304","2023-01-02"
"55079","2022","COM","2020","698","21","719","2023-01-02"
"55080","2022","COM","2020","79","4","83","2023-01-02"
"55081","2022","COM","2020","59","0","59","2023-01-02"
"55082","2022","COM","2020","46","0","46","2023-01-02"
"55083","2022","COM","2020","155","4","159","2023-01-02"
"55084","2022","COM","2020","56","2","58","2023-01-02"
"55085","2022","COM","2020","287","4","291","2023-01-02"
"55087","2022","COM","2020","79","6","85","2023-01-02"
"55088","2022","COM","2020","152","4","156","2023-01-02"
"55089","2022","COM","2020","88","1","89","2023-01-02"
"55093","2022","COM","2020","282","7","289","2023-01-02"
"55094","2022","COM","2020","541","9","550","2023-01-02"
"55095","2022","COM","2020","102","4","106","2023-01-02"
"55096","2022","COM","2020","110","1","111","2023-01-02"
"55097","2022","COM","2020","310","7","317","2023-01-02"
"55099","2022","COM","2020","123","1","124","2023-01-02"
"55100","2022","COM","2020","75","7","82","2023-01-02"
"55101","2022","COM","2020","297","8","305","2023-01-02"
"55102","2022","COM","2020","527","20","547","2023-01-02"
"55103","2022","COM","2020","21","2","23","2023-01-02"
"55104","2022","COM","2020","79","3","82","2023-01-02"
"55105","2022","COM","2020","177","4","181","2023-01-02"
"55106","2022","COM","2020","177","5","182","2023-01-02"
"55107","2022","COM","2020","47","0","47","2023-01-02"
"55108","2022","COM","2020","122","4","126","2023-01-02"
"55109","2022","COM","2020","231","7","238","2023-01-02"
"55110","2022","COM","2020","224","6","230","2023-01-02"
"55111","2022","COM","2020","437","20","457","2023-01-02"
"55113","2022","COM","2020","155","4","159","2023-01-02"
"55114","2022","COM","2020","205","4","209","2023-01-02"
"55115","2022","COM","2020","46","0","46","2023-01-02"
"55116","2022","COM","2020","53","2","55","2023-01-02"
"55117","2022","COM","2020","1449","35","1484","2023-01-02"
"55118","2022","COM","2020","94","2","96","2023-01-02"
"55119","2022","COM","2020","189","1","190","2023-01-02"
"55120","2022","COM","2020","778","23","801","2023-01-02"
"55121","2022","COM","2020","116","3","119","2023-01-02"
"55122","2022","COM","2020","5352","226","5578","2023-01-02"
"55123","2022","COM","2020","711","14","725","2023-01-02"
"55124","2022","COM","2020","308","4","312","2023-01-02"
"55125","2022","COM","2020","787","18","805","2023-01-02"
"55127","2022","COM","2020","42","0","42","2023-01-02"
"55128","2022","COM","2020","41","1","42","2023-01-02"
"55129","2022","COM","2020","37","1","38","2023-01-02"
"55132","2022","COM","2020","1675","28","1703","2023-01-02"
"55133","2022","COM","2020","85","4","89","2023-01-02"
"55134","2022","COM","2020","152","4","156","2023-01-02"
"55137","2022","COM","2020","47","0","47","2023-01-02"
"55138","2022","COM","2020","127","3","130","2023-01-02"
"55139","2022","COM","2020","0","0","0","2023-01-02"
"55140","2022","COM","2020","18","0","18","2023-01-02"
"55141","2022","COM","2020","83","0","83","2023-01-02"
"55142","2022","COM","2020","123","6","129","2023-01-02"
"55143","2022","COM","2020","125","8","133","2023-01-02"
"55144","2022","COM","2020","379","11","390","2023-01-02"
"55145","2022","COM","2020","618","75","693","2023-01-02"
"55146","2022","COM","2020","197","10","207","2023-01-02"
"55148","2022","COM","2020","114","2","116","2023-01-02"
"55149","2022","COM","2020","120","0","120","2023-01-02"
"55150","2022","COM","2020","512","12","524","2023-01-02"
"55153","2022","COM","2020","194","2","196","2023-01-02"
"55154","2022","COM","2020","1441","47","1488","2023-01-02"
"55155","2022","COM","2020","393","7","400","2023-01-02"
"55156","2022","COM","2020","137","4","141","2023-01-02"
"55157","2022","COM","2020","52","0","52","2023-01-02"
"55158","2022","COM","2020","723","8","731","2023-01-02"
"55159","2022","COM","2020","353","3","356","2023-01-02"
"55160","2022","COM","2020","38","0","38","2023-01-02"
"55162","2022","COM","2020","33","0","33","2023-01-02"
"55163","2022","COM","2020","54","3","57","2023-01-02"
"55165","2022","COM","2020","429","9","438","2023-01-02"
"55166","2022","COM","2020","1313","26","1339","2023-01-02"
"55167","2022","COM","2020","637","19","656","2023-01-02"
"55168","2022","COM","2020","45","0","45","2023-01-02"
"55169","2022","COM","2020","515","5","520","2023-01-02"
"55170","2022","COM","2020","115","1","116","2023-01-02"
"55171","2022","COM","2020","259","4","263","2023-01-02"
"55172","2022","COM","2020","61","1","62","2023-01-02"
"55173","2022","COM","2020","39","3","42","2023-01-02"
"55174","2022","COM","2020","78","0","78","2023-01-02"
"55175","2022","COM","2020","184","4","188","2023-01-02"
"55177","2022","COM","2020","45","4","49","2023-01-02"
"55178","2022","COM","2020","187","4","191","2023-01-02"
"55179","2022","COM","2020","145","2","147","2023-01-02"
"55180","2022","COM","2020","136","11","147","2023-01-02"
"55181","2022","COM","2020","3492","72","3564","2023-01-02"
"55182","2022","COM","2020","207","3","210","2023-01-02"
"55183","2022","COM","2020","37","1","38","2023-01-02"
"55184","2022","COM","2020","1644","31","1675","2023-01-02"
"55185","2022","COM","2020","89","5","94","2023-01-02"
"55186","2022","COM","2020","2093","50","2143","2023-01-02"
"55188","2022","COM","2020","44","1","45","2023-01-02"
"55189","2022","COM","2020","0","0","0","2023-01-02"
"55191","2022","COM","2020","225","5","230","2023-01-02"
"55192","2022","COM","2020","39","1","40","2023-01-02"
"55193","2022","COM","2020","124","2","126","2023-01-02"
"55194","2022","COM","2020","60","0","60","2023-01-02"
"55195","2022","COM","2020","123","3","126","2023-01-02"
"55196","2022","COM","2020","126","1","127","2023-01-02"
"55197","2022","COM","2020","166","4","170","2023-01-02"
"55198","2022","COM","2020","657","13","670","2023-01-02"
"55199","2022","COM","2020","88","2","90","2023-01-02"
"55200","2022","COM","2020","207","4","211","2023-01-02"
"55201","2022","COM","2020","61","0","61","2023-01-02"
"55202","2022","COM","2020","145","3","148","2023-01-02"
"55204","2022","COM","2020","292","5","297","2023-01-02"
"55206","2022","COM","2020","107","6","113","2023-01-02"
"55207","2022","COM","2020","53","1","54","2023-01-02"
"55208","2022","COM","2020","57","2","59","2023-01-02"
"55210","2022","COM","2020","40","2","42","2023-01-02"
"55211","2022","COM","2020","64","0","64","2023-01-02"
"55212","2022","COM","2020","82","0","82","2023-01-02"
"55214","2022","COM","2020","278","16","294","2023-01-02"
"55215","2022","COM","2020","1065","17","1082","2023-01-02"
"55216","2022","COM","2020","64","0","64","2023-01-02"
"55217","2022","COM","2020","115","4","119","2023-01-02"
"55218","2022","COM","2020","41","0","41","2023-01-02"
"55219","2022","COM","2020","101","2","103","2023-01-02"
"55220","2022","COM","2020","83","2","85","2023-01-02"
"55221","2022","COM","2020","243","5","248","2023-01-02"
"55222","2022","COM","2020","31","2","33","2023-01-02"
"55224","2022","COM","2020","578","13","591","2023-01-02"
"55225","2022","COM","2020","139","6","145","2023-01-02"
"55226","2022","COM","2020","123","1","124","2023-01-02"
"55228","2022","COM","2020","542","10","552","2023-01-02"
"55229","2022","COM","2020","269","3","272","2023-01-02"
"55232","2022","COM","2020","112","0","112","2023-01-02"
"55236","2022","COM","2020","935","24","959","2023-01-02"
"55237","2022","COM","2020","232","1","233","2023-01-02"
"55239","2022","COM","2020","0","0","0","2023-01-02"
"55241","2022","COM","2020","77","4","81","2023-01-02"
"55242","2022","COM","2020","110","4","114","2023-01-02"
"55243","2022","COM","2020","181","5","186","2023-01-02"
"55244","2022","COM","2020","228","3","231","2023-01-02"
"55245","2022","COM","2020","164","2","166","2023-01-02"
"55246","2022","COM","2020","152","0","152","2023-01-02"
"55247","2022","COM","2020","48","5","53","2023-01-02"
"55248","2022","COM","2020","279","5","284","2023-01-02"
"55250","2022","COM","2020","181","8","189","2023-01-02"
"55251","2022","COM","2020","105","3","108","2023-01-02"
"55252","2022","COM","2020","155","2","157","2023-01-02"
"55253","2022","COM","2020","708","11","719","2023-01-02"
"55254","2022","COM","2020","123","3","126","2023-01-02"
"55255","2022","COM","2020","260","6","266","2023-01-02"
"55256","2022","COM","2020","147","2","149","2023-01-02"
"55257","2022","COM","2020","42","0","42","2023-01-02"
"55258","2022","COM","2020","619","15","634","2023-01-02"
"55260","2022","COM","2020","53","2","55","2023-01-02"
"55261","2022","COM","2020","143","2","145","2023-01-02"
"55262","2022","COM","2020","267","2","269","2023-01-02"
"55263","2022","COM","2020","160","1","161","2023-01-02"
"55264","2022","COM","2020","261","6","267","2023-01-02"
"55265","2022","COM","2020","139","5","144","2023-01-02"
"55266","2022","COM","2020","48","1","49","2023-01-02"
"55267","2022","COM","2020","276","8","284","2023-01-02"
"55268","2022","COM","2020","691","16","707","2023-01-02"
"55269","2022","COM","2020","74","0","74","2023-01-02"
"55270","2022","COM","2020","30","0","30","2023-01-02"
"55271","2022","COM","2020","365","5","370","2023-01-02"
"55272","2022","COM","2020","431","18","449","2023-01-02"
"55274","2022","COM","2020","290","6","296","2023-01-02"
"55275","2022","COM","2020","85","4","89","2023-01-02"
"55276","2022","COM","2020","217","2","219","2023-01-02"
"55278","2022","COM","2020","194","3","197","2023-01-02"
"55279","2022","COM","2020","445","7","452","2023-01-02"
"55280","2022","COM","2020","58","1","59","2023-01-02"
"55281","2022","COM","2020","94","0","94","2023-01-02"
"55282","2022","COM","2020","96","3","99","2023-01-02"
"55284","2022","COM","2020","73","0","73","2023-01-02"
"55285","2022","COM","2020","151","4","155","2023-01-02"
"55286","2022","COM","2020","237","1","238","2023-01-02"
"55288","2022","COM","2020","1410","17","1427","2023-01-02"
"55289","2022","COM","2020","59","1","60","2023-01-02"
"55290","2022","COM","2020","55","2","57","2023-01-02"
"55291","2022","COM","2020","3909","129","4038","2023-01-02"
"55292","2022","COM","2020","189","6","195","2023-01-02"
"55293","2022","COM","2020","172","3","175","2023-01-02"
"55295","2022","COM","2020","31","1","32","2023-01-02"
"55296","2022","COM","2020","475","7","482","2023-01-02"
"55297","2022","COM","2020","113","1","114","2023-01-02"
"55298","2022","COM","2020","294","9","303","2023-01-02"
"55299","2022","COM","2020","118","2","120","2023-01-02"
"55300","2022","COM","2020","221","6","227","2023-01-02"
"55301","2022","COM","2020","119","8","127","2023-01-02"
"55302","2022","COM","2020","1114","31","1145","2023-01-02"
"55303","2022","COM","2020","72","4","76","2023-01-02"
"55304","2022","COM","2020","160","6","166","2023-01-02"
"55306","2022","COM","2020","113","1","114","2023-01-02"
"55307","2022","COM","2020","0","0","0","2023-01-02"
"55310","2022","COM","2020","112","4","116","2023-01-02"
"55311","2022","COM","2020","27","1","28","2023-01-02"
"55312","2022","COM","2020","167","6","173","2023-01-02"
"55313","2022","COM","2020","68","2","70","2023-01-02"
"55315","2022","COM","2020","117","4","121","2023-01-02"
"55316","2022","COM","2020","406","7","413","2023-01-02"
"55317","2022","COM","2020","144","7","151","2023-01-02"
"55320","2022","COM","2020","66","2","68","2023-01-02"
"55321","2022","COM","2020","168","2","170","2023-01-02"
"55322","2022","COM","2020","50","1","51","2023-01-02"
"55323","2022","COM","2020","69","1","70","2023-01-02"
"55324","2022","COM","2020","517","13","530","2023-01-02"
"55325","2022","COM","2020","50","1","51","2023-01-02"
"55326","2022","COM","2020","108","3","111","2023-01-02"
"55327","2022","COM","2020","248","2","250","2023-01-02"
"55328","2022","COM","2020","285","5","290","2023-01-02"
"55329","2022","COM","2020","211","5","216","2023-01-02"
"55330","2022","COM","2020","90","2","92","2023-01-02"
"55331","2022","COM","2020","77","1","78","2023-01-02"
"55332","2022","COM","2020","238","1","239","2023-01-02"
"55333","2022","COM","2020","43","1","44","2023-01-02"
"55334","2022","COM","2020","164","1","165","2023-01-02"
"55335","2022","COM","2020","250","8","258","2023-01-02"
"55336","2022","COM","2020","151","2","153","2023-01-02"
"55338","2022","COM","2020","148","4","152","2023-01-02"
"55339","2022","COM","2020","75","1","76","2023-01-02"
"55340","2022","COM","2020","371","8","379","2023-01-02"
"55341","2022","COM","2020","122","4","126","2023-01-02"
"55343","2022","COM","2020","58","2","60","2023-01-02"
"55344","2022","COM","2020","22","0","22","2023-01-02"
"55345","2022","COM","2020","101","2","103","2023-01-02"
"55346","2022","COM","2020","293","7","300","2023-01-02"
"55347","2022","COM","2020","339","3","342","2023-01-02"
"55348","2022","COM","2020","368","3","371","2023-01-02"
"55349","2022","COM","2020","118","0","118","2023-01-02"
"55350","2022","COM","2020","76","0","76","2023-01-02"
"55351","2022","COM","2020","2040","84","2124","2023-01-02"
"55352","2022","COM","2020","143","17","160","2023-01-02"
"55353","2022","COM","2020","79","1","80","2023-01-02"
"55355","2022","COM","2020","155","1","156","2023-01-02"
"55356","2022","COM","2020","104","1","105","2023-01-02"
"55357","2022","COM","2020","108","3","111","2023-01-02"
"55358","2022","COM","2020","188","4","192","2023-01-02"
"55359","2022","COM","2020","206","2","208","2023-01-02"
"55360","2022","COM","2020","109","1","110","2023-01-02"
"55361","2022","COM","2020","128","0","128","2023-01-02"
"55362","2022","COM","2020","181","3","184","2023-01-02"
"55363","2022","COM","2020","90","1","91","2023-01-02"
"55364","2022","COM","2020","660","28","688","2023-01-02"
"55365","2022","COM","2020","141","3","144","2023-01-02"
"55366","2022","COM","2020","1008","34","1042","2023-01-02"
"55367","2022","COM","2020","137","4","141","2023-01-02"
"55368","2022","COM","2020","148","7","155","2023-01-02"
"55369","2022","COM","2020","805","16","821","2023-01-02"
"55370","2022","COM","2020","227","2","229","2023-01-02"
"55371","2022","COM","2020","76","3","79","2023-01-02"
"55372","2022","COM","2020","367","9","376","2023-01-02"
"55373","2022","COM","2020","82","5","87","2023-01-02"
"55374","2022","COM","2020","75","1","76","2023-01-02"
"55375","2022","COM","2020","63","1","64","2023-01-02"
"55376","2022","COM","2020","86","4","90","2023-01-02"
"55377","2022","COM","2020","93","1","94","2023-01-02"
"55378","2022","COM","2020","241","2","243","2023-01-02"
"55379","2022","COM","2020","66","2","68","2023-01-02"
"55380","2022","COM","2020","52","1","53","2023-01-02"
"55381","2022","COM","2020","165","0","165","2023-01-02"
"55382","2022","COM","2020","366","8","374","2023-01-02"
"55383","2022","COM","2020","216","1","217","2023-01-02"
"55384","2022","COM","2020","126","4","130","2023-01-02"
"55385","2022","COM","2020","493","16","509","2023-01-02"
"55386","2022","COM","2020","221","3","224","2023-01-02"
"55387","2022","COM","2020","241","4","245","2023-01-02"
"55388","2022","COM","2020","276","4","280","2023-01-02"
"55389","2022","COM","2020","247","6","253","2023-01-02"
"55391","2022","COM","2020","198","6","204","2023-01-02"
"55394","2022","COM","2020","7","0","7","2023-01-02"
"55395","2022","COM","2020","59","3","62","2023-01-02"
"55396","2022","COM","2020","224","4","228","2023-01-02"
"55397","2022","COM","2020","234","4","238","2023-01-02"
"55398","2022","COM","2020","1006","16","1022","2023-01-02"
"55399","2022","COM","2020","115","4","119","2023-01-02"
"55400","2022","COM","2020","43","0","43","2023-01-02"
"55401","2022","COM","2020","415","10","425","2023-01-02"
"55403","2022","COM","2020","63","1","64","2023-01-02"
"55404","2022","COM","2020","319","6","325","2023-01-02"
"55405","2022","COM","2020","252","4","256","2023-01-02"
"55406","2022","COM","2020","110","4","114","2023-01-02"
"55407","2022","COM","2020","129","6","135","2023-01-02"
"55408","2022","COM","2020","171","8","179","2023-01-02"
"55409","2022","COM","2020","64","2","66","2023-01-02"
"55410","2022","COM","2020","133","5","138","2023-01-02"
"55411","2022","COM","2020","99","1","100","2023-01-02"
"55412","2022","COM","2020","185","5","190","2023-01-02"
"55414","2022","COM","2020","180","1","181","2023-01-02"
"55415","2022","COM","2020","87","1","88","2023-01-02"
"55416","2022","COM","2020","225","8","233","2023-01-02"
"55419","2022","COM","2020","157","2","159","2023-01-02"
"55420","2022","COM","2020","77","0","77","2023-01-02"
"55421","2022","COM","2020","75","5","80","2023-01-02"
"55422","2022","COM","2020","51","1","52","2023-01-02"
"55423","2022","COM","2020","318","8","326","2023-01-02"
"55424","2022","COM","2020","47","1","48","2023-01-02"
"55425","2022","COM","2020","133","0","133","2023-01-02"
"55426","2022","COM","2020","384","13","397","2023-01-02"
"55427","2022","COM","2020","2794","44","2838","2023-01-02"
"55428","2022","COM","2020","126","1","127","2023-01-02"
"55429","2022","COM","2020","49","0","49","2023-01-02"
"55430","2022","COM","2020","67","1","68","2023-01-02"
"55431","2022","COM","2020","57","0","57","2023-01-02"
"55433","2022","COM","2020","362","5","367","2023-01-02"
"55434","2022","COM","2020","49","2","51","2023-01-02"
"55435","2022","COM","2020","771","23","794","2023-01-02"
"55436","2022","COM","2020","28","0","28","2023-01-02"
"55437","2022","COM","2020","122","3","125","2023-01-02"
"55438","2022","COM","2020","186","4","190","2023-01-02"
"55439","2022","COM","2020","95","7","102","2023-01-02"
"55442","2022","COM","2020","245","5","250","2023-01-02"
"55443","2022","COM","2020","591","6","597","2023-01-02"
"55444","2022","COM","2020","210","2","212","2023-01-02"
"55445","2022","COM","2020","190","8","198","2023-01-02"
"55446","2022","COM","2020","86","4","90","2023-01-02"
"55447","2022","COM","2020","370","7","377","2023-01-02"
"55448","2022","COM","2020","44","1","45","2023-01-02"
"55449","2022","COM","2020","284","4","288","2023-01-02"
"55450","2022","COM","2020","45","2","47","2023-01-02"
"55452","2022","COM","2020","53","0","53","2023-01-02"
"55453","2022","COM","2020","64","2","66","2023-01-02"
"55454","2022","COM","2020","169","9","178","2023-01-02"
"55456","2022","COM","2020","225","6","231","2023-01-02"
"55457","2022","COM","2020","185","6","191","2023-01-02"
"55458","2022","COM","2020","380","0","380","2023-01-02"
"55459","2022","COM","2020","237","2","239","2023-01-02"
"55460","2022","COM","2020","140","2","142","2023-01-02"
"55461","2022","COM","2020","455","15","470","2023-01-02"
"55462","2022","COM","2020","335","11","346","2023-01-02"
"55463","2022","COM","2020","4000","70","4070","2023-01-02"
"55464","2022","COM","2020","153","2","155","2023-01-02"
"55465","2022","COM","2020","102","0","102","2023-01-02"
"55466","2022","COM","2020","290","4","294","2023-01-02"
"55467","2022","COM","2020","696","13","709","2023-01-02"
"55468","2022","COM","2020","99","0","99","2023-01-02"
"55469","2022","COM","2020","91","0","91","2023-01-02"
"55470","2022","COM","2020","193","2","195","2023-01-02"
"55471","2022","COM","2020","81","1","82","2023-01-02"
"55472","2022","COM","2020","116","5","121","2023-01-02"
"55473","2022","COM","2020","111","12","123","2023-01-02"
"55474","2022","COM","2020","226","4","230","2023-01-02"
"55475","2022","COM","2020","64","1","65","2023-01-02"
"55476","2022","COM","2020","469","13","482","2023-01-02"
"55477","2022","COM","2020","402","15","417","2023-01-02"
"55479","2022","COM","2020","160","3","163","2023-01-02"
"55481","2022","COM","2020","324","5","329","2023-01-02"
"55482","2022","COM","2020","103","2","105","2023-01-02"
"55484","2022","COM","2020","47","0","47","2023-01-02"
"55485","2022","COM","2020","70","1","71","2023-01-02"
"55487","2022","COM","2020","88","2","90","2023-01-02"
"55488","2022","COM","2020","146","5","151","2023-01-02"
"55489","2022","COM","2020","276","5","281","2023-01-02"
"55490","2022","COM","2020","333","5","338","2023-01-02"
"55492","2022","COM","2020","988","11","999","2023-01-02"
"55493","2022","COM","2020","183","6","189","2023-01-02"
"55494","2022","COM","2020","419","20","439","2023-01-02"
"55495","2022","COM","2020","242","1","243","2023-01-02"
"55496","2022","COM","2020","1047","27","1074","2023-01-02"
"55497","2022","COM","2020","319","3","322","2023-01-02"
"55498","2022","COM","2020","452","5","457","2023-01-02"
"55500","2022","COM","2020","825","12","837","2023-01-02"
"55501","2022","COM","2020","382","10","392","2023-01-02"
"55502","2022","COM","2020","2492","131","2623","2023-01-02"
"55503","2022","COM","2020","124","2","126","2023-01-02"
"55504","2022","COM","2020","405","5","410","2023-01-02"
"55505","2022","COM","2020","3167","96","3263","2023-01-02"
"55506","2022","COM","2020","31","0","31","2023-01-02"
"55507","2022","COM","2020","214","2","216","2023-01-02"
"55508","2022","COM","2020","351","13","364","2023-01-02"
"55509","2022","COM","2020","276","5","281","2023-01-02"
"55510","2022","COM","2020","129","3","132","2023-01-02"
"55511","2022","COM","2020","118","3","121","2023-01-02"
"55512","2022","COM","2020","279","4","283","2023-01-02"
"55514","2022","COM","2020","605","10","615","2023-01-02"
"55515","2022","COM","2020","68","1","69","2023-01-02"
"55516","2022","COM","2020","552","7","559","2023-01-02"
"55517","2022","COM","2020","510","6","516","2023-01-02"
"55518","2022","COM","2020","145","2","147","2023-01-02"
"55519","2022","COM","2020","1343","17","1360","2023-01-02"
"55520","2022","COM","2020","477","11","488","2023-01-02"
"55521","2022","COM","2020","235","1","236","2023-01-02"
"55522","2022","COM","2020","110","3","113","2023-01-02"
"55523","2022","COM","2020","188","4","192","2023-01-02"
"55525","2022","COM","2020","75","1","76","2023-01-02"
"55526","2022","COM","2020","263","4","267","2023-01-02"
"55527","2022","COM","2020","635","11","646","2023-01-02"
"55528","2022","COM","2020","50","0","50","2023-01-02"
"55530","2022","COM","2020","92","1","93","2023-01-02"
"55531","2022","COM","2020","283","21","304","2023-01-02"
"55532","2022","COM","2020","313","5","318","2023-01-02"
"55533","2022","COM","2020","1929","24","1953","2023-01-02"
"55534","2022","COM","2020","53","0","53","2023-01-02"
"55535","2022","COM","2020","90","0","90","2023-01-02"
"55536","2022","COM","2020","19","2","21","2023-01-02"
"55537","2022","COM","2020","79","0","79","2023-01-02"
"55540","2022","COM","2020","59","3","62","2023-01-02"
"55541","2022","COM","2020","527","9","536","2023-01-02"
"55543","2022","COM","2020","925","18","943","2023-01-02"
"55544","2022","COM","2020","148","1","149","2023-01-02"
"55545","2022","COM","2020","16877","969","17846","2023-01-02"
"55546","2022","COM","2020","207","8","215","2023-01-02"
"55547","2022","COM","2020","114","4","118","2023-01-02"
"55549","2022","COM","2020","89","1","90","2023-01-02"
"55551","2022","COM","2020","1566","92","1658","2023-01-02"
"55552","2022","COM","2020","81","4","85","2023-01-02"
"55553","2022","COM","2020","1299","20","1319","2023-01-02"
"55554","2022","COM","2020","268","14","282","2023-01-02"
"55555","2022","COM","2020","32","1","33","2023-01-02"
"55556","2022","COM","2020","49","1","50","2023-01-02"
"55557","2022","COM","2020","124","0","124","2023-01-02"
"55559","2022","COM","2020","52","2","54","2023-01-02"
"55560","2022","COM","2020","130","4","134","2023-01-02"
"55561","2022","COM","2020","51","1","52","2023-01-02"
"55562","2022","COM","2020","126","0","126","2023-01-02"
"55563","2022","COM","2020","77","2","79","2023-01-02"
"55565","2022","COM","2020","77","3","80","2023-01-02"
"55566","2022","COM","2020","298","6","304","2023-01-02"
"55567","2022","COM","2020","141","3","144","2023-01-02"
"55568","2022","COM","2020","277","5","282","2023-01-02"
"55569","2022","COM","2020","165","5","170","2023-01-02"
"55570","2022","COM","2020","212","7","219","2023-01-02"
"55571","2022","COM","2020","235","5","240","2023-01-02"
"55572","2022","COM","2020","89","1","90","2023-01-02"
"55573","2022","COM","2020","1621","29","1650","2023-01-02"
"55574","2022","COM","2020","43","2","45","2023-01-02"
"55575","2022","COM","2020","89","0","89","2023-01-02"
"55577","2022","COM","2020","57","2","59","2023-01-02"
"55578","2022","COM","2020","186","7","193","2023-01-02"
"55579","2022","COM","2020","101","0","101","2023-01-02"
"55580","2022","COM","2020","50","3","53","2023-01-02"
"55581","2022","COM","2020","105","2","107","2023-01-02"
"55582","2022","COM","2020","89","1","90","2023-01-02"
"55583","2022","COM","2020","205","3","208","2023-01-02"
"55584","2022","COM","2020","126","2","128","2023-01-02"
"55586","2022","COM","2020","111","3","114","2023-01-02"
"56001","2022","COM","2020","3882","126","4008","2023-01-02"
"56002","2022","COM","2020","2042","53","2095","2023-01-02"
"56003","2022","COM","2020","5549","150","5699","2023-01-02"
"56004","2022","COM","2020","1699","32","1731","2023-01-02"
"56005","2022","COM","2020","2264","41","2305","2023-01-02"
"56006","2022","COM","2020","1522","31","1553","2023-01-02"
"56007","2022","COM","2020","14155","416","14571","2023-01-02"
"56008","2022","COM","2020","4418","127","4545","2023-01-02"
"56009","2022","COM","2020","1018","20","1038","2023-01-02"
"56010","2022","COM","2020","6242","185","6427","2023-01-02"
"56011","2022","COM","2020","1390","26","1416","2023-01-02"
"56012","2022","COM","2020","1955","43","1998","2023-01-02"
"56013","2022","COM","2020","3784","61","3845","2023-01-02"
"56014","2022","COM","2020","1545","134","1679","2023-01-02"
"56015","2022","COM","2020","2095","31","2126","2023-01-02"
"56017","2022","COM","2020","2758","63","2821","2023-01-02"
"56018","2022","COM","2020","1037","26","1063","2023-01-02"
"56019","2022","COM","2020","332","10","342","2023-01-02"
"56020","2022","COM","2020","852","13","865","2023-01-02"
"56021","2022","COM","2020","1466","26","1492","2023-01-02"
"56022","2022","COM","2020","1341","36","1377","2023-01-02"
"56023","2022","COM","2020","6792","286","7078","2023-01-02"
"56024","2022","COM","2020","2291","33","2324","2023-01-02"
"56025","2022","COM","2020","194","4","198","2023-01-02"
"56026","2022","COM","2020","2289","57","2346","2023-01-02"
"56027","2022","COM","2020","542","7","549","2023-01-02"
"56028","2022","COM","2020","1580","36","1616","2023-01-02"
"56029","2022","COM","2020","1247","25","1272","2023-01-02"
"56030","2022","COM","2020","1089","15","1104","2023-01-02"
"56031","2022","COM","2020","3083","61","3144","2023-01-02"
"56032","2022","COM","2020","1898","53","1951","2023-01-02"
"56033","2022","COM","2020","3062","58","3120","2023-01-02"
"56034","2022","COM","2020","4231","106","4337","2023-01-02"
"56035","2022","COM","2020","1143","29","1172","2023-01-02"
"56036","2022","COM","2020","7091","207","7298","2023-01-02"
"56039","2022","COM","2020","984","22","1006","2023-01-02"
"56040","2022","COM","2020","3310","61","3371","2023-01-02"
"56041","2022","COM","2020","2835","88","2923","2023-01-02"
"56042","2022","COM","2020","2216","46","2262","2023-01-02"
"56043","2022","COM","2020","750","17","767","2023-01-02"
"56044","2022","COM","2020","798","29","827","2023-01-02"
"56045","2022","COM","2020","674","10","684","2023-01-02"
"56046","2022","COM","2020","3421","80","3501","2023-01-02"
"56047","2022","COM","2020","1501","45","1546","2023-01-02"
"56048","2022","COM","2020","721","14","735","2023-01-02"
"56050","2022","COM","2020","876","32","908","2023-01-02"
"56051","2022","COM","2020","656","9","665","2023-01-02"
"56052","2022","COM","2020","1908","29","1937","2023-01-02"
"56053","2022","COM","2020","6387","127","6514","2023-01-02"
"56054","2022","COM","2020","3958","95","4053","2023-01-02"
"56055","2022","COM","2020","2053","180","2233","2023-01-02"
"56056","2022","COM","2020","205","4","209","2023-01-02"
"56057","2022","COM","2020","2800","56","2856","2023-01-02"
"56058","2022","COM","2020","3367","66","3433","2023-01-02"
"56060","2022","COM","2020","948","34","982","2023-01-02"
"56061","2022","COM","2020","3974","105","4079","2023-01-02"
"56062","2022","COM","2020","679","19","698","2023-01-02"
"56063","2022","COM","2020","2609","89","2698","2023-01-02"
"56065","2022","COM","2020","751","23","774","2023-01-02"
"56066","2022","COM","2020","3783","152","3935","2023-01-02"
"56067","2022","COM","2020","5612","142","5754","2023-01-02"
"56068","2022","COM","2020","315","3","318","2023-01-02"
"56069","2022","COM","2020","2256","47","2303","2023-01-02"
"56070","2022","COM","2020","2261","52","2313","2023-01-02"
"56071","2022","COM","2020","796","12","808","2023-01-02"
"56072","2022","COM","2020","511","10","521","2023-01-02"
"56073","2022","COM","2020","1059","15","1074","2023-01-02"
"56074","2022","COM","2020","1848","38","1886","2023-01-02"
"56075","2022","COM","2020","6079","299","6378","2023-01-02"
"56076","2022","COM","2020","1314","35","1349","2023-01-02"
"56077","2022","COM","2020","992","25","1017","2023-01-02"
"56078","2022","COM","2020","11743","294","12037","2023-01-02"
"56079","2022","COM","2020","1364","34","1398","2023-01-02"
"56080","2022","COM","2020","1301","143","1444","2023-01-02"
"56081","2022","COM","2020","2081","57","2138","2023-01-02"
"56082","2022","COM","2020","383","7","390","2023-01-02"
"56083","2022","COM","2020","15873","427","16300","2023-01-02"
"56084","2022","COM","2020","856","16","872","2023-01-02"
"56085","2022","COM","2020","97","2","99","2023-01-02"
"56086","2022","COM","2020","216","6","222","2023-01-02"
"56087","2022","COM","2020","627","18","645","2023-01-02"
"56088","2022","COM","2020","257","6","263","2023-01-02"
"56089","2022","COM","2020","2193","54","2247","2023-01-02"
"56090","2022","COM","2020","6535","134","6669","2023-01-02"
"56091","2022","COM","2020","2511","102","2613","2023-01-02"
"56092","2022","COM","2020","829","15","844","2023-01-02"
"56093","2022","COM","2020","719","23","742","2023-01-02"
"56094","2022","COM","2020","6858","216","7074","2023-01-02"
"56096","2022","COM","2020","2429","50","2479","2023-01-02"
"56097","2022","COM","2020","4013","71","4084","2023-01-02"
"56098","2022","COM","2020","22940","481","23421","2023-01-02"
"56099","2022","COM","2020","388","5","393","2023-01-02"
"56100","2022","COM","2020","1708","52","1760","2023-01-02"
"56101","2022","COM","2020","8047","157","8204","2023-01-02"
"56102","2022","COM","2020","2148","51","2199","2023-01-02"
"56103","2022","COM","2020","296","4","300","2023-01-02"
"56104","2022","COM","2020","804","10","814","2023-01-02"
"56105","2022","COM","2020","1138","22","1160","2023-01-02"
"56106","2022","COM","2020","869","20","889","2023-01-02"
"56107","2022","COM","2020","8277","245","8522","2023-01-02"
"56108","2022","COM","2020","1081","17","1098","2023-01-02"
"56109","2022","COM","2020","1177","27","1204","2023-01-02"
"56110","2022","COM","2020","844","20","864","2023-01-02"
"56111","2022","COM","2020","1311","23","1334","2023-01-02"
"56112","2022","COM","2020","740","15","755","2023-01-02"
"56113","2022","COM","2020","903","21","924","2023-01-02"
"56114","2022","COM","2020","962","30","992","2023-01-02"
"56115","2022","COM","2020","1742","40","1782","2023-01-02"
"56116","2022","COM","2020","1545","43","1588","2023-01-02"
"56117","2022","COM","2020","4578","237","4815","2023-01-02"
"56118","2022","COM","2020","4056","111","4167","2023-01-02"
"56119","2022","COM","2020","3486","80","3566","2023-01-02"
"56120","2022","COM","2020","1919","42","1961","2023-01-02"
"56121","2022","COM","2020","57412","1469","58881","2023-01-02"
"56122","2022","COM","2020","1667","42","1709","2023-01-02"
"56123","2022","COM","2020","2198","44","2242","2023-01-02"
"56124","2022","COM","2020","2483","81","2564","2023-01-02"
"56125","2022","COM","2020","1840","64","1904","2023-01-02"
"56126","2022","COM","2020","2468","30","2498","2023-01-02"
"56127","2022","COM","2020","3176","71","3247","2023-01-02"
"56128","2022","COM","2020","1520","24","1544","2023-01-02"
"56129","2022","COM","2020","1512","33","1545","2023-01-02"
"56130","2022","COM","2020","3215","76","3291","2023-01-02"
"56131","2022","COM","2020","1438","29","1467","2023-01-02"
"56132","2022","COM","2020","2269","54","2323","2023-01-02"
"56133","2022","COM","2020","1167","34","1201","2023-01-02"
"56134","2022","COM","2020","982","11","993","2023-01-02"
"56135","2022","COM","2020","1622","31","1653","2023-01-02"
"56136","2022","COM","2020","755","15","770","2023-01-02"
"56137","2022","COM","2020","3311","78","3389","2023-01-02"
"56139","2022","COM","2020","362","10","372","2023-01-02"
"56140","2022","COM","2020","3703","95","3798","2023-01-02"
"56141","2022","COM","2020","1728","37","1765","2023-01-02"
"56143","2022","COM","2020","5054","127","5181","2023-01-02"
"56144","2022","COM","2020","3446","79","3525","2023-01-02"
"56145","2022","COM","2020","1119","27","1146","2023-01-02"
"56146","2022","COM","2020","1419","35","1454","2023-01-02"
"56147","2022","COM","2020","4746","98","4844","2023-01-02"
"56148","2022","COM","2020","1607","33","1640","2023-01-02"
"56149","2022","COM","2020","2520","51","2571","2023-01-02"
"56151","2022","COM","2020","3596","118","3714","2023-01-02"
"56152","2022","COM","2020","2536","53","2589","2023-01-02"
"56153","2022","COM","2020","2718","52","2770","2023-01-02"
"56154","2022","COM","2020","1840","49","1889","2023-01-02"
"56155","2022","COM","2020","2023","28","2051","2023-01-02"
"56156","2022","COM","2020","351","6","357","2023-01-02"
"56157","2022","COM","2020","1957","54","2011","2023-01-02"
"56158","2022","COM","2020","6182","185","6367","2023-01-02"
"56159","2022","COM","2020","1819","43","1862","2023-01-02"
"56160","2022","COM","2020","1292","18","1310","2023-01-02"
"56161","2022","COM","2020","3032","90","3122","2023-01-02"
"56162","2022","COM","2020","18537","648","19185","2023-01-02"
"56163","2022","COM","2020","1228","24","1252","2023-01-02"
"56164","2022","COM","2020","6669","224","6893","2023-01-02"
"56165","2022","COM","2020","9785","563","10348","2023-01-02"
"56166","2022","COM","2020","5789","141","5930","2023-01-02"
"56167","2022","COM","2020","2599","85","2684","2023-01-02"
"56168","2022","COM","2020","2240","52","2292","2023-01-02"
"56169","2022","COM","2020","5365","122","5487","2023-01-02"
"56170","2022","COM","2020","1046","29","1075","2023-01-02"
"56171","2022","COM","2020","1520","27","1547","2023-01-02"
"56172","2022","COM","2020","2686","67","2753","2023-01-02"
"56173","2022","COM","2020","4341","89","4430","2023-01-02"
"56174","2022","COM","2020","2753","70","2823","2023-01-02"
"56175","2022","COM","2020","4190","96","4286","2023-01-02"
"56176","2022","COM","2020","6023","143","6166","2023-01-02"
"56177","2022","COM","2020","7657","141","7798","2023-01-02"
"56178","2022","COM","2020","15092","938","16030","2023-01-02"
"56179","2022","COM","2020","3897","88","3985","2023-01-02"
"56180","2022","COM","2020","738","17","755","2023-01-02"
"56181","2022","COM","2020","2672","102","2774","2023-01-02"
"56182","2022","COM","2020","965","180","1145","2023-01-02"
"56184","2022","COM","2020","7937","282","8219","2023-01-02"
"56185","2022","COM","2020","8816","235","9051","2023-01-02"
"56186","2022","COM","2020","4659","97","4756","2023-01-02"
"56188","2022","COM","2020","1421","21","1442","2023-01-02"
"56189","2022","COM","2020","1067","19","1086","2023-01-02"
"56190","2022","COM","2020","1963","54","2017","2023-01-02"
"56191","2022","COM","2020","425","11","436","2023-01-02"
"56193","2022","COM","2020","5806","140","5946","2023-01-02"
"56194","2022","COM","2020","2862","74","2936","2023-01-02"
"56195","2022","COM","2020","694","13","707","2023-01-02"
"56196","2022","COM","2020","637","13","650","2023-01-02"
"56197","2022","COM","2020","2782","78","2860","2023-01-02"
"56198","2022","COM","2020","1605","37","1642","2023-01-02"
"56199","2022","COM","2020","702","14","716","2023-01-02"
"56200","2022","COM","2020","1378","34","1412","2023-01-02"
"56201","2022","COM","2020","590","7","597","2023-01-02"
"56202","2022","COM","2020","529","14","543","2023-01-02"
"56203","2022","COM","2020","629","14","643","2023-01-02"
"56204","2022","COM","2020","630","8","638","2023-01-02"
"56205","2022","COM","2020","877","18","895","2023-01-02"
"56206","2022","COM","2020","11912","283","12195","2023-01-02"
"56207","2022","COM","2020","1153","18","1171","2023-01-02"
"56208","2022","COM","2020","302","8","310","2023-01-02"
"56209","2022","COM","2020","180","7","187","2023-01-02"
"56210","2022","COM","2020","479","6","485","2023-01-02"
"56211","2022","COM","2020","798","17","815","2023-01-02"
"56212","2022","COM","2020","2570","50","2620","2023-01-02"
"56213","2022","COM","2020","1316","32","1348","2023-01-02"
"56214","2022","COM","2020","1552","22","1574","2023-01-02"
"56215","2022","COM","2020","1100","24","1124","2023-01-02"
"56216","2022","COM","2020","399","4","403","2023-01-02"
"56218","2022","COM","2020","710","11","721","2023-01-02"
"56219","2022","COM","2020","1407","23","1430","2023-01-02"
"56220","2022","COM","2020","1272","31","1303","2023-01-02"
"56221","2022","COM","2020","1742","83","1825","2023-01-02"
"56222","2022","COM","2020","2865","136","3001","2023-01-02"
"56223","2022","COM","2020","1454","58","1512","2023-01-02"
"56224","2022","COM","2020","389","10","399","2023-01-02"
"56225","2022","COM","2020","208","8","216","2023-01-02"
"56226","2022","COM","2020","543","23","566","2023-01-02"
"56227","2022","COM","2020","596","15","611","2023-01-02"
"56228","2022","COM","2020","1113","48","1161","2023-01-02"
"56229","2022","COM","2020","1299","17","1316","2023-01-02"
"56230","2022","COM","2020","463","11","474","2023-01-02"
"56231","2022","COM","2020","3892","127","4019","2023-01-02"
"56232","2022","COM","2020","1066","42","1108","2023-01-02"
"56233","2022","COM","2020","1524","44","1568","2023-01-02"
"56234","2022","COM","2020","2145","48","2193","2023-01-02"
"56236","2022","COM","2020","802","18","820","2023-01-02"
"56237","2022","COM","2020","1869","76","1945","2023-01-02"
"56238","2022","COM","2020","369","12","381","2023-01-02"
"56239","2022","COM","2020","1584","42","1626","2023-01-02"
"56240","2022","COM","2020","8866","179","9045","2023-01-02"
"56241","2022","COM","2020","1012","20","1032","2023-01-02"
"56242","2022","COM","2020","645","18","663","2023-01-02"
"56243","2022","COM","2020","8930","259","9189","2023-01-02"
"56244","2022","COM","2020","3172","51","3223","2023-01-02"
"56245","2022","COM","2020","478","13","491","2023-01-02"
"56246","2022","COM","2020","2124","43","2167","2023-01-02"
"56247","2022","COM","2020","3797","92","3889","2023-01-02"
"56248","2022","COM","2020","4899","101","5000","2023-01-02"
"56249","2022","COM","2020","2259","64","2323","2023-01-02"
"56250","2022","COM","2020","608","5","613","2023-01-02"
"56251","2022","COM","2020","8386","239","8625","2023-01-02"
"56252","2022","COM","2020","1211","8","1219","2023-01-02"
"56253","2022","COM","2020","640","25","665","2023-01-02"
"56254","2022","COM","2020","1323","22","1345","2023-01-02"
"56255","2022","COM","2020","2450","57","2507","2023-01-02"
"56256","2022","COM","2020","113","0","113","2023-01-02"
"56257","2022","COM","2020","670","13","683","2023-01-02"
"56258","2022","COM","2020","1698","33","1731","2023-01-02"
"56259","2022","COM","2020","1738","22","1760","2023-01-02"
"56260","2022","COM","2020","54017","2001","56018","2023-01-02"
"56261","2022","COM","2020","1473","31","1504","2023-01-02"
"56262","2022","COM","2020","2567","42","2609","2023-01-02"
"56263","2022","COM","2020","2802","136","2938","2023-01-02"
"56264","2022","COM","2020","395","9","404","2023-01-02"
"57001","2022","COM","2020","324","3","327","2023-01-02"
"57002","2022","COM","2020","66","1","67","2023-01-02"
"57003","2022","COM","2020","1409","28","1437","2023-01-02"
"57004","2022","COM","2020","79","1","80","2023-01-02"
"57006","2022","COM","2020","983","28","1011","2023-01-02"
"57007","2022","COM","2020","128","4","132","2023-01-02"
"57008","2022","COM","2020","203","7","210","2023-01-02"
"57009","2022","COM","2020","104","1","105","2023-01-02"
"57010","2022","COM","2020","158","2","160","2023-01-02"
"57011","2022","COM","2020","618","19","637","2023-01-02"
"57012","2022","COM","2020","6104","53","6157","2023-01-02"
"57013","2022","COM","2020","2508","50","2558","2023-01-02"
"57014","2022","COM","2020","369","10","379","2023-01-02"
"57015","2022","COM","2020","561","12","573","2023-01-02"
"57016","2022","COM","2020","392","8","400","2023-01-02"
"57017","2022","COM","2020","2087","23","2110","2023-01-02"
"57018","2022","COM","2020","126","8","134","2023-01-02"
"57019","2022","COM","2020","10668","71","10739","2023-01-02"
"57020","2022","COM","2020","303","3","306","2023-01-02"
"57021","2022","COM","2020","1509","29","1538","2023-01-02"
"57022","2022","COM","2020","1264","28","1292","2023-01-02"
"57024","2022","COM","2020","188","0","188","2023-01-02"
"57025","2022","COM","2020","511","7","518","2023-01-02"
"57026","2022","COM","2020","1071","19","1090","2023-01-02"
"57027","2022","COM","2020","123","3","126","2023-01-02"
"57028","2022","COM","2020","1337","39","1376","2023-01-02"
"57029","2022","COM","2020","216","3","219","2023-01-02"
"57030","2022","COM","2020","562","3","565","2023-01-02"
"57031","2022","COM","2020","930","17","947","2023-01-02"
"57032","2022","COM","2020","4695","48","4743","2023-01-02"
"57033","2022","COM","2020","538","16","554","2023-01-02"
"57034","2022","COM","2020","35","1","36","2023-01-02"
"57035","2022","COM","2020","115","3","118","2023-01-02"
"57036","2022","COM","2020","103","0","103","2023-01-02"
"57037","2022","COM","2020","267","5","272","2023-01-02"
"57038","2022","COM","2020","7108","64","7172","2023-01-02"
"57039","2022","COM","2020","2158","35","2193","2023-01-02"
"57040","2022","COM","2020","289","2","291","2023-01-02"
"57041","2022","COM","2020","2368","31","2399","2023-01-02"
"57042","2022","COM","2020","583","11","594","2023-01-02"
"57043","2022","COM","2020","1517","19","1536","2023-01-02"
"57044","2022","COM","2020","125","5","130","2023-01-02"
"57045","2022","COM","2020","110","0","110","2023-01-02"
"57046","2022","COM","2020","756","13","769","2023-01-02"
"57047","2022","COM","2020","1045","13","1058","2023-01-02"
"57048","2022","COM","2020","72","2","74","2023-01-02"
"57049","2022","COM","2020","4604","68","4672","2023-01-02"
"57050","2022","COM","2020","111","2","113","2023-01-02"
"57051","2022","COM","2020","370","4","374","2023-01-02"
"57052","2022","COM","2020","573","9","582","2023-01-02"
"57053","2022","COM","2020","107","5","112","2023-01-02"
"57054","2022","COM","2020","184","1","185","2023-01-02"
"57055","2022","COM","2020","537","4","541","2023-01-02"
"57056","2022","COM","2020","190","5","195","2023-01-02"
"57057","2022","COM","2020","604","6","610","2023-01-02"
"57058","2022","COM","2020","6571","64","6635","2023-01-02"
"57059","2022","COM","2020","53","2","55","2023-01-02"
"57060","2022","COM","2020","523","6","529","2023-01-02"
"57061","2022","COM","2020","1145","28","1173","2023-01-02"
"57062","2022","COM","2020","433","14","447","2023-01-02"
"57063","2022","COM","2020","216","8","224","2023-01-02"
"57064","2022","COM","2020","260","4","264","2023-01-02"
"57065","2022","COM","2020","214","5","219","2023-01-02"
"57066","2022","COM","2020","512","4","516","2023-01-02"
"57067","2022","COM","2020","2808","60","2868","2023-01-02"
"57069","2022","COM","2020","458","7","465","2023-01-02"
"57070","2022","COM","2020","247","2","249","2023-01-02"
"57071","2022","COM","2020","380","5","385","2023-01-02"
"57072","2022","COM","2020","623","8","631","2023-01-02"
"57073","2022","COM","2020","863","16","879","2023-01-02"
"57074","2022","COM","2020","820","17","837","2023-01-02"
"57075","2022","COM","2020","294","3","297","2023-01-02"
"57076","2022","COM","2020","512","16","528","2023-01-02"
"57077","2022","COM","2020","97","3","100","2023-01-02"
"57079","2022","COM","2020","448","9","457","2023-01-02"
"57080","2022","COM","2020","83","0","83","2023-01-02"
"57081","2022","COM","2020","132","1","133","2023-01-02"
"57082","2022","COM","2020","334","7","341","2023-01-02"
"57083","2022","COM","2020","1195","22","1217","2023-01-02"
"57084","2022","COM","2020","301","2","303","2023-01-02"
"57085","2022","COM","2020","386","2","388","2023-01-02"
"57086","2022","COM","2020","232","5","237","2023-01-02"
"57087","2022","COM","2020","251","4","255","2023-01-02"
"57088","2022","COM","2020","310","7","317","2023-01-02"
"57089","2022","COM","2020","4955","101","5056","2023-01-02"
"57090","2022","COM","2020","110","2","112","2023-01-02"
"57091","2022","COM","2020","1007","22","1029","2023-01-02"
"57092","2022","COM","2020","616","8","624","2023-01-02"
"57093","2022","COM","2020","650","12","662","2023-01-02"
"57095","2022","COM","2020","576","10","586","2023-01-02"
"57096","2022","COM","2020","2469","47","2516","2023-01-02"
"57097","2022","COM","2020","5565","70","5635","2023-01-02"
"57098","2022","COM","2020","236","13","249","2023-01-02"
"57099","2022","COM","2020","236","5","241","2023-01-02"
"57100","2022","COM","2020","175","6","181","2023-01-02"
"57101","2022","COM","2020","1228","23","1251","2023-01-02"
"57102","2022","COM","2020","3209","49","3258","2023-01-02"
"57103","2022","COM","2020","122","2","124","2023-01-02"
"57104","2022","COM","2020","1156","27","1183","2023-01-02"
"57105","2022","COM","2020","151","1","152","2023-01-02"
"57106","2022","COM","2020","3926","75","4001","2023-01-02"
"57107","2022","COM","2020","106","0","106","2023-01-02"
"57108","2022","COM","2020","313","5","318","2023-01-02"
"57109","2022","COM","2020","792","12","804","2023-01-02"
"57110","2022","COM","2020","425","2","427","2023-01-02"
"57111","2022","COM","2020","518","3","521","2023-01-02"
"57112","2022","COM","2020","83","0","83","2023-01-02"
"57113","2022","COM","2020","971","19","990","2023-01-02"
"57114","2022","COM","2020","436","16","452","2023-01-02"
"57115","2022","COM","2020","98","4","102","2023-01-02"
"57116","2022","COM","2020","93","1","94","2023-01-02"
"57117","2022","COM","2020","581","15","596","2023-01-02"
"57118","2022","COM","2020","165","6","171","2023-01-02"
"57119","2022","COM","2020","1199","33","1232","2023-01-02"
"57120","2022","COM","2020","118","3","121","2023-01-02"
"57121","2022","COM","2020","220","5","225","2023-01-02"
"57122","2022","COM","2020","677","12","689","2023-01-02"
"57123","2022","COM","2020","3414","42","3456","2023-01-02"
"57124","2022","COM","2020","2619","34","2653","2023-01-02"
"57125","2022","COM","2020","425","7","432","2023-01-02"
"57126","2022","COM","2020","322","9","331","2023-01-02"
"57127","2022","COM","2020","148","1","149","2023-01-02"
"57128","2022","COM","2020","309","8","317","2023-01-02"
"57129","2022","COM","2020","734","23","757","2023-01-02"
"57130","2022","COM","2020","74","1","75","2023-01-02"
"57131","2022","COM","2020","296","11","307","2023-01-02"
"57132","2022","COM","2020","2304","238","2542","2023-01-02"
"57133","2022","COM","2020","93","0","93","2023-01-02"
"57134","2022","COM","2020","1913","192","2105","2023-01-02"
"57136","2022","COM","2020","573","17","590","2023-01-02"
"57137","2022","COM","2020","807","14","821","2023-01-02"
"57138","2022","COM","2020","82","3","85","2023-01-02"
"57139","2022","COM","2020","284","6","290","2023-01-02"
"57140","2022","COM","2020","571","10","581","2023-01-02"
"57141","2022","COM","2020","89","0","89","2023-01-02"
"57142","2022","COM","2020","424","8","432","2023-01-02"
"57143","2022","COM","2020","3369","32","3401","2023-01-02"
"57144","2022","COM","2020","3355","41","3396","2023-01-02"
"57145","2022","COM","2020","325","5","330","2023-01-02"
"57146","2022","COM","2020","804","19","823","2023-01-02"
"57147","2022","COM","2020","337","14","351","2023-01-02"
"57148","2022","COM","2020","568","11","579","2023-01-02"
"57149","2022","COM","2020","202","4","206","2023-01-02"
"57150","2022","COM","2020","692","9","701","2023-01-02"
"57151","2022","COM","2020","147","2","149","2023-01-02"
"57152","2022","COM","2020","514","8","522","2023-01-02"
"57153","2022","COM","2020","2168","38","2206","2023-01-02"
"57154","2022","COM","2020","620","19","639","2023-01-02"
"57155","2022","COM","2020","2961","325","3286","2023-01-02"
"57156","2022","COM","2020","1169","12","1181","2023-01-02"
"57158","2022","COM","2020","240","5","245","2023-01-02"
"57159","2022","COM","2020","3854","55","3909","2023-01-02"
"57160","2022","COM","2020","12772","203","12975","2023-01-02"
"57161","2022","COM","2020","105","1","106","2023-01-02"
"57162","2022","COM","2020","903","15","918","2023-01-02"
"57163","2022","COM","2020","2384","46","2430","2023-01-02"
"57165","2022","COM","2020","695","9","704","2023-01-02"
"57166","2022","COM","2020","104","2","106","2023-01-02"
"57167","2022","COM","2020","376","6","382","2023-01-02"
"57168","2022","COM","2020","676","16","692","2023-01-02"
"57169","2022","COM","2020","496","16","512","2023-01-02"
"57171","2022","COM","2020","1151","13","1164","2023-01-02"
"57172","2022","COM","2020","284","1","285","2023-01-02"
"57173","2022","COM","2020","101","3","104","2023-01-02"
"57174","2022","COM","2020","101","1","102","2023-01-02"
"57175","2022","COM","2020","224","7","231","2023-01-02"
"57176","2022","COM","2020","1677","37","1714","2023-01-02"
"57177","2022","COM","2020","2795","209","3004","2023-01-02"
"57178","2022","COM","2020","351","4","355","2023-01-02"
"57179","2022","COM","2020","1830","33","1863","2023-01-02"
"57180","2022","COM","2020","342","9","351","2023-01-02"
"57181","2022","COM","2020","84","2","86","2023-01-02"
"57182","2022","COM","2020","95","1","96","2023-01-02"
"57183","2022","COM","2020","189","2","191","2023-01-02"
"57186","2022","COM","2020","956","11","967","2023-01-02"
"57187","2022","COM","2020","363","7","370","2023-01-02"
"57188","2022","COM","2020","424","104","528","2023-01-02"
"57189","2022","COM","2020","225","2","227","2023-01-02"
"57190","2022","COM","2020","418","2","420","2023-01-02"
"57191","2022","COM","2020","694","16","710","2023-01-02"
"57192","2022","COM","2020","1218","32","1250","2023-01-02"
"57193","2022","COM","2020","2230","26","2256","2023-01-02"
"57194","2022","COM","2020","1229","34","1263","2023-01-02"
"57195","2022","COM","2020","562","15","577","2023-01-02"
"57196","2022","COM","2020","423","12","435","2023-01-02"
"57197","2022","COM","2020","510","8","518","2023-01-02"
"57198","2022","COM","2020","192","3","195","2023-01-02"
"57199","2022","COM","2020","690","15","705","2023-01-02"
"57200","2022","COM","2020","397","10","407","2023-01-02"
"57201","2022","COM","2020","720","12","732","2023-01-02"
"57202","2022","COM","2020","1155","17","1172","2023-01-02"
"57203","2022","COM","2020","222","4","226","2023-01-02"
"57204","2022","COM","2020","536","10","546","2023-01-02"
"57205","2022","COM","2020","2520","33","2553","2023-01-02"
"57206","2022","COM","2020","14829","168","14997","2023-01-02"
"57207","2022","COM","2020","5406","47","5453","2023-01-02"
"57208","2022","COM","2020","1340","34","1374","2023-01-02"
"57209","2022","COM","2020","5157","84","5241","2023-01-02"
"57210","2022","COM","2020","664","19","683","2023-01-02"
"57211","2022","COM","2020","1204","11","1215","2023-01-02"
"57212","2022","COM","2020","731","9","740","2023-01-02"
"57213","2022","COM","2020","772","13","785","2023-01-02"
"57214","2022","COM","2020","408","7","415","2023-01-02"
"57215","2022","COM","2020","340","3","343","2023-01-02"
"57216","2022","COM","2020","142","5","147","2023-01-02"
"57217","2022","COM","2020","892","18","910","2023-01-02"
"57218","2022","COM","2020","1287","22","1309","2023-01-02"
"57219","2022","COM","2020","560","6","566","2023-01-02"
"57220","2022","COM","2020","117","2","119","2023-01-02"
"57221","2022","COM","2020","11939","101","12040","2023-01-02"
"57222","2022","COM","2020","1354","39","1393","2023-01-02"
"57224","2022","COM","2020","3949","70","4019","2023-01-02"
"57225","2022","COM","2020","140","2","142","2023-01-02"
"57226","2022","COM","2020","3132","41","3173","2023-01-02"
"57227","2022","COM","2020","21509","288","21797","2023-01-02"
"57228","2022","COM","2020","191","5","196","2023-01-02"
"57229","2022","COM","2020","153","2","155","2023-01-02"
"57230","2022","COM","2020","194","2","196","2023-01-02"
"57231","2022","COM","2020","100","0","100","2023-01-02"
"57232","2022","COM","2020","778","12","790","2023-01-02"
"57233","2022","COM","2020","86","1","87","2023-01-02"
"57234","2022","COM","2020","599","8","607","2023-01-02"
"57235","2022","COM","2020","1031","20","1051","2023-01-02"
"57236","2022","COM","2020","88","0","88","2023-01-02"
"57237","2022","COM","2020","304","7","311","2023-01-02"
"57238","2022","COM","2020","193","6","199","2023-01-02"
"57239","2022","COM","2020","432","6","438","2023-01-02"
"57240","2022","COM","2020","12840","112","12952","2023-01-02"
"57241","2022","COM","2020","165","8","173","2023-01-02"
"57242","2022","COM","2020","3035","33","3068","2023-01-02"
"57244","2022","COM","2020","492","12","504","2023-01-02"
"57245","2022","COM","2020","570","9","579","2023-01-02"
"57246","2022","COM","2020","217","4","221","2023-01-02"
"57247","2022","COM","2020","77","3","80","2023-01-02"
"57248","2022","COM","2020","86","2","88","2023-01-02"
"57249","2022","COM","2020","259","7","266","2023-01-02"
"57250","2022","COM","2020","1465","40","1505","2023-01-02"
"57251","2022","COM","2020","344","2","346","2023-01-02"
"57252","2022","COM","2020","474","10","484","2023-01-02"
"57253","2022","COM","2020","502","6","508","2023-01-02"
"57254","2022","COM","2020","1155","9","1164","2023-01-02"
"57255","2022","COM","2020","568","23","591","2023-01-02"
"57256","2022","COM","2020","821","4","825","2023-01-02"
"57257","2022","COM","2020","104","1","105","2023-01-02"
"57258","2022","COM","2020","115","1","116","2023-01-02"
"57259","2022","COM","2020","316","10","326","2023-01-02"
"57260","2022","COM","2020","3319","52","3371","2023-01-02"
"57261","2022","COM","2020","1324","30","1354","2023-01-02"
"57262","2022","COM","2020","658","7","665","2023-01-02"
"57263","2022","COM","2020","654","19","673","2023-01-02"
"57264","2022","COM","2020","404","6","410","2023-01-02"
"57265","2022","COM","2020","59","3","62","2023-01-02"
"57266","2022","COM","2020","146","3","149","2023-01-02"
"57267","2022","COM","2020","832","12","844","2023-01-02"
"57268","2022","COM","2020","123","1","124","2023-01-02"
"57269","2022","COM","2020","7594","67","7661","2023-01-02"
"57270","2022","COM","2020","562","6","568","2023-01-02"
"57271","2022","COM","2020","678","17","695","2023-01-02"
"57272","2022","COM","2020","88","4","92","2023-01-02"
"57273","2022","COM","2020","385","9","394","2023-01-02"
"57274","2022","COM","2020","863","15","878","2023-01-02"
"57275","2022","COM","2020","918","12","930","2023-01-02"
"57276","2022","COM","2020","335","4","339","2023-01-02"
"57277","2022","COM","2020","147","5","152","2023-01-02"
"57278","2022","COM","2020","65","0","65","2023-01-02"
"57280","2022","COM","2020","362","20","382","2023-01-02"
"57281","2022","COM","2020","235","5","240","2023-01-02"
"57282","2022","COM","2020","354","4","358","2023-01-02"
"57283","2022","COM","2020","9332","105","9437","2023-01-02"
"57284","2022","COM","2020","113","5","118","2023-01-02"
"57286","2022","COM","2020","305","8","313","2023-01-02"
"57287","2022","COM","2020","2221","44","2265","2023-01-02"
"57288","2022","COM","2020","2862","40","2902","2023-01-02"
"57289","2022","COM","2020","2864","66","2930","2023-01-02"
"57290","2022","COM","2020","176","2","178","2023-01-02"
"57291","2022","COM","2020","262","5","267","2023-01-02"
"57292","2022","COM","2020","19","0","19","2023-01-02"
"57293","2022","COM","2020","257","6","263","2023-01-02"
"57294","2022","COM","2020","195","7","202","2023-01-02"
"57295","2022","COM","2020","105","1","106","2023-01-02"
"57296","2022","COM","2020","1095","20","1115","2023-01-02"
"57297","2022","COM","2020","184","6","190","2023-01-02"
"57298","2022","COM","2020","377","7","384","2023-01-02"
"57299","2022","COM","2020","926","17","943","2023-01-02"
"57300","2022","COM","2020","319","5","324","2023-01-02"
"57301","2022","COM","2020","303","12","315","2023-01-02"
"57302","2022","COM","2020","189","1","190","2023-01-02"
"57303","2022","COM","2020","596","9","605","2023-01-02"
"57304","2022","COM","2020","355","9","364","2023-01-02"
"57305","2022","COM","2020","451","6","457","2023-01-02"
"57306","2022","COM","2020","15994","192","16186","2023-01-02"
"57307","2022","COM","2020","251","5","256","2023-01-02"
"57308","2022","COM","2020","149","5","154","2023-01-02"
"57309","2022","COM","2020","481","9","490","2023-01-02"
"57310","2022","COM","2020","192","5","197","2023-01-02"
"57311","2022","COM","2020","518","10","528","2023-01-02"
"57312","2022","COM","2020","492","8","500","2023-01-02"
"57313","2022","COM","2020","142","3","145","2023-01-02"
"57314","2022","COM","2020","496","5","501","2023-01-02"
"57315","2022","COM","2020","709","21","730","2023-01-02"
"57316","2022","COM","2020","750","16","766","2023-01-02"
"57317","2022","COM","2020","107","1","108","2023-01-02"
"57318","2022","COM","2020","216","5","221","2023-01-02"
"57319","2022","COM","2020","526","5","531","2023-01-02"
"57320","2022","COM","2020","182","3","185","2023-01-02"
"57321","2022","COM","2020","559","21","580","2023-01-02"
"57322","2022","COM","2020","474","6","480","2023-01-02"
"57323","2022","COM","2020","7753","168","7921","2023-01-02"
"57324","2022","COM","2020","615","23","638","2023-01-02"
"57325","2022","COM","2020","825","16","841","2023-01-02"
"57326","2022","COM","2020","336","4","340","2023-01-02"
"57328","2022","COM","2020","90","1","91","2023-01-02"
"57329","2022","COM","2020","430","11","441","2023-01-02"
"57330","2022","COM","2020","1280","20","1300","2023-01-02"
"57331","2022","COM","2020","553","11","564","2023-01-02"
"57332","2022","COM","2020","6275","55","6330","2023-01-02"
"57333","2022","COM","2020","827","24","851","2023-01-02"
"57334","2022","COM","2020","319","4","323","2023-01-02"
"57335","2022","COM","2020","218","4","222","2023-01-02"
"57336","2022","COM","2020","5205","57","5262","2023-01-02"
"57337","2022","COM","2020","584","17","601","2023-01-02"
"57338","2022","COM","2020","512","5","517","2023-01-02"
"57339","2022","COM","2020","366","5","371","2023-01-02"
"57340","2022","COM","2020","1355","20","1375","2023-01-02"
"57341","2022","COM","2020","707","16","723","2023-01-02"
"57342","2022","COM","2020","94","0","94","2023-01-02"
"57343","2022","COM","2020","1814","30","1844","2023-01-02"
"57344","2022","COM","2020","737","8","745","2023-01-02"
"57345","2022","COM","2020","412","32","444","2023-01-02"
"57346","2022","COM","2020","593","9","602","2023-01-02"
"57347","2022","COM","2020","173","5","178","2023-01-02"
"57348","2022","COM","2020","797","17","814","2023-01-02"
"57349","2022","COM","2020","148","3","151","2023-01-02"
"57350","2022","COM","2020","1424","20","1444","2023-01-02"
"57351","2022","COM","2020","1317","18","1335","2023-01-02"
"57352","2022","COM","2020","446","16","462","2023-01-02"
"57353","2022","COM","2020","72","1","73","2023-01-02"
"57354","2022","COM","2020","121","5","126","2023-01-02"
"57355","2022","COM","2020","799","19","818","2023-01-02"
"57356","2022","COM","2020","1210","38","1248","2023-01-02"
"57357","2022","COM","2020","407","2","409","2023-01-02"
"57358","2022","COM","2020","1080","24","1104","2023-01-02"
"57359","2022","COM","2020","172","4","176","2023-01-02"
"57360","2022","COM","2020","1207","22","1229","2023-01-02"
"57361","2022","COM","2020","610","18","628","2023-01-02"
"57362","2022","COM","2020","182","5","187","2023-01-02"
"57364","2022","COM","2020","314","7","321","2023-01-02"
"57365","2022","COM","2020","471","11","482","2023-01-02"
"57366","2022","COM","2020","139","2","141","2023-01-02"
"57367","2022","COM","2020","218","4","222","2023-01-02"
"57368","2022","COM","2020","3197","48","3245","2023-01-02"
"57370","2022","COM","2020","2278","40","2318","2023-01-02"
"57371","2022","COM","2020","586","7","593","2023-01-02"
"57372","2022","COM","2020","1360","26","1386","2023-01-02"
"57373","2022","COM","2020","926","19","945","2023-01-02"
"57374","2022","COM","2020","198","6","204","2023-01-02"
"57375","2022","COM","2020","185","5","190","2023-01-02"
"57376","2022","COM","2020","492","7","499","2023-01-02"
"57377","2022","COM","2020","247","4","251","2023-01-02"
"57379","2022","COM","2020","272","2","274","2023-01-02"
"57380","2022","COM","2020","106","2","108","2023-01-02"
"57381","2022","COM","2020","286","6","292","2023-01-02"
"57382","2022","COM","2020","581","8","589","2023-01-02"
"57383","2022","COM","2020","160","6","166","2023-01-02"
"57384","2022","COM","2020","623","18","641","2023-01-02"
"57385","2022","COM","2020","1258","23","1281","2023-01-02"
"57386","2022","COM","2020","346","7","353","2023-01-02"
"57387","2022","COM","2020","293","1","294","2023-01-02"
"57388","2022","COM","2020","258","7","265","2023-01-02"
"57389","2022","COM","2020","465","12","477","2023-01-02"
"57390","2022","COM","2020","1420","38","1458","2023-01-02"
"57391","2022","COM","2020","63","2","65","2023-01-02"
"57392","2022","COM","2020","539","4","543","2023-01-02"
"57393","2022","COM","2020","196","3","199","2023-01-02"
"57394","2022","COM","2020","346","12","358","2023-01-02"
"57395","2022","COM","2020","204","4","208","2023-01-02"
"57396","2022","COM","2020","736","27","763","2023-01-02"
"57397","2022","COM","2020","102","0","102","2023-01-02"
"57398","2022","COM","2020","506","10","516","2023-01-02"
"57399","2022","COM","2020","91","7","98","2023-01-02"
"57401","2022","COM","2020","84","1","85","2023-01-02"
"57402","2022","COM","2020","119","1","120","2023-01-02"
"57403","2022","COM","2020","129","0","129","2023-01-02"
"57404","2022","COM","2020","210","6","216","2023-01-02"
"57405","2022","COM","2020","54","0","54","2023-01-02"
"57406","2022","COM","2020","141","3","144","2023-01-02"
"57407","2022","COM","2020","589","6","595","2023-01-02"
"57408","2022","COM","2020","847","18","865","2023-01-02"
"57409","2022","COM","2020","670","15","685","2023-01-02"
"57410","2022","COM","2020","140","3","143","2023-01-02"
"57411","2022","COM","2020","350","1","351","2023-01-02"
"57412","2022","COM","2020","3926","64","3990","2023-01-02"
"57413","2022","COM","2020","3627","82","3709","2023-01-02"
"57414","2022","COM","2020","1144","25","1169","2023-01-02"
"57415","2022","COM","2020","1737","75","1812","2023-01-02"
"57416","2022","COM","2020","664","8","672","2023-01-02"
"57417","2022","COM","2020","69","3","72","2023-01-02"
"57418","2022","COM","2020","323","3","326","2023-01-02"
"57419","2022","COM","2020","902","20","922","2023-01-02"
"57421","2022","COM","2020","154","3","157","2023-01-02"
"57422","2022","COM","2020","883","11","894","2023-01-02"
"57423","2022","COM","2020","72","1","73","2023-01-02"
"57424","2022","COM","2020","235","2","237","2023-01-02"
"57425","2022","COM","2020","575","4","579","2023-01-02"
"57426","2022","COM","2020","900","9","909","2023-01-02"
"57427","2022","COM","2020","565","10","575","2023-01-02"
"57428","2022","COM","2020","2778","50","2828","2023-01-02"
"57430","2022","COM","2020","327","5","332","2023-01-02"
"57431","2022","COM","2020","409","3","412","2023-01-02"
"57433","2022","COM","2020","11776","116","11892","2023-01-02"
"57434","2022","COM","2020","482","9","491","2023-01-02"
"57436","2022","COM","2020","129","6","135","2023-01-02"
"57437","2022","COM","2020","647","13","660","2023-01-02"
"57438","2022","COM","2020","350","5","355","2023-01-02"
"57439","2022","COM","2020","602","13","615","2023-01-02"
"57440","2022","COM","2020","141","3","144","2023-01-02"
"57441","2022","COM","2020","2947","61","3008","2023-01-02"
"57442","2022","COM","2020","238","2","240","2023-01-02"
"57443","2022","COM","2020","6446","56","6502","2023-01-02"
"57444","2022","COM","2020","358","5","363","2023-01-02"
"57445","2022","COM","2020","700","11","711","2023-01-02"
"57446","2022","COM","2020","45","0","45","2023-01-02"
"57447","2022","COM","2020","9961","226","10187","2023-01-02"
"57448","2022","COM","2020","245","6","251","2023-01-02"
"57449","2022","COM","2020","594","3","597","2023-01-02"
"57451","2022","COM","2020","168","4","172","2023-01-02"
"57452","2022","COM","2020","1034","15","1049","2023-01-02"
"57453","2022","COM","2020","297","11","308","2023-01-02"
"57454","2022","COM","2020","1187","25","1212","2023-01-02"
"57455","2022","COM","2020","143","3","146","2023-01-02"
"57456","2022","COM","2020","662","24","686","2023-01-02"
"57457","2022","COM","2020","137","2","139","2023-01-02"
"57459","2022","COM","2020","289","2","291","2023-01-02"
"57460","2022","COM","2020","1471","17","1488","2023-01-02"
"57461","2022","COM","2020","276","8","284","2023-01-02"
"57462","2022","COM","2020","431","7","438","2023-01-02"
"57463","2022","COM","2020","120211","1825","122036","2023-01-02"
"57464","2022","COM","2020","978","28","1006","2023-01-02"
"57465","2022","COM","2020","2268","51","2319","2023-01-02"
"57466","2022","COM","2020","665","9","674","2023-01-02"
"57467","2022","COM","2020","308","2","310","2023-01-02"
"57468","2022","COM","2020","673","17","690","2023-01-02"
"57469","2022","COM","2020","595","4","599","2023-01-02"
"57470","2022","COM","2020","4","0","4","2023-01-02"
"57471","2022","COM","2020","297","3","300","2023-01-02"
"57472","2022","COM","2020","147","0","147","2023-01-02"
"57473","2022","COM","2020","65","2","67","2023-01-02"
"57474","2022","COM","2020","5701","57","5758","2023-01-02"
"57475","2022","COM","2020","527","15","542","2023-01-02"
"57476","2022","COM","2020","407","10","417","2023-01-02"
"57477","2022","COM","2020","1597","44","1641","2023-01-02"
"57478","2022","COM","2020","86","0","86","2023-01-02"
"57479","2022","COM","2020","479","12","491","2023-01-02"
"57480","2022","COM","2020","21788","347","22135","2023-01-02"
"57481","2022","COM","2020","2730","17","2747","2023-01-02"
"57482","2022","COM","2020","1777","29","1806","2023-01-02"
"57483","2022","COM","2020","3390","85","3475","2023-01-02"
"57484","2022","COM","2020","2675","28","2703","2023-01-02"
"57485","2022","COM","2020","124","2","126","2023-01-02"
"57486","2022","COM","2020","116","1","117","2023-01-02"
"57487","2022","COM","2020","5021","58","5079","2023-01-02"
"57488","2022","COM","2020","561","8","569","2023-01-02"
"57489","2022","COM","2020","288","0","288","2023-01-02"
"57490","2022","COM","2020","341","4","345","2023-01-02"
"57491","2022","COM","2020","7349","63","7412","2023-01-02"
"57492","2022","COM","2020","448","9","457","2023-01-02"
"57493","2022","COM","2020","211","4","215","2023-01-02"
"57494","2022","COM","2020","236","0","236","2023-01-02"
"57495","2022","COM","2020","115","1","116","2023-01-02"
"57496","2022","COM","2020","334","6","340","2023-01-02"
"57497","2022","COM","2020","262","9","271","2023-01-02"
"57498","2022","COM","2020","2593","53","2646","2023-01-02"
"57499","2022","COM","2020","1357","30","1387","2023-01-02"
"57500","2022","COM","2020","43","0","43","2023-01-02"
"57501","2022","COM","2020","40","0","40","2023-01-02"
"57502","2022","COM","2020","331","12","343","2023-01-02"
"57504","2022","COM","2020","278","5","283","2023-01-02"
"57505","2022","COM","2020","1192","22","1214","2023-01-02"
"57506","2022","COM","2020","247","5","252","2023-01-02"
"57507","2022","COM","2020","271","2","273","2023-01-02"
"57508","2022","COM","2020","4430","53","4483","2023-01-02"
"57509","2022","COM","2020","487","11","498","2023-01-02"
"57510","2022","COM","2020","1108","11","1119","2023-01-02"
"57511","2022","COM","2020","1019","21","1040","2023-01-02"
"57512","2022","COM","2020","712","11","723","2023-01-02"
"57513","2022","COM","2020","154","1","155","2023-01-02"
"57514","2022","COM","2020","1186","25","1211","2023-01-02"
"57515","2022","COM","2020","1836","25","1861","2023-01-02"
"57516","2022","COM","2020","339","10","349","2023-01-02"
"57517","2022","COM","2020","279","4","283","2023-01-02"
"57518","2022","COM","2020","327","10","337","2023-01-02"
"57519","2022","COM","2020","160","3","163","2023-01-02"
"57520","2022","COM","2020","32","1","33","2023-01-02"
"57521","2022","COM","2020","2711","54","2765","2023-01-02"
"57524","2022","COM","2020","129","1","130","2023-01-02"
"57525","2022","COM","2020","55","1","56","2023-01-02"
"57526","2022","COM","2020","378","1","379","2023-01-02"
"57527","2022","COM","2020","357","4","361","2023-01-02"
"57528","2022","COM","2020","105","1","106","2023-01-02"
"57529","2022","COM","2020","3127","66","3193","2023-01-02"
"57530","2022","COM","2020","438","6","444","2023-01-02"
"57531","2022","COM","2020","742","12","754","2023-01-02"
"57532","2022","COM","2020","230","3","233","2023-01-02"
"57533","2022","COM","2020","876","18","894","2023-01-02"
"57534","2022","COM","2020","1830","123","1953","2023-01-02"
"57535","2022","COM","2020","1426","33","1459","2023-01-02"
"57536","2022","COM","2020","219","3","222","2023-01-02"
"57537","2022","COM","2020","6257","67","6324","2023-01-02"
"57538","2022","COM","2020","296","3","299","2023-01-02"
"57539","2022","COM","2020","45","3","48","2023-01-02"
"57540","2022","COM","2020","4700","239","4939","2023-01-02"
"57541","2022","COM","2020","600","13","613","2023-01-02"
"57542","2022","COM","2020","973","10","983","2023-01-02"
"57543","2022","COM","2020","1495","22","1517","2023-01-02"
"57544","2022","COM","2020","610","17","627","2023-01-02"
"57545","2022","COM","2020","2032","56","2088","2023-01-02"
"57546","2022","COM","2020","803","31","834","2023-01-02"
"57547","2022","COM","2020","709","10","719","2023-01-02"
"57548","2022","COM","2020","581","7","588","2023-01-02"
"57549","2022","COM","2020","743","14","757","2023-01-02"
"57550","2022","COM","2020","2473","65","2538","2023-01-02"
"57551","2022","COM","2020","208","7","215","2023-01-02"
"57552","2022","COM","2020","727","10","737","2023-01-02"
"57553","2022","COM","2020","624","13","637","2023-01-02"
"57554","2022","COM","2020","710","21","731","2023-01-02"
"57555","2022","COM","2020","112","0","112","2023-01-02"
"57556","2022","COM","2020","3081","46","3127","2023-01-02"
"57557","2022","COM","2020","1016","24","1040","2023-01-02"
"57558","2022","COM","2020","77","0","77","2023-01-02"
"57559","2022","COM","2020","170","0","170","2023-01-02"
"57560","2022","COM","2020","621","13","634","2023-01-02"
"57561","2022","COM","2020","722","20","742","2023-01-02"
"57562","2022","COM","2020","865","18","883","2023-01-02"
"57563","2022","COM","2020","250","2","252","2023-01-02"
"57564","2022","COM","2020","564","14","578","2023-01-02"
"57565","2022","COM","2020","996","19","1015","2023-01-02"
"57566","2022","COM","2020","2349","64","2413","2023-01-02"
"57567","2022","COM","2020","146","1","147","2023-01-02"
"57568","2022","COM","2020","1367","23","1390","2023-01-02"
"57569","2022","COM","2020","320","6","326","2023-01-02"
"57570","2022","COM","2020","416","5","421","2023-01-02"
"57571","2022","COM","2020","1040","32","1072","2023-01-02"
"57572","2022","COM","2020","2009","100","2109","2023-01-02"
"57573","2022","COM","2020","134","2","136","2023-01-02"
"57574","2022","COM","2020","522","13","535","2023-01-02"
"57575","2022","COM","2020","1344","30","1374","2023-01-02"
"57576","2022","COM","2020","796","54","850","2023-01-02"
"57577","2022","COM","2020","371","6","377","2023-01-02"
"57578","2022","COM","2020","494","7","501","2023-01-02"
"57579","2022","COM","2020","128","1","129","2023-01-02"
"57580","2022","COM","2020","187","2","189","2023-01-02"
"57581","2022","COM","2020","351","7","358","2023-01-02"
"57582","2022","COM","2020","2090","44","2134","2023-01-02"
"57583","2022","COM","2020","129","6","135","2023-01-02"
"57584","2022","COM","2020","656","17","673","2023-01-02"
"57586","2022","COM","2020","186","2","188","2023-01-02"
"57587","2022","COM","2020","248","3","251","2023-01-02"
"57588","2022","COM","2020","1292","33","1325","2023-01-02"
"57589","2022","COM","2020","2305","50","2355","2023-01-02"
"57590","2022","COM","2020","259","6","265","2023-01-02"
"57591","2022","COM","2020","9864","91","9955","2023-01-02"
"57592","2022","COM","2020","344","7","351","2023-01-02"
"57593","2022","COM","2020","1029","11","1040","2023-01-02"
"57594","2022","COM","2020","98","3","101","2023-01-02"
"57595","2022","COM","2020","49","0","49","2023-01-02"
"57596","2022","COM","2020","740","11","751","2023-01-02"
"57597","2022","COM","2020","2567","25","2592","2023-01-02"
"57598","2022","COM","2020","1995","53","2048","2023-01-02"
"57599","2022","COM","2020","361","8","369","2023-01-02"
"57600","2022","COM","2020","1443","25","1468","2023-01-02"
"57601","2022","COM","2020","1322","41","1363","2023-01-02"
"57602","2022","COM","2020","2399","53","2452","2023-01-02"
"57603","2022","COM","2020","1268","22","1290","2023-01-02"
"57604","2022","COM","2020","630","5","635","2023-01-02"
"57605","2022","COM","2020","303","2","305","2023-01-02"
"57606","2022","COM","2020","15171","323","15494","2023-01-02"
"57607","2022","COM","2020","769","10","779","2023-01-02"
"57609","2022","COM","2020","173","2","175","2023-01-02"
"57610","2022","COM","2020","311","6","317","2023-01-02"
"57611","2022","COM","2020","197","6","203","2023-01-02"
"57612","2022","COM","2020","237","5","242","2023-01-02"
"57613","2022","COM","2020","344","5","349","2023-01-02"
"57614","2022","COM","2020","703","4","707","2023-01-02"
"57615","2022","COM","2020","969","19","988","2023-01-02"
"57616","2022","COM","2020","3467","64","3531","2023-01-02"
"57617","2022","COM","2020","283","6","289","2023-01-02"
"57618","2022","COM","2020","642","18","660","2023-01-02"
"57619","2022","COM","2020","467","9","476","2023-01-02"
"57620","2022","COM","2020","4463","59","4522","2023-01-02"
"57621","2022","COM","2020","109","1","110","2023-01-02"
"57622","2022","COM","2020","1897","23","1920","2023-01-02"
"57623","2022","COM","2020","705","49","754","2023-01-02"
"57624","2022","COM","2020","570","31","601","2023-01-02"
"57625","2022","COM","2020","174","2","176","2023-01-02"
"57626","2022","COM","2020","523","12","535","2023-01-02"
"57627","2022","COM","2020","357","3","360","2023-01-02"
"57628","2022","COM","2020","4450","90","4540","2023-01-02"
"57629","2022","COM","2020","780","6","786","2023-01-02"
"57630","2022","COM","2020","12278","304","12582","2023-01-02"
"57631","2022","COM","2020","20555","462","21017","2023-01-02"
"57633","2022","COM","2020","1261","32","1293","2023-01-02"
"57634","2022","COM","2020","1511","40","1551","2023-01-02"
"57635","2022","COM","2020","368","7","375","2023-01-02"
"57636","2022","COM","2020","322","8","330","2023-01-02"
"57637","2022","COM","2020","307","7","314","2023-01-02"
"57638","2022","COM","2020","2473","41","2514","2023-01-02"
"57639","2022","COM","2020","536","9","545","2023-01-02"
"57640","2022","COM","2020","474","14","488","2023-01-02"
"57641","2022","COM","2020","309","6","315","2023-01-02"
"57642","2022","COM","2020","2665","52","2717","2023-01-02"
"57643","2022","COM","2020","201","6","207","2023-01-02"
"57644","2022","COM","2020","1741","44","1785","2023-01-02"
"57645","2022","COM","2020","1021","9","1030","2023-01-02"
"57647","2022","COM","2020","4164","56","4220","2023-01-02"
"57648","2022","COM","2020","501","5","506","2023-01-02"
"57649","2022","COM","2020","478","4","482","2023-01-02"
"57650","2022","COM","2020","1776","13","1789","2023-01-02"
"57651","2022","COM","2020","639","6","645","2023-01-02"
"57652","2022","COM","2020","584","6","590","2023-01-02"
"57653","2022","COM","2020","33","1","34","2023-01-02"
"57654","2022","COM","2020","703","11","714","2023-01-02"
"57655","2022","COM","2020","1124","53","1177","2023-01-02"
"57656","2022","COM","2020","385","6","391","2023-01-02"
"57657","2022","COM","2020","21","0","21","2023-01-02"
"57658","2022","COM","2020","1038","20","1058","2023-01-02"
"57659","2022","COM","2020","3227","56","3283","2023-01-02"
"57660","2022","COM","2020","11043","131","11174","2023-01-02"
"57661","2022","COM","2020","172","1","173","2023-01-02"
"57662","2022","COM","2020","98","1","99","2023-01-02"
"57663","2022","COM","2020","7832","177","8009","2023-01-02"
"57664","2022","COM","2020","61","2","63","2023-01-02"
"57665","2022","COM","2020","1051","19","1070","2023-01-02"
"57666","2022","COM","2020","7328","93","7421","2023-01-02"
"57667","2022","COM","2020","775","8","783","2023-01-02"
"57668","2022","COM","2020","1264","34","1298","2023-01-02"
"57669","2022","COM","2020","2459","44","2503","2023-01-02"
"57670","2022","COM","2020","132","1","133","2023-01-02"
"57671","2022","COM","2020","154","0","154","2023-01-02"
"57672","2022","COM","2020","41383","734","42117","2023-01-02"
"57673","2022","COM","2020","49","1","50","2023-01-02"
"57674","2022","COM","2020","174","4","178","2023-01-02"
"57675","2022","COM","2020","118","1","119","2023-01-02"
"57676","2022","COM","2020","90","1","91","2023-01-02"
"57677","2022","COM","2020","1024","21","1045","2023-01-02"
"57678","2022","COM","2020","2301","30","2331","2023-01-02"
"57679","2022","COM","2020","526","10","536","2023-01-02"
"57680","2022","COM","2020","1255","29","1284","2023-01-02"
"57681","2022","COM","2020","334","5","339","2023-01-02"
"57682","2022","COM","2020","11","0","11","2023-01-02"
"57683","2022","COM","2020","6951","37","6988","2023-01-02"
"57684","2022","COM","2020","509","10","519","2023-01-02"
"57685","2022","COM","2020","150","3","153","2023-01-02"
"57686","2022","COM","2020","247","1","248","2023-01-02"
"57687","2022","COM","2020","212","4","216","2023-01-02"
"57689","2022","COM","2020","329","5","334","2023-01-02"
"57690","2022","COM","2020","2976","68","3044","2023-01-02"
"57691","2022","COM","2020","85","4","89","2023-01-02"
"57692","2022","COM","2020","73","0","73","2023-01-02"
"57693","2022","COM","2020","808","19","827","2023-01-02"
"57694","2022","COM","2020","452","11","463","2023-01-02"
"57695","2022","COM","2020","506","9","515","2023-01-02"
"57696","2022","COM","2020","968","24","992","2023-01-02"
"57697","2022","COM","2020","314","9","323","2023-01-02"
"57698","2022","COM","2020","314","6","320","2023-01-02"
"57700","2022","COM","2020","499","8","507","2023-01-02"
"57701","2022","COM","2020","816","26","842","2023-01-02"
"57702","2022","COM","2020","169","0","169","2023-01-02"
"57703","2022","COM","2020","234","17","251","2023-01-02"
"57704","2022","COM","2020","647","15","662","2023-01-02"
"57705","2022","COM","2020","209","5","214","2023-01-02"
"57706","2022","COM","2020","545","13","558","2023-01-02"
"57707","2022","COM","2020","670","6","676","2023-01-02"
"57708","2022","COM","2020","1981","44","2025","2023-01-02"
"57709","2022","COM","2020","310","7","317","2023-01-02"
"57711","2022","COM","2020","400","8","408","2023-01-02"
"57712","2022","COM","2020","1332","44","1376","2023-01-02"
"57713","2022","COM","2020","248","6","254","2023-01-02"
"57714","2022","COM","2020","442","9","451","2023-01-02"
"57715","2022","COM","2020","383","11","394","2023-01-02"
"57716","2022","COM","2020","1673","18","1691","2023-01-02"
"57717","2022","COM","2020","181","4","185","2023-01-02"
"57718","2022","COM","2020","216","1","217","2023-01-02"
"57719","2022","COM","2020","82","3","85","2023-01-02"
"57720","2022","COM","2020","501","12","513","2023-01-02"
"57721","2022","COM","2020","346","11","357","2023-01-02"
"57723","2022","COM","2020","293","6","299","2023-01-02"
"57724","2022","COM","2020","3019","32","3051","2023-01-02"
"57725","2022","COM","2020","343","7","350","2023-01-02"
"57726","2022","COM","2020","385","4","389","2023-01-02"
"57727","2022","COM","2020","124","1","125","2023-01-02"
"57728","2022","COM","2020","254","3","257","2023-01-02"
"57730","2022","COM","2020","565","14","579","2023-01-02"
"57731","2022","COM","2020","2308","41","2349","2023-01-02"
"57732","2022","COM","2020","768","20","788","2023-01-02"
"57733","2022","COM","2020","2048","29","2077","2023-01-02"
"57734","2022","COM","2020","458","9","467","2023-01-02"
"57736","2022","COM","2020","619","11","630","2023-01-02"
"57737","2022","COM","2020","32","2","34","2023-01-02"
"57738","2022","COM","2020","387","9","396","2023-01-02"
"57739","2022","COM","2020","510","5","515","2023-01-02"
"57740","2022","COM","2020","812","11","823","2023-01-02"
"57741","2022","COM","2020","408","12","420","2023-01-02"
"57742","2022","COM","2020","1496","42","1538","2023-01-02"
"57743","2022","COM","2020","241","7","248","2023-01-02"
"57745","2022","COM","2020","920","22","942","2023-01-02"
"57746","2022","COM","2020","1538","32","1570","2023-01-02"
"57747","2022","COM","2020","266","3","269","2023-01-02"
"57748","2022","COM","2020","752","19","771","2023-01-02"
"57749","2022","COM","2020","156","6","162","2023-01-02"
"57750","2022","COM","2020","710","26","736","2023-01-02"
"57751","2022","COM","2020","14526","123","14649","2023-01-02"
"57752","2022","COM","2020","2891","50","2941","2023-01-02"
"57753","2022","COM","2020","59","1","60","2023-01-02"
"57754","2022","COM","2020","109","1","110","2023-01-02"
"57755","2022","COM","2020","99","0","99","2023-01-02"
"57756","2022","COM","2020","314","4","318","2023-01-02"
"57757","2022","COM","2020","17304","276","17580","2023-01-02"
"57759","2022","COM","2020","66","1","67","2023-01-02"
"57760","2022","COM","2020","854","20","874","2023-01-02"
"57761","2022","COM","2020","273","4","277","2023-01-02"
"57762","2022","COM","2020","704","6","710","2023-01-02"
"57763","2022","COM","2020","47","2","49","2023-01-02"
"57764","2022","COM","2020","1253","17","1270","2023-01-02"
"57765","2022","COM","2020","1057","16","1073","2023-01-02"
"57767","2022","COM","2020","1336","34","1370","2023-01-02"
"58001","2022","COM","2020","159","0","159","2023-01-02"
"58002","2022","COM","2020","919","13","932","2023-01-02"
"58003","2022","COM","2020","601","7","608","2023-01-02"
"58004","2022","COM","2020","374","8","382","2023-01-02"
"58005","2022","COM","2020","222","4","226","2023-01-02"
"58006","2022","COM","2020","242","3","245","2023-01-02"
"58007","2022","COM","2020","344","5","349","2023-01-02"
"58008","2022","COM","2020","168","4","172","2023-01-02"
"58009","2022","COM","2020","126","1","127","2023-01-02"
"58010","2022","COM","2020","651","11","662","2023-01-02"
"58011","2022","COM","2020","283","5","288","2023-01-02"
"58012","2022","COM","2020","571","13","584","2023-01-02"
"58013","2022","COM","2020","95","2","97","2023-01-02"
"58014","2022","COM","2020","65","1","66","2023-01-02"
"58015","2022","COM","2020","119","3","122","2023-01-02"
"58016","2022","COM","2020","139","4","143","2023-01-02"
"58017","2022","COM","2020","225","7","232","2023-01-02"
"58018","2022","COM","2020","45","0","45","2023-01-02"
"58019","2022","COM","2020","84","2","86","2023-01-02"
"58020","2022","COM","2020","246","4","250","2023-01-02"
"58021","2022","COM","2020","203","5","208","2023-01-02"
"58023","2022","COM","2020","173","3","176","2023-01-02"
"58024","2022","COM","2020","280","11","291","2023-01-02"
"58025","2022","COM","2020","163","7","170","2023-01-02"
"58026","2022","COM","2020","141","9","150","2023-01-02"
"58027","2022","COM","2020","120","3","123","2023-01-02"
"58028","2022","COM","2020","118","3","121","2023-01-02"
"58029","2022","COM","2020","83","0","83","2023-01-02"
"58030","2022","COM","2020","282","12","294","2023-01-02"
"58031","2022","COM","2020","297","3","300","2023-01-02"
"58032","2022","COM","2020","357","7","364","2023-01-02"
"58033","2022","COM","2020","301","9","310","2023-01-02"
"58034","2022","COM","2020","185","6","191","2023-01-02"
"58035","2022","COM","2020","297","2","299","2023-01-02"
"58036","2022","COM","2020","462","9","471","2023-01-02"
"58037","2022","COM","2020","591","36","627","2023-01-02"
"58038","2022","COM","2020","156","5","161","2023-01-02"
"58039","2022","COM","2020","231","3","234","2023-01-02"
"58040","2022","COM","2020","144","3","147","2023-01-02"
"58041","2022","COM","2020","167","5","172","2023-01-02"
"58042","2022","COM","2020","140","2","142","2023-01-02"
"58043","2022","COM","2020","53","0","53","2023-01-02"
"58044","2022","COM","2020","804","11","815","2023-01-02"
"58045","2022","COM","2020","158","1","159","2023-01-02"
"58046","2022","COM","2020","1697","24","1721","2023-01-02"
"58047","2022","COM","2020","639","15","654","2023-01-02"
"58048","2022","COM","2020","114","5","119","2023-01-02"
"58049","2022","COM","2020","83","2","85","2023-01-02"
"58050","2022","COM","2020","45","2","47","2023-01-02"
"58051","2022","COM","2020","1522","133","1655","2023-01-02"
"58052","2022","COM","2020","48","1","49","2023-01-02"
"58053","2022","COM","2020","325","8","333","2023-01-02"
"58054","2022","COM","2020","40","1","41","2023-01-02"
"58055","2022","COM","2020","752","14","766","2023-01-02"
"58056","2022","COM","2020","291","7","298","2023-01-02"
"58057","2022","COM","2020","1108","19","1127","2023-01-02"
"58058","2022","COM","2020","298","5","303","2023-01-02"
"58059","2022","COM","2020","4673","53","4726","2023-01-02"
"58060","2022","COM","2020","614","10","624","2023-01-02"
"58061","2022","COM","2020","125","1","126","2023-01-02"
"58062","2022","COM","2020","1934","383","2317","2023-01-02"
"58063","2022","COM","2020","549","8","557","2023-01-02"
"58064","2022","COM","2020","491","15","506","2023-01-02"
"58065","2022","COM","2020","912","16","928","2023-01-02"
"58066","2022","COM","2020","82","0","82","2023-01-02"
"58067","2022","COM","2020","1508","23","1531","2023-01-02"
"58068","2022","COM","2020","205","1","206","2023-01-02"
"58069","2022","COM","2020","163","4","167","2023-01-02"
"58070","2022","COM","2020","58","0","58","2023-01-02"
"58071","2022","COM","2020","137","7","144","2023-01-02"
"58072","2022","COM","2020","623","10","633","2023-01-02"
"58073","2022","COM","2020","126","4","130","2023-01-02"
"58074","2022","COM","2020","344","11","355","2023-01-02"
"58075","2022","COM","2020","218","4","222","2023-01-02"
"58076","2022","COM","2020","81","0","81","2023-01-02"
"58077","2022","COM","2020","373","7","380","2023-01-02"
"58078","2022","COM","2020","53","0","53","2023-01-02"
"58079","2022","COM","2020","3594","185","3779","2023-01-02"
"58080","2022","COM","2020","167","1","168","2023-01-02"
"58081","2022","COM","2020","271","4","275","2023-01-02"
"58082","2022","COM","2020","284","4","288","2023-01-02"
"58083","2022","COM","2020","1397","96","1493","2023-01-02"
"58084","2022","COM","2020","95","4","99","2023-01-02"
"58085","2022","COM","2020","730","12","742","2023-01-02"
"58086","2022","COM","2020","9415","243","9658","2023-01-02"
"58087","2022","COM","2020","689","12","701","2023-01-02"
"58088","2022","COM","2020","3708","71","3779","2023-01-02"
"58089","2022","COM","2020","192","7","199","2023-01-02"
"58090","2022","COM","2020","219","1","220","2023-01-02"
"58092","2022","COM","2020","397","10","407","2023-01-02"
"58093","2022","COM","2020","126","2","128","2023-01-02"
"58094","2022","COM","2020","444","4","448","2023-01-02"
"58095","2022","COM","2020","5193","182","5375","2023-01-02"
"58096","2022","COM","2020","496","10","506","2023-01-02"
"58097","2022","COM","2020","91","1","92","2023-01-02"
"58098","2022","COM","2020","110","5","115","2023-01-02"
"58099","2022","COM","2020","161","3","164","2023-01-02"
"58101","2022","COM","2020","190","2","192","2023-01-02"
"58102","2022","COM","2020","1571","25","1596","2023-01-02"
"58103","2022","COM","2020","469","8","477","2023-01-02"
"58104","2022","COM","2020","1473","24","1497","2023-01-02"
"58105","2022","COM","2020","307","4","311","2023-01-02"
"58106","2022","COM","2020","356","3","359","2023-01-02"
"58107","2022","COM","2020","144","2","146","2023-01-02"
"58108","2022","COM","2020","86","1","87","2023-01-02"
"58109","2022","COM","2020","739","12","751","2023-01-02"
"58110","2022","COM","2020","239","2","241","2023-01-02"
"58111","2022","COM","2020","104","0","104","2023-01-02"
"58112","2022","COM","2020","629","7","636","2023-01-02"
"58113","2022","COM","2020","96","1","97","2023-01-02"
"58114","2022","COM","2020","91","4","95","2023-01-02"
"58115","2022","COM","2020","224","6","230","2023-01-02"
"58116","2022","COM","2020","130","4","134","2023-01-02"
"58117","2022","COM","2020","4069","51","4120","2023-01-02"
"58118","2022","COM","2020","641","7","648","2023-01-02"
"58119","2022","COM","2020","79","2","81","2023-01-02"
"58120","2022","COM","2020","219","0","219","2023-01-02"
"58121","2022","COM","2020","3750","45","3795","2023-01-02"
"58122","2022","COM","2020","425","11","436","2023-01-02"
"58123","2022","COM","2020","121","11","132","2023-01-02"
"58124","2022","COM","2020","767","7","774","2023-01-02"
"58125","2022","COM","2020","92","2","94","2023-01-02"
"58126","2022","COM","2020","438","12","450","2023-01-02"
"58127","2022","COM","2020","188","3","191","2023-01-02"
"58128","2022","COM","2020","90","1","91","2023-01-02"
"58129","2022","COM","2020","170","5","175","2023-01-02"
"58130","2022","COM","2020","94","3","97","2023-01-02"
"58131","2022","COM","2020","2525","43","2568","2023-01-02"
"58132","2022","COM","2020","227","10","237","2023-01-02"
"58133","2022","COM","2020","72","2","74","2023-01-02"
"58134","2022","COM","2020","3195","38","3233","2023-01-02"
"58135","2022","COM","2020","101","0","101","2023-01-02"
"58136","2022","COM","2020","68","2","70","2023-01-02"
"58137","2022","COM","2020","71","0","71","2023-01-02"
"58138","2022","COM","2020","352","13","365","2023-01-02"
"58139","2022","COM","2020","113","0","113","2023-01-02"
"58140","2022","COM","2020","229","4","233","2023-01-02"
"58141","2022","COM","2020","72","0","72","2023-01-02"
"58142","2022","COM","2020","239","1","240","2023-01-02"
"58143","2022","COM","2020","141","5","146","2023-01-02"
"58144","2022","COM","2020","681","15","696","2023-01-02"
"58145","2022","COM","2020","1267","30","1297","2023-01-02"
"58146","2022","COM","2020","981","19","1000","2023-01-02"
"58147","2022","COM","2020","276","5","281","2023-01-02"
"58148","2022","COM","2020","613","10","623","2023-01-02"
"58149","2022","COM","2020","1994","39","2033","2023-01-02"
"58150","2022","COM","2020","108","0","108","2023-01-02"
"58151","2022","COM","2020","3231","52","3283","2023-01-02"
"58152","2022","COM","2020","1404","27","1431","2023-01-02"
"58153","2022","COM","2020","70","2","72","2023-01-02"
"58154","2022","COM","2020","115","1","116","2023-01-02"
"58155","2022","COM","2020","558","17","575","2023-01-02"
"58156","2022","COM","2020","142","2","144","2023-01-02"
"58157","2022","COM","2020","279","16","295","2023-01-02"
"58158","2022","COM","2020","304","5","309","2023-01-02"
"58159","2022","COM","2020","192","4","196","2023-01-02"
"58160","2022","COM","2020","3701","160","3861","2023-01-02"
"58161","2022","COM","2020","145","1","146","2023-01-02"
"58162","2022","COM","2020","103","3","106","2023-01-02"
"58163","2022","COM","2020","187","3","190","2023-01-02"
"58164","2022","COM","2020","661","29","690","2023-01-02"
"58165","2022","COM","2020","166","7","173","2023-01-02"
"58166","2022","COM","2020","230","3","233","2023-01-02"
"58168","2022","COM","2020","440","6","446","2023-01-02"
"58169","2022","COM","2020","14","2","16","2023-01-02"
"58170","2022","COM","2020","124","3","127","2023-01-02"
"58171","2022","COM","2020","288","2","290","2023-01-02"
"58172","2022","COM","2020","121","2","123","2023-01-02"
"58173","2022","COM","2020","156","1","157","2023-01-02"
"58174","2022","COM","2020","120","2","122","2023-01-02"
"58175","2022","COM","2020","155","1","156","2023-01-02"
"58176","2022","COM","2020","637","22","659","2023-01-02"
"58177","2022","COM","2020","276","1","277","2023-01-02"
"58178","2022","COM","2020","154","2","156","2023-01-02"
"58179","2022","COM","2020","258","11","269","2023-01-02"
"58180","2022","COM","2020","515","3","518","2023-01-02"
"58181","2022","COM","2020","140","2","142","2023-01-02"
"58182","2022","COM","2020","1415","14","1429","2023-01-02"
"58183","2022","COM","2020","94","1","95","2023-01-02"
"58184","2022","COM","2020","104","1","105","2023-01-02"
"58185","2022","COM","2020","528","4","532","2023-01-02"
"58186","2022","COM","2020","57","1","58","2023-01-02"
"58187","2022","COM","2020","524","7","531","2023-01-02"
"58188","2022","COM","2020","113","3","116","2023-01-02"
"58189","2022","COM","2020","476","3","479","2023-01-02"
"58190","2022","COM","2020","105","2","107","2023-01-02"
"58191","2022","COM","2020","111","3","114","2023-01-02"
"58192","2022","COM","2020","218","9","227","2023-01-02"
"58193","2022","COM","2020","1393","29","1422","2023-01-02"
"58194","2022","COM","2020","32284","1001","33285","2023-01-02"
"58195","2022","COM","2020","276","1","277","2023-01-02"
"58196","2022","COM","2020","344","3","347","2023-01-02"
"58197","2022","COM","2020","163","3","166","2023-01-02"
"58198","2022","COM","2020","299","5","304","2023-01-02"
"58199","2022","COM","2020","157","4","161","2023-01-02"
"58200","2022","COM","2020","147","1","148","2023-01-02"
"58201","2022","COM","2020","141","3","144","2023-01-02"
"58202","2022","COM","2020","25","0","25","2023-01-02"
"58203","2022","COM","2020","62","1","63","2023-01-02"
"58204","2022","COM","2020","538","7","545","2023-01-02"
"58205","2022","COM","2020","600","8","608","2023-01-02"
"58206","2022","COM","2020","34","0","34","2023-01-02"
"58207","2022","COM","2020","973","32","1005","2023-01-02"
"58208","2022","COM","2020","293","13","306","2023-01-02"
"58209","2022","COM","2020","147","5","152","2023-01-02"
"58210","2022","COM","2020","304","4","308","2023-01-02"
"58211","2022","COM","2020","152","3","155","2023-01-02"
"58212","2022","COM","2020","329","4","333","2023-01-02"
"58213","2022","COM","2020","469","9","478","2023-01-02"
"58214","2022","COM","2020","2361","49","2410","2023-01-02"
"58215","2022","COM","2020","1607","24","1631","2023-01-02"
"58216","2022","COM","2020","157","4","161","2023-01-02"
"58217","2022","COM","2020","196","4","200","2023-01-02"
"58218","2022","COM","2020","1823","25","1848","2023-01-02"
"58219","2022","COM","2020","207","4","211","2023-01-02"
"58220","2022","COM","2020","645","12","657","2023-01-02"
"58221","2022","COM","2020","150","2","152","2023-01-02"
"58222","2022","COM","2020","157","1","158","2023-01-02"
"58223","2022","COM","2020","637","8","645","2023-01-02"
"58224","2022","COM","2020","88","1","89","2023-01-02"
"58225","2022","COM","2020","369","7","376","2023-01-02"
"58226","2022","COM","2020","129","2","131","2023-01-02"
"58227","2022","COM","2020","1223","21","1244","2023-01-02"
"58228","2022","COM","2020","592","4","596","2023-01-02"
"58229","2022","COM","2020","311","4","315","2023-01-02"
"58230","2022","COM","2020","70","0","70","2023-01-02"
"58231","2022","COM","2020","387","8","395","2023-01-02"
"58232","2022","COM","2020","1262","20","1282","2023-01-02"
"58233","2022","COM","2020","175","1","176","2023-01-02"
"58234","2022","COM","2020","143","1","144","2023-01-02"
"58235","2022","COM","2020","257","0","257","2023-01-02"
"58236","2022","COM","2020","136","2","138","2023-01-02"
"58237","2022","COM","2020","29","2","31","2023-01-02"
"58238","2022","COM","2020","2223","49","2272","2023-01-02"
"58239","2022","COM","2020","155","2","157","2023-01-02"
"58240","2022","COM","2020","78","2","80","2023-01-02"
"58241","2022","COM","2020","314","5","319","2023-01-02"
"58242","2022","COM","2020","124","0","124","2023-01-02"
"58243","2022","COM","2020","115","3","118","2023-01-02"
"58244","2022","COM","2020","215","6","221","2023-01-02"
"58245","2022","COM","2020","165","4","169","2023-01-02"
"58246","2022","COM","2020","698","13","711","2023-01-02"
"58247","2022","COM","2020","484","7","491","2023-01-02"
"58248","2022","COM","2020","214","5","219","2023-01-02"
"58249","2022","COM","2020","350","2","352","2023-01-02"
"58250","2022","COM","2020","1799","39","1838","2023-01-02"
"58251","2022","COM","2020","470","7","477","2023-01-02"
"58252","2022","COM","2020","126","2","128","2023-01-02"
"58253","2022","COM","2020","81","7","88","2023-01-02"
"58254","2022","COM","2020","564","12","576","2023-01-02"
"58255","2022","COM","2020","283","5","288","2023-01-02"
"58256","2022","COM","2020","378","14","392","2023-01-02"
"58257","2022","COM","2020","65","1","66","2023-01-02"
"58258","2022","COM","2020","531","9","540","2023-01-02"
"58259","2022","COM","2020","142","0","142","2023-01-02"
"58260","2022","COM","2020","1242","27","1269","2023-01-02"
"58261","2022","COM","2020","1055","20","1075","2023-01-02"
"58262","2022","COM","2020","209","6","215","2023-01-02"
"58263","2022","COM","2020","167","2","169","2023-01-02"
"58264","2022","COM","2020","1840","28","1868","2023-01-02"
"58265","2022","COM","2020","91","3","94","2023-01-02"
"58266","2022","COM","2020","170","0","170","2023-01-02"
"58267","2022","COM","2020","719","81","800","2023-01-02"
"58268","2022","COM","2020","191","5","196","2023-01-02"
"58269","2022","COM","2020","420","10","430","2023-01-02"
"58270","2022","COM","2020","356","7","363","2023-01-02"
"58271","2022","COM","2020","186","3","189","2023-01-02"
"58272","2022","COM","2020","110","3","113","2023-01-02"
"58273","2022","COM","2020","1427","33","1460","2023-01-02"
"58274","2022","COM","2020","113","3","116","2023-01-02"
"58275","2022","COM","2020","288","5","293","2023-01-02"
"58276","2022","COM","2020","222","2","224","2023-01-02"
"58277","2022","COM","2020","191","5","196","2023-01-02"
"58278","2022","COM","2020","1480","69","1549","2023-01-02"
"58279","2022","COM","2020","173","6","179","2023-01-02"
"58280","2022","COM","2020","592","16","608","2023-01-02"
"58281","2022","COM","2020","589","13","602","2023-01-02"
"58282","2022","COM","2020","335","11","346","2023-01-02"
"58283","2022","COM","2020","73","2","75","2023-01-02"
"58284","2022","COM","2020","37","2","39","2023-01-02"
"58285","2022","COM","2020","159","5","164","2023-01-02"
"58286","2022","COM","2020","570","12","582","2023-01-02"
"58287","2022","COM","2020","188","2","190","2023-01-02"
"58288","2022","COM","2020","107","2","109","2023-01-02"
"58289","2022","COM","2020","182","1","183","2023-01-02"
"58290","2022","COM","2020","44","1","45","2023-01-02"
"58291","2022","COM","2020","180","0","180","2023-01-02"
"58292","2022","COM","2020","165","0","165","2023-01-02"
"58293","2022","COM","2020","409","4","413","2023-01-02"
"58294","2022","COM","2020","120","0","120","2023-01-02"
"58295","2022","COM","2020","985","16","1001","2023-01-02"
"58296","2022","COM","2020","135","1","136","2023-01-02"
"58297","2022","COM","2020","244","1","245","2023-01-02"
"58298","2022","COM","2020","400","9","409","2023-01-02"
"58299","2022","COM","2020","220","3","223","2023-01-02"
"58300","2022","COM","2020","1747","31","1778","2023-01-02"
"58301","2022","COM","2020","299","5","304","2023-01-02"
"58302","2022","COM","2020","921","5","926","2023-01-02"
"58303","2022","COM","2020","9195","167","9362","2023-01-02"
"58304","2022","COM","2020","1053","198","1251","2023-01-02"
"58305","2022","COM","2020","136","1","137","2023-01-02"
"58306","2022","COM","2020","289","4","293","2023-01-02"
"58307","2022","COM","2020","177","4","181","2023-01-02"
"58308","2022","COM","2020","62","0","62","2023-01-02"
"58309","2022","COM","2020","409","9","418","2023-01-02"
"58310","2022","COM","2020","48","1","49","2023-01-02"
"58311","2022","COM","2020","238","6","244","2023-01-02"
"58312","2022","COM","2020","269","9","278","2023-01-02"
"58313","2022","COM","2020","87","2","89","2023-01-02"
"59001","2022","COM","2020","468","13","481","2023-01-02"
"59002","2022","COM","2020","4241","33","4274","2023-01-02"
"59003","2022","COM","2020","371","6","377","2023-01-02"
"59004","2022","COM","2020","1368","13","1381","2023-01-02"
"59005","2022","COM","2020","3532","61","3593","2023-01-02"
"59006","2022","COM","2020","213","8","221","2023-01-02"
"59007","2022","COM","2020","892","8","900","2023-01-02"
"59008","2022","COM","2020","9944","81","10025","2023-01-02"
"59009","2022","COM","2020","61258","644","61902","2023-01-02"
"59010","2022","COM","2020","257","2","259","2023-01-02"
"59011","2022","COM","2020","10679","108","10787","2023-01-02"
"59012","2022","COM","2020","3254","47","3301","2023-01-02"
"59013","2022","COM","2020","1559","25","1584","2023-01-02"
"59014","2022","COM","2020","13195","75","13270","2023-01-02"
"59015","2022","COM","2020","3160","26","3186","2023-01-02"
"59016","2022","COM","2020","2159","44","2203","2023-01-02"
"59017","2022","COM","2020","25225","363","25588","2023-01-02"
"59018","2022","COM","2020","1566","16","1582","2023-01-02"
"59019","2022","COM","2020","1055","12","1067","2023-01-02"
"59021","2022","COM","2020","1810","18","1828","2023-01-02"
"59022","2022","COM","2020","2234","30","2264","2023-01-02"
"59023","2022","COM","2020","544","7","551","2023-01-02"
"59024","2022","COM","2020","4634","27","4661","2023-01-02"
"59025","2022","COM","2020","1698","28","1726","2023-01-02"
"59026","2022","COM","2020","1161","16","1177","2023-01-02"
"59027","2022","COM","2020","1720","16","1736","2023-01-02"
"59028","2022","COM","2020","7205","31","7236","2023-01-02"
"59029","2022","COM","2020","1493","20","1513","2023-01-02"
"59031","2022","COM","2020","374","4","378","2023-01-02"
"59032","2022","COM","2020","7167","70","7237","2023-01-02"
"59033","2022","COM","2020","8804","238","9042","2023-01-02"
"59034","2022","COM","2020","2616","43","2659","2023-01-02"
"59035","2022","COM","2020","2309","46","2355","2023-01-02"
"59036","2022","COM","2020","4158","137","4295","2023-01-02"
"59037","2022","COM","2020","3628","34","3662","2023-01-02"
"59038","2022","COM","2020","1445","18","1463","2023-01-02"
"59039","2022","COM","2020","812","18","830","2023-01-02"
"59041","2022","COM","2020","2276","16","2292","2023-01-02"
"59042","2022","COM","2020","1836","31","1867","2023-01-02"
"59043","2022","COM","2020","15026","224","15250","2023-01-02"
"59044","2022","COM","2020","4993","51","5044","2023-01-02"
"59045","2022","COM","2020","166","4","170","2023-01-02"
"59046","2022","COM","2020","822","2","824","2023-01-02"
"59047","2022","COM","2020","350","3","353","2023-01-02"
"59048","2022","COM","2020","515","9","524","2023-01-02"
"59049","2022","COM","2020","440","7","447","2023-01-02"
"59050","2022","COM","2020","342","8","350","2023-01-02"
"59051","2022","COM","2020","6565","38","6603","2023-01-02"
"59052","2022","COM","2020","5044","44","5088","2023-01-02"
"59053","2022","COM","2020","3248","60","3308","2023-01-02"
"59054","2022","COM","2020","1041","8","1049","2023-01-02"
"59055","2022","COM","2020","526","10","536","2023-01-02"
"59056","2022","COM","2020","844","23","867","2023-01-02"
"59057","2022","COM","2020","564","4","568","2023-01-02"
"59058","2022","COM","2020","1013","14","1027","2023-01-02"
"59059","2022","COM","2020","447","7","454","2023-01-02"
"59060","2022","COM","2020","232","5","237","2023-01-02"
"59061","2022","COM","2020","268","2","270","2023-01-02"
"59062","2022","COM","2020","163","7","170","2023-01-02"
"59063","2022","COM","2020","1970","18","1988","2023-01-02"
"59064","2022","COM","2020","1263","12","1275","2023-01-02"
"59065","2022","COM","2020","809","18","827","2023-01-02"
"59066","2022","COM","2020","161","5","166","2023-01-02"
"59067","2022","COM","2020","3580","43","3623","2023-01-02"
"59068","2022","COM","2020","3174","36","3210","2023-01-02"
"59069","2022","COM","2020","739","12","751","2023-01-02"
"59070","2022","COM","2020","376","3","379","2023-01-02"
"59071","2022","COM","2020","2271","47","2318","2023-01-02"
"59072","2022","COM","2020","256","6","262","2023-01-02"
"59073","2022","COM","2020","577","9","586","2023-01-02"
"59074","2022","COM","2020","2158","22","2180","2023-01-02"
"59075","2022","COM","2020","736","5","741","2023-01-02"
"59076","2022","COM","2020","309","5","314","2023-01-02"
"59077","2022","COM","2020","259","6","265","2023-01-02"
"59078","2022","COM","2020","619","6","625","2023-01-02"
"59079","2022","COM","2020","6800","33","6833","2023-01-02"
"59080","2022","COM","2020","2817","39","2856","2023-01-02"
"59081","2022","COM","2020","560","11","571","2023-01-02"
"59082","2022","COM","2020","1799","31","1830","2023-01-02"
"59083","2022","COM","2020","250","11","261","2023-01-02"
"59084","2022","COM","2020","2055","30","2085","2023-01-02"
"59085","2022","COM","2020","302","6","308","2023-01-02"
"59086","2022","COM","2020","2144","31","2175","2023-01-02"
"59087","2022","COM","2020","745","13","758","2023-01-02"
"59088","2022","COM","2020","1802","24","1826","2023-01-02"
"59089","2022","COM","2020","1424","30","1454","2023-01-02"
"59090","2022","COM","2020","9759","185","9944","2023-01-02"
"59091","2022","COM","2020","575","15","590","2023-01-02"
"59092","2022","COM","2020","3937","42","3979","2023-01-02"
"59093","2022","COM","2020","325","6","331","2023-01-02"
"59094","2022","COM","2020","7087","48","7135","2023-01-02"
"59096","2022","COM","2020","1670","40","1710","2023-01-02"
"59097","2022","COM","2020","408","5","413","2023-01-02"
"59098","2022","COM","2020","4791","54","4845","2023-01-02"
"59099","2022","COM","2020","1766","16","1782","2023-01-02"
"59100","2022","COM","2020","354","4","358","2023-01-02"
"59101","2022","COM","2020","379","11","390","2023-01-02"
"59102","2022","COM","2020","440","4","444","2023-01-02"
"59103","2022","COM","2020","518","8","526","2023-01-02"
"59104","2022","COM","2020","3176","25","3201","2023-01-02"
"59105","2022","COM","2020","1532","24","1556","2023-01-02"
"59106","2022","COM","2020","746","14","760","2023-01-02"
"59107","2022","COM","2020","4476","45","4521","2023-01-02"
"59108","2022","COM","2020","732","7","739","2023-01-02"
"59109","2022","COM","2020","770","9","779","2023-01-02"
"59110","2022","COM","2020","1434","25","1459","2023-01-02"
"59111","2022","COM","2020","397","4","401","2023-01-02"
"59112","2022","COM","2020","11325","48","11373","2023-01-02"
"59113","2022","COM","2020","1354","6","1360","2023-01-02"
"59114","2022","COM","2020","1671","18","1689","2023-01-02"
"59115","2022","COM","2020","710","7","717","2023-01-02"
"59116","2022","COM","2020","419","12","431","2023-01-02"
"59117","2022","COM","2020","1058","10","1068","2023-01-02"
"59118","2022","COM","2020","2440","24","2464","2023-01-02"
"59119","2022","COM","2020","599","6","605","2023-01-02"
"59120","2022","COM","2020","2034","33","2067","2023-01-02"
"59121","2022","COM","2020","621","7","628","2023-01-02"
"59122","2022","COM","2020","31559","569","32128","2023-01-02"
"59123","2022","COM","2020","1702","24","1726","2023-01-02"
"59124","2022","COM","2020","2497","68","2565","2023-01-02"
"59125","2022","COM","2020","405","9","414","2023-01-02"
"59126","2022","COM","2020","1719","14","1733","2023-01-02"
"59127","2022","COM","2020","143","5","148","2023-01-02"
"59128","2022","COM","2020","2506","31","2537","2023-01-02"
"59129","2022","COM","2020","2265","45","2310","2023-01-02"
"59130","2022","COM","2020","1154","19","1173","2023-01-02"
"59131","2022","COM","2020","7953","77","8030","2023-01-02"
"59132","2022","COM","2020","1009","13","1022","2023-01-02"
"59133","2022","COM","2020","1054","14","1068","2023-01-02"
"59134","2022","COM","2020","1257","10","1267","2023-01-02"
"59135","2022","COM","2020","2249","100","2349","2023-01-02"
"59136","2022","COM","2020","7016","137","7153","2023-01-02"
"59137","2022","COM","2020","788","8","796","2023-01-02"
"59138","2022","COM","2020","682","14","696","2023-01-02"
"59139","2022","COM","2020","14028","142","14170","2023-01-02"
"59140","2022","COM","2020","457","9","466","2023-01-02"
"59141","2022","COM","2020","566","15","581","2023-01-02"
"59142","2022","COM","2020","709","5","714","2023-01-02"
"59143","2022","COM","2020","8656","68","8724","2023-01-02"
"59144","2022","COM","2020","859","10","869","2023-01-02"
"59145","2022","COM","2020","770","12","782","2023-01-02"
"59146","2022","COM","2020","2978","41","3019","2023-01-02"
"59147","2022","COM","2020","48","2","50","2023-01-02"
"59148","2022","COM","2020","363","1","364","2023-01-02"
"59149","2022","COM","2020","1086","16","1102","2023-01-02"
"59150","2022","COM","2020","535","7","542","2023-01-02"
"59151","2022","COM","2020","1595","22","1617","2023-01-02"
"59152","2022","COM","2020","12749","98","12847","2023-01-02"
"59153","2022","COM","2020","9445","53","9498","2023-01-02"
"59155","2022","COM","2020","20708","279","20987","2023-01-02"
"59156","2022","COM","2020","2912","35","2947","2023-01-02"
"59157","2022","COM","2020","2172","20","2192","2023-01-02"
"59158","2022","COM","2020","3151","46","3197","2023-01-02"
"59159","2022","COM","2020","741","7","748","2023-01-02"
"59160","2022","COM","2020","4481","30","4511","2023-01-02"
"59161","2022","COM","2020","741","32","773","2023-01-02"
"59162","2022","COM","2020","665","21","686","2023-01-02"
"59163","2022","COM","2020","20574","263","20837","2023-01-02"
"59164","2022","COM","2020","244","8","252","2023-01-02"
"59165","2022","COM","2020","6444","65","6509","2023-01-02"
"59166","2022","COM","2020","1348","36","1384","2023-01-02"
"59167","2022","COM","2020","207","1","208","2023-01-02"
"59168","2022","COM","2020","4798","68","4866","2023-01-02"
"59169","2022","COM","2020","207","4","211","2023-01-02"
"59170","2022","COM","2020","5352","33","5385","2023-01-02"
"59171","2022","COM","2020","38","1","39","2023-01-02"
"59172","2022","COM","2020","20415","117","20532","2023-01-02"
"59173","2022","COM","2020","1843","25","1868","2023-01-02"
"59174","2022","COM","2020","326","2","328","2023-01-02"
"59175","2022","COM","2020","310","9","319","2023-01-02"
"59176","2022","COM","2020","323","3","326","2023-01-02"
"59177","2022","COM","2020","858","14","872","2023-01-02"
"59178","2022","COM","2020","39842","855","40697","2023-01-02"
"59179","2022","COM","2020","10144","35","10179","2023-01-02"
"59180","2022","COM","2020","1462","19","1481","2023-01-02"
"59181","2022","COM","2020","542","6","548","2023-01-02"
"59182","2022","COM","2020","274","4","278","2023-01-02"
"59183","2022","COM","2020","86545","1260","87805","2023-01-02"
"59184","2022","COM","2020","660","10","670","2023-01-02"
"59185","2022","COM","2020","1936","13","1949","2023-01-02"
"59186","2022","COM","2020","84","2","86","2023-01-02"
"59187","2022","COM","2020","265","5","270","2023-01-02"
"59188","2022","COM","2020","140","4","144","2023-01-02"
"59189","2022","COM","2020","1222","27","1249","2023-01-02"
"59190","2022","COM","2020","998","14","1012","2023-01-02"
"59191","2022","COM","2020","630","4","634","2023-01-02"
"59192","2022","COM","2020","826","47","873","2023-01-02"
"59193","2022","COM","2020","3077","24","3101","2023-01-02"
"59194","2022","COM","2020","1271","22","1293","2023-01-02"
"59195","2022","COM","2020","615","9","624","2023-01-02"
"59196","2022","COM","2020","1299","20","1319","2023-01-02"
"59197","2022","COM","2020","2295","28","2323","2023-01-02"
"59198","2022","COM","2020","243","0","243","2023-01-02"
"59199","2022","COM","2020","690","11","701","2023-01-02"
"59200","2022","COM","2020","492","9","501","2023-01-02"
"59201","2022","COM","2020","595","11","606","2023-01-02"
"59202","2022","COM","2020","5364","38","5402","2023-01-02"
"59203","2022","COM","2020","1580","9","1589","2023-01-02"
"59204","2022","COM","2020","482","8","490","2023-01-02"
"59205","2022","COM","2020","9445","44","9489","2023-01-02"
"59206","2022","COM","2020","3186","28","3214","2023-01-02"
"59207","2022","COM","2020","4172","28","4200","2023-01-02"
"59208","2022","COM","2020","304","11","315","2023-01-02"
"59209","2022","COM","2020","673","8","681","2023-01-02"
"59210","2022","COM","2020","2125","51","2176","2023-01-02"
"59211","2022","COM","2020","914","20","934","2023-01-02"
"59212","2022","COM","2020","6501","123","6624","2023-01-02"
"59213","2022","COM","2020","457","15","472","2023-01-02"
"59214","2022","COM","2020","1111","24","1135","2023-01-02"
"59215","2022","COM","2020","960","33","993","2023-01-02"
"59216","2022","COM","2020","349","8","357","2023-01-02"
"59217","2022","COM","2020","347","7","354","2023-01-02"
"59218","2022","COM","2020","1291","16","1307","2023-01-02"
"59219","2022","COM","2020","718","8","726","2023-01-02"
"59220","2022","COM","2020","18160","120","18280","2023-01-02"
"59221","2022","COM","2020","2494","68","2562","2023-01-02"
"59222","2022","COM","2020","2235","46","2281","2023-01-02"
"59223","2022","COM","2020","501","4","505","2023-01-02"
"59224","2022","COM","2020","1675","13","1688","2023-01-02"
"59225","2022","COM","2020","6763","68","6831","2023-01-02"
"59226","2022","COM","2020","1458","15","1473","2023-01-02"
"59227","2022","COM","2020","5516","48","5564","2023-01-02"
"59228","2022","COM","2020","1452","22","1474","2023-01-02"
"59229","2022","COM","2020","546","19","565","2023-01-02"
"59230","2022","COM","2020","5239","53","5292","2023-01-02"
"59231","2022","COM","2020","1081","13","1094","2023-01-02"
"59232","2022","COM","2020","436","4","440","2023-01-02"
"59233","2022","COM","2020","356","3","359","2023-01-02"
"59234","2022","COM","2020","5751","41","5792","2023-01-02"
"59236","2022","COM","2020","263","4","267","2023-01-02"
"59237","2022","COM","2020","992","23","1015","2023-01-02"
"59238","2022","COM","2020","1630","25","1655","2023-01-02"
"59239","2022","COM","2020","5612","91","5703","2023-01-02"
"59240","2022","COM","2020","127","3","130","2023-01-02"
"59241","2022","COM","2020","515","14","529","2023-01-02"
"59242","2022","COM","2020","680","6","686","2023-01-02"
"59243","2022","COM","2020","1217","12","1229","2023-01-02"
"59244","2022","COM","2020","1767","30","1797","2023-01-02"
"59246","2022","COM","2020","575","3","578","2023-01-02"
"59247","2022","COM","2020","1503","17","1520","2023-01-02"
"59249","2022","COM","2020","11403","171","11574","2023-01-02"
"59250","2022","COM","2020","2220","107","2327","2023-01-02"
"59251","2022","COM","2020","376","4","380","2023-01-02"
"59252","2022","COM","2020","2482","22","2504","2023-01-02"
"59253","2022","COM","2020","7453","38","7491","2023-01-02"
"59254","2022","COM","2020","880","12","892","2023-01-02"
"59255","2022","COM","2020","572","5","577","2023-01-02"
"59256","2022","COM","2020","3245","33","3278","2023-01-02"
"59257","2022","COM","2020","1065","14","1079","2023-01-02"
"59258","2022","COM","2020","2839","624","3463","2023-01-02"
"59259","2022","COM","2020","502","20","522","2023-01-02"
"59260","2022","COM","2020","4111","59","4170","2023-01-02"
"59261","2022","COM","2020","1751","29","1780","2023-01-02"
"59262","2022","COM","2020","2070","28","2098","2023-01-02"
"59263","2022","COM","2020","1045","26","1071","2023-01-02"
"59264","2022","COM","2020","728","11","739","2023-01-02"
"59265","2022","COM","2020","2295","36","2331","2023-01-02"
"59266","2022","COM","2020","4000","39","4039","2023-01-02"
"59267","2022","COM","2020","295","7","302","2023-01-02"
"59268","2022","COM","2020","5640","52","5692","2023-01-02"
"59269","2022","COM","2020","1463","25","1488","2023-01-02"
"59270","2022","COM","2020","477","7","484","2023-01-02"
"59271","2022","COM","2020","20635","205","20840","2023-01-02"
"59272","2022","COM","2020","5054","49","5103","2023-01-02"
"59273","2022","COM","2020","11001","174","11175","2023-01-02"
"59274","2022","COM","2020","481","4","485","2023-01-02"
"59275","2022","COM","2020","1246","35","1281","2023-01-02"
"59276","2022","COM","2020","4667","28","4695","2023-01-02"
"59277","2022","COM","2020","339","3","342","2023-01-02"
"59278","2022","COM","2020","4697","36","4733","2023-01-02"
"59279","2022","COM","2020","20812","122","20934","2023-01-02"
"59280","2022","COM","2020","780","9","789","2023-01-02"
"59281","2022","COM","2020","1269","12","1281","2023-01-02"
"59282","2022","COM","2020","401","9","410","2023-01-02"
"59283","2022","COM","2020","622","10","632","2023-01-02"
"59284","2022","COM","2020","3894","37","3931","2023-01-02"
"59285","2022","COM","2020","2650","20","2670","2023-01-02"
"59286","2022","COM","2020","14556","105","14661","2023-01-02"
"59287","2022","COM","2020","190","4","194","2023-01-02"
"59288","2022","COM","2020","2328","26","2354","2023-01-02"
"59289","2022","COM","2020","1514","32","1546","2023-01-02"
"59290","2022","COM","2020","388","1","389","2023-01-02"
"59291","2022","COM","2020","14318","95","14413","2023-01-02"
"59292","2022","COM","2020","3276","12","3288","2023-01-02"
"59293","2022","COM","2020","1408","18","1426","2023-01-02"
"59294","2022","COM","2020","309","7","316","2023-01-02"
"59295","2022","COM","2020","21464","405","21869","2023-01-02"
"59296","2022","COM","2020","350","10","360","2023-01-02"
"59297","2022","COM","2020","1937","19","1956","2023-01-02"
"59299","2022","COM","2020","18462","148","18610","2023-01-02"
"59300","2022","COM","2020","549","9","558","2023-01-02"
"59301","2022","COM","2020","4465","27","4492","2023-01-02"
"59302","2022","COM","2020","4125","28","4153","2023-01-02"
"59303","2022","COM","2020","2358","29","2387","2023-01-02"
"59304","2022","COM","2020","421","7","428","2023-01-02"
"59305","2022","COM","2020","1642","35","1677","2023-01-02"
"59306","2022","COM","2020","295","3","298","2023-01-02"
"59307","2022","COM","2020","887","2","889","2023-01-02"
"59308","2022","COM","2020","922","23","945","2023-01-02"
"59309","2022","COM","2020","4041","82","4123","2023-01-02"
"59310","2022","COM","2020","869","10","879","2023-01-02"
"59311","2022","COM","2020","567","6","573","2023-01-02"
"59312","2022","COM","2020","743","16","759","2023-01-02"
"59313","2022","COM","2020","1431","15","1446","2023-01-02"
"59314","2022","COM","2020","3548","35","3583","2023-01-02"
"59315","2022","COM","2020","892","12","904","2023-01-02"
"59316","2022","COM","2020","3299","45","3344","2023-01-02"
"59317","2022","COM","2020","7870","96","7966","2023-01-02"
"59318","2022","COM","2020","986","9","995","2023-01-02"
"59319","2022","COM","2020","3185","202","3387","2023-01-02"
"59320","2022","COM","2020","1640","12","1652","2023-01-02"
"59321","2022","COM","2020","643","5","648","2023-01-02"
"59322","2022","COM","2020","3358","31","3389","2023-01-02"
"59323","2022","COM","2020","1150","27","1177","2023-01-02"
"59324","2022","COM","2020","10447","97","10544","2023-01-02"
"59325","2022","COM","2020","856","14","870","2023-01-02"
"59326","2022","COM","2020","1175","21","1196","2023-01-02"
"59327","2022","COM","2020","6311","35","6346","2023-01-02"
"59328","2022","COM","2020","27425","443","27868","2023-01-02"
"59329","2022","COM","2020","4953","85","5038","2023-01-02"
"59330","2022","COM","2020","2414","38","2452","2023-01-02"
"59331","2022","COM","2020","3456","89","3545","2023-01-02"
"59332","2022","COM","2020","1810","8","1818","2023-01-02"
"59333","2022","COM","2020","249","9","258","2023-01-02"
"59334","2022","COM","2020","1604","22","1626","2023-01-02"
"59335","2022","COM","2020","2896","57","2953","2023-01-02"
"59336","2022","COM","2020","1366","15","1381","2023-01-02"
"59337","2022","COM","2020","687","20","707","2023-01-02"
"59338","2022","COM","2020","640","20","660","2023-01-02"
"59339","2022","COM","2020","9548","80","9628","2023-01-02"
"59340","2022","COM","2020","4150","100","4250","2023-01-02"
"59341","2022","COM","2020","439","7","446","2023-01-02"
"59342","2022","COM","2020","223","4","227","2023-01-02"
"59343","2022","COM","2020","9113","86","9199","2023-01-02"
"59344","2022","COM","2020","2500","10","2510","2023-01-02"
"59345","2022","COM","2020","2418","24","2442","2023-01-02"
"59346","2022","COM","2020","3038","20","3058","2023-01-02"
"59347","2022","COM","2020","534","16","550","2023-01-02"
"59348","2022","COM","2020","1465","15","1480","2023-01-02"
"59349","2022","COM","2020","1928","30","1958","2023-01-02"
"59350","2022","COM","2020","236234","1870","238104","2023-01-02"
"59351","2022","COM","2020","544","7","551","2023-01-02"
"59352","2022","COM","2020","8211","96","8307","2023-01-02"
"59353","2022","COM","2020","302","6","308","2023-01-02"
"59354","2022","COM","2020","719","13","732","2023-01-02"
"59356","2022","COM","2020","2195","47","2242","2023-01-02"
"59357","2022","COM","2020","2070","33","2103","2023-01-02"
"59358","2022","COM","2020","1195","23","1218","2023-01-02"
"59359","2022","COM","2020","6083","74","6157","2023-01-02"
"59360","2022","COM","2020","22896","257","23153","2023-01-02"
"59361","2022","COM","2020","3872","23","3895","2023-01-02"
"59363","2022","COM","2020","922","17","939","2023-01-02"
"59364","2022","COM","2020","890","12","902","2023-01-02"
"59365","2022","COM","2020","6389","40","6429","2023-01-02"
"59366","2022","COM","2020","779","15","794","2023-01-02"
"59367","2022","COM","2020","13797","145","13942","2023-01-02"
"59368","2022","COM","2020","22214","173","22387","2023-01-02"
"59369","2022","COM","2020","4039","53","4092","2023-01-02"
"59370","2022","COM","2020","700","11","711","2023-01-02"
"59371","2022","COM","2020","634","15","649","2023-01-02"
"59372","2022","COM","2020","481","5","486","2023-01-02"
"59374","2022","COM","2020","470","4","474","2023-01-02"
"59375","2022","COM","2020","4549","63","4612","2023-01-02"
"59377","2022","COM","2020","1897","25","1922","2023-01-02"
"59378","2022","COM","2020","38604","715","39319","2023-01-02"
"59379","2022","COM","2020","755","3","758","2023-01-02"
"59381","2022","COM","2020","808","20","828","2023-01-02"
"59382","2022","COM","2020","1430","14","1444","2023-01-02"
"59383","2022","COM","2020","12014","121","12135","2023-01-02"
"59384","2022","COM","2020","1432","22","1454","2023-01-02"
"59385","2022","COM","2020","2674","21","2695","2023-01-02"
"59386","2022","COM","2020","11105","70","11175","2023-01-02"
"59387","2022","COM","2020","1919","12","1931","2023-01-02"
"59388","2022","COM","2020","1987","24","2011","2023-01-02"
"59389","2022","COM","2020","2757","30","2787","2023-01-02"
"59390","2022","COM","2020","4080","42","4122","2023-01-02"
"59391","2022","COM","2020","887","5","892","2023-01-02"
"59392","2022","COM","2020","29625","288","29913","2023-01-02"
"59393","2022","COM","2020","1007","13","1020","2023-01-02"
"59394","2022","COM","2020","404","2","406","2023-01-02"
"59395","2022","COM","2020","297","5","302","2023-01-02"
"59396","2022","COM","2020","713","11","724","2023-01-02"
"59397","2022","COM","2020","603","12","615","2023-01-02"
"59398","2022","COM","2020","3289","135","3424","2023-01-02"
"59399","2022","COM","2020","1009","30","1039","2023-01-02"
"59400","2022","COM","2020","9692","88","9780","2023-01-02"
"59401","2022","COM","2020","2281","30","2311","2023-01-02"
"59402","2022","COM","2020","854","22","876","2023-01-02"
"59403","2022","COM","2020","715","7","722","2023-01-02"
"59405","2022","COM","2020","485","3","488","2023-01-02"
"59406","2022","COM","2020","435","6","441","2023-01-02"
"59407","2022","COM","2020","548","9","557","2023-01-02"
"59408","2022","COM","2020","1723","20","1743","2023-01-02"
"59409","2022","COM","2020","2508","19","2527","2023-01-02"
"59410","2022","COM","2020","21564","133","21697","2023-01-02"
"59411","2022","COM","2020","2105","37","2142","2023-01-02"
"59412","2022","COM","2020","273","4","277","2023-01-02"
"59413","2022","COM","2020","555","7","562","2023-01-02"
"59414","2022","COM","2020","4774","35","4809","2023-01-02"
"59415","2022","COM","2020","224","1","225","2023-01-02"
"59416","2022","COM","2020","2518","41","2559","2023-01-02"
"59418","2022","COM","2020","1584","7","1591","2023-01-02"
"59419","2022","COM","2020","1416","16","1432","2023-01-02"
"59420","2022","COM","2020","58","2","60","2023-01-02"
"59421","2022","COM","2020","13020","190","13210","2023-01-02"
"59422","2022","COM","2020","627","12","639","2023-01-02"
"59423","2022","COM","2020","1365","20","1385","2023-01-02"
"59424","2022","COM","2020","1316","5","1321","2023-01-02"
"59425","2022","COM","2020","303","8","311","2023-01-02"
"59426","2022","COM","2020","10126","68","10194","2023-01-02"
"59427","2022","COM","2020","633","11","644","2023-01-02"
"59428","2022","COM","2020","3923","40","3963","2023-01-02"
"59429","2022","COM","2020","2688","14","2702","2023-01-02"
"59430","2022","COM","2020","1084","11","1095","2023-01-02"
"59431","2022","COM","2020","7528","84","7612","2023-01-02"
"59432","2022","COM","2020","513","7","520","2023-01-02"
"59433","2022","COM","2020","905","12","917","2023-01-02"
"59434","2022","COM","2020","1361","17","1378","2023-01-02"
"59435","2022","COM","2020","2569","36","2605","2023-01-02"
"59436","2022","COM","2020","787","10","797","2023-01-02"
"59437","2022","COM","2020","852","15","867","2023-01-02"
"59438","2022","COM","2020","813","13","826","2023-01-02"
"59439","2022","COM","2020","273","7","280","2023-01-02"
"59440","2022","COM","2020","685","11","696","2023-01-02"
"59441","2022","COM","2020","652","6","658","2023-01-02"
"59442","2022","COM","2020","270","6","276","2023-01-02"
"59443","2022","COM","2020","388","5","393","2023-01-02"
"59444","2022","COM","2020","918","10","928","2023-01-02"
"59445","2022","COM","2020","1193","18","1211","2023-01-02"
"59446","2022","COM","2020","679","8","687","2023-01-02"
"59447","2022","COM","2020","8742","65","8807","2023-01-02"
"59448","2022","COM","2020","474","5","479","2023-01-02"
"59449","2022","COM","2020","8529","143","8672","2023-01-02"
"59450","2022","COM","2020","638","9","647","2023-01-02"
"59451","2022","COM","2020","555","10","565","2023-01-02"
"59452","2022","COM","2020","5644","31","5675","2023-01-02"
"59453","2022","COM","2020","672","14","686","2023-01-02"
"59454","2022","COM","2020","522","5","527","2023-01-02"
"59455","2022","COM","2020","1007","8","1015","2023-01-02"
"59456","2022","COM","2020","6225","264","6489","2023-01-02"
"59457","2022","COM","2020","8584","45","8629","2023-01-02"
"59458","2022","COM","2020","972","20","992","2023-01-02"
"59459","2022","COM","2020","5080","39","5119","2023-01-02"
"59461","2022","COM","2020","302","6","308","2023-01-02"
"59462","2022","COM","2020","4834","51","4885","2023-01-02"
"59463","2022","COM","2020","976","12","988","2023-01-02"
"59464","2022","COM","2020","2224","16","2240","2023-01-02"
"59465","2022","COM","2020","778","3","781","2023-01-02"
"59466","2022","COM","2020","2924","90","3014","2023-01-02"
"59467","2022","COM","2020","2434","27","2461","2023-01-02"
"59468","2022","COM","2020","442","3","445","2023-01-02"
"59469","2022","COM","2020","415","4","419","2023-01-02"
"59470","2022","COM","2020","2092","32","2124","2023-01-02"
"59471","2022","COM","2020","2048","24","2072","2023-01-02"
"59472","2022","COM","2020","833","8","841","2023-01-02"
"59473","2022","COM","2020","306","7","313","2023-01-02"
"59474","2022","COM","2020","1042","21","1063","2023-01-02"
"59475","2022","COM","2020","2190","19","2209","2023-01-02"
"59476","2022","COM","2020","3090","75","3165","2023-01-02"
"59477","2022","COM","2020","4488","44","4532","2023-01-02"
"59478","2022","COM","2020","1123","26","1149","2023-01-02"
"59479","2022","COM","2020","3108","27","3135","2023-01-02"
"59480","2022","COM","2020","859","21","880","2023-01-02"
"59481","2022","COM","2020","4863","120","4983","2023-01-02"
"59482","2022","COM","2020","6985","60","7045","2023-01-02"
"59483","2022","COM","2020","137","2","139","2023-01-02"
"59484","2022","COM","2020","6354","33","6387","2023-01-02"
"59485","2022","COM","2020","1801","19","1820","2023-01-02"
"59486","2022","COM","2020","2682","42","2724","2023-01-02"
"59487","2022","COM","2020","1398","20","1418","2023-01-02"
"59488","2022","COM","2020","2155","40","2195","2023-01-02"
"59489","2022","COM","2020","4010","54","4064","2023-01-02"
"59490","2022","COM","2020","183","1","184","2023-01-02"
"59491","2022","COM","2020","12201","52","12253","2023-01-02"
"59492","2022","COM","2020","605","7","612","2023-01-02"
"59493","2022","COM","2020","227","1","228","2023-01-02"
"59494","2022","COM","2020","156","1","157","2023-01-02"
"59495","2022","COM","2020","2460","25","2485","2023-01-02"
"59496","2022","COM","2020","237","1","238","2023-01-02"
"59497","2022","COM","2020","2140","29","2169","2023-01-02"
"59498","2022","COM","2020","347","8","355","2023-01-02"
"59499","2022","COM","2020","2000","33","2033","2023-01-02"
"59500","2022","COM","2020","375","5","380","2023-01-02"
"59501","2022","COM","2020","1258","25","1283","2023-01-02"
"59502","2022","COM","2020","1439","10","1449","2023-01-02"
"59503","2022","COM","2020","201","3","204","2023-01-02"
"59504","2022","COM","2020","3798","18","3816","2023-01-02"
"59505","2022","COM","2020","755","7","762","2023-01-02"
"59506","2022","COM","2020","470","7","477","2023-01-02"
"59507","2022","COM","2020","18933","128","19061","2023-01-02"
"59508","2022","COM","2020","13560","115","13675","2023-01-02"
"59509","2022","COM","2020","5985","47","6032","2023-01-02"
"59511","2022","COM","2020","1948","27","1975","2023-01-02"
"59512","2022","COM","2020","98066","414","98480","2023-01-02"
"59513","2022","COM","2020","455","5","460","2023-01-02"
"59514","2022","COM","2020","4089","53","4142","2023-01-02"
"59515","2022","COM","2020","660","6","666","2023-01-02"
"59516","2022","COM","2020","924","22","946","2023-01-02"
"59517","2022","COM","2020","756","14","770","2023-01-02"
"59518","2022","COM","2020","459","7","466","2023-01-02"
"59519","2022","COM","2020","1739","33","1772","2023-01-02"
"59520","2022","COM","2020","1431","25","1456","2023-01-02"
"59521","2022","COM","2020","429","8","437","2023-01-02"
"59522","2022","COM","2020","1943","38","1981","2023-01-02"
"59523","2022","COM","2020","2840","28","2868","2023-01-02"
"59524","2022","COM","2020","5597","50","5647","2023-01-02"
"59525","2022","COM","2020","2787","25","2812","2023-01-02"
"59526","2022","COM","2020","15997","180","16177","2023-01-02"
"59527","2022","COM","2020","13004","100","13104","2023-01-02"
"59528","2022","COM","2020","1563","17","1580","2023-01-02"
"59529","2022","COM","2020","349","8","357","2023-01-02"
"59530","2022","COM","2020","333","1","334","2023-01-02"
"59531","2022","COM","2020","340","6","346","2023-01-02"
"59532","2022","COM","2020","302","3","305","2023-01-02"
"59533","2022","COM","2020","1559","16","1575","2023-01-02"
"59534","2022","COM","2020","832","31","863","2023-01-02"
"59535","2022","COM","2020","1675","47","1722","2023-01-02"
"59536","2022","COM","2020","880","25","905","2023-01-02"
"59537","2022","COM","2020","502","9","511","2023-01-02"
"59538","2022","COM","2020","420","11","431","2023-01-02"
"59539","2022","COM","2020","984","15","999","2023-01-02"
"59541","2022","COM","2020","1013","8","1021","2023-01-02"
"59542","2022","COM","2020","498","8","506","2023-01-02"
"59543","2022","COM","2020","1083","11","1094","2023-01-02"
"59544","2022","COM","2020","11268","148","11416","2023-01-02"
"59545","2022","COM","2020","1203","23","1226","2023-01-02"
"59546","2022","COM","2020","1150","29","1179","2023-01-02"
"59547","2022","COM","2020","852","8","860","2023-01-02"
"59548","2022","COM","2020","644","8","652","2023-01-02"
"59549","2022","COM","2020","330","3","333","2023-01-02"
"59550","2022","COM","2020","2985","21","3006","2023-01-02"
"59551","2022","COM","2020","1738","23","1761","2023-01-02"
"59552","2022","COM","2020","195","6","201","2023-01-02"
"59553","2022","COM","2020","5663","51","5714","2023-01-02"
"59554","2022","COM","2020","618","15","633","2023-01-02"
"59555","2022","COM","2020","1432","18","1450","2023-01-02"
"59556","2022","COM","2020","261","3","264","2023-01-02"
"59557","2022","COM","2020","2577","17","2594","2023-01-02"
"59558","2022","COM","2020","1684","19","1703","2023-01-02"
"59559","2022","COM","2020","1989","33","2022","2023-01-02"
"59560","2022","COM","2020","12505","93","12598","2023-01-02"
"59562","2022","COM","2020","538","7","545","2023-01-02"
"59563","2022","COM","2020","234","3","237","2023-01-02"
"59564","2022","COM","2020","3151","16","3167","2023-01-02"
"59565","2022","COM","2020","649","11","660","2023-01-02"
"59566","2022","COM","2020","4812","38","4850","2023-01-02"
"59567","2022","COM","2020","416","6","422","2023-01-02"
"59568","2022","COM","2020","484","8","492","2023-01-02"
"59569","2022","COM","2020","15442","97","15539","2023-01-02"
"59570","2022","COM","2020","906","19","925","2023-01-02"
"59571","2022","COM","2020","4266","108","4374","2023-01-02"
"59572","2022","COM","2020","1777","21","1798","2023-01-02"
"59573","2022","COM","2020","141","3","144","2023-01-02"
"59574","2022","COM","2020","11869","83","11952","2023-01-02"
"59575","2022","COM","2020","399","4","403","2023-01-02"
"59576","2022","COM","2020","1779","36","1815","2023-01-02"
"59577","2022","COM","2020","671","4","675","2023-01-02"
"59578","2022","COM","2020","1662","29","1691","2023-01-02"
"59579","2022","COM","2020","1373","25","1398","2023-01-02"
"59580","2022","COM","2020","4341","67","4408","2023-01-02"
"59581","2022","COM","2020","3606","55","3661","2023-01-02"
"59582","2022","COM","2020","947","23","970","2023-01-02"
"59583","2022","COM","2020","473","4","477","2023-01-02"
"59584","2022","COM","2020","957","12","969","2023-01-02"
"59585","2022","COM","2020","3528","35","3563","2023-01-02"
"59586","2022","COM","2020","6469","90","6559","2023-01-02"
"59587","2022","COM","2020","517","14","531","2023-01-02"
"59588","2022","COM","2020","8258","216","8474","2023-01-02"
"59589","2022","COM","2020","3000","24","3024","2023-01-02"
"59590","2022","COM","2020","918","13","931","2023-01-02"
"59591","2022","COM","2020","827","3","830","2023-01-02"
"59592","2022","COM","2020","3957","44","4001","2023-01-02"
"59593","2022","COM","2020","756","11","767","2023-01-02"
"59594","2022","COM","2020","1116","13","1129","2023-01-02"
"59595","2022","COM","2020","541","8","549","2023-01-02"
"59596","2022","COM","2020","519","20","539","2023-01-02"
"59597","2022","COM","2020","682","23","705","2023-01-02"
"59598","2022","COM","2020","3914","31","3945","2023-01-02"
"59599","2022","COM","2020","99165","661","99826","2023-01-02"
"59600","2022","COM","2020","940","15","955","2023-01-02"
"59601","2022","COM","2020","2744","67","2811","2023-01-02"
"59602","2022","COM","2020","1401","38","1439","2023-01-02"
"59603","2022","COM","2020","6186","79","6265","2023-01-02"
"59604","2022","COM","2020","815","7","822","2023-01-02"
"59605","2022","COM","2020","1470","27","1497","2023-01-02"
"59606","2022","COM","2020","42738","450","43188","2023-01-02"
"59607","2022","COM","2020","483","5","488","2023-01-02"
"59608","2022","COM","2020","1108","22","1130","2023-01-02"
"59609","2022","COM","2020","1548","21","1569","2023-01-02"
"59610","2022","COM","2020","1087","9","1096","2023-01-02"
"59611","2022","COM","2020","2607","58","2665","2023-01-02"
"59612","2022","COM","2020","508","9","517","2023-01-02"
"59613","2022","COM","2020","1465","14","1479","2023-01-02"
"59614","2022","COM","2020","1394","18","1412","2023-01-02"
"59615","2022","COM","2020","2634","44","2678","2023-01-02"
"59616","2022","COM","2020","10409","56","10465","2023-01-02"
"59617","2022","COM","2020","637","7","644","2023-01-02"
"59618","2022","COM","2020","899","6","905","2023-01-02"
"59619","2022","COM","2020","1054","15","1069","2023-01-02"
"59620","2022","COM","2020","664","9","673","2023-01-02"
"59622","2022","COM","2020","1174","17","1191","2023-01-02"
"59623","2022","COM","2020","686","3","689","2023-01-02"
"59624","2022","COM","2020","2146","25","2171","2023-01-02"
"59625","2022","COM","2020","393","5","398","2023-01-02"
"59626","2022","COM","2020","1295","21","1316","2023-01-02"
"59627","2022","COM","2020","1005","11","1016","2023-01-02"
"59628","2022","COM","2020","562","5","567","2023-01-02"
"59629","2022","COM","2020","1320","23","1343","2023-01-02"
"59630","2022","COM","2020","2615","49","2664","2023-01-02"
"59631","2022","COM","2020","2132","25","2157","2023-01-02"
"59632","2022","COM","2020","5617","35","5652","2023-01-02"
"59633","2022","COM","2020","282","7","289","2023-01-02"
"59634","2022","COM","2020","777","20","797","2023-01-02"
"59635","2022","COM","2020","366","6","372","2023-01-02"
"59636","2022","COM","2020","10716","105","10821","2023-01-02"
"59637","2022","COM","2020","1327","14","1341","2023-01-02"
"59638","2022","COM","2020","1330","13","1343","2023-01-02"
"59639","2022","COM","2020","1102","23","1125","2023-01-02"
"59640","2022","COM","2020","774","11","785","2023-01-02"
"59641","2022","COM","2020","2009","36","2045","2023-01-02"
"59642","2022","COM","2020","590","16","606","2023-01-02"
"59643","2022","COM","2020","235","5","240","2023-01-02"
"59645","2022","COM","2020","593","4","597","2023-01-02"
"59646","2022","COM","2020","20980","210","21190","2023-01-02"
"59647","2022","COM","2020","2587","21","2608","2023-01-02"
"59648","2022","COM","2020","15372","200","15572","2023-01-02"
"59649","2022","COM","2020","239","5","244","2023-01-02"
"59650","2022","COM","2020","41015","182","41197","2023-01-02"
"59651","2022","COM","2020","1624","11","1635","2023-01-02"
"59652","2022","COM","2020","419","0","419","2023-01-02"
"59653","2022","COM","2020","7736","57","7793","2023-01-02"
"59654","2022","COM","2020","7381","63","7444","2023-01-02"
"59655","2022","COM","2020","246","4","250","2023-01-02"
"59656","2022","COM","2020","5322","51","5373","2023-01-02"
"59657","2022","COM","2020","632","7","639","2023-01-02"
"59658","2022","COM","2020","533","7","540","2023-01-02"
"59659","2022","COM","2020","2830","33","2863","2023-01-02"
"59660","2022","COM","2020","3023","30","3053","2023-01-02"
"59661","2022","COM","2020","133","2","135","2023-01-02"
"59662","2022","COM","2020","1319","22","1341","2023-01-02"
"59663","2022","COM","2020","5709","85","5794","2023-01-02"
"59664","2022","COM","2020","322","7","329","2023-01-02"
"59665","2022","COM","2020","299","6","305","2023-01-02"
"59666","2022","COM","2020","1540","25","1565","2023-01-02"
"59667","2022","COM","2020","231","6","237","2023-01-02"
"59668","2022","COM","2020","1593","60","1653","2023-01-02"
"59669","2022","COM","2020","512","17","529","2023-01-02"
"59670","2022","COM","2020","1362","12","1374","2023-01-02"
"60001","2022","COM","2020","606","13","619","2023-01-02"
"60002","2022","COM","2020","822","25","847","2023-01-02"
"60003","2022","COM","2020","508","13","521","2023-01-02"
"60004","2022","COM","2020","407","7","414","2023-01-02"
"60005","2022","COM","2020","889","13","902","2023-01-02"
"60006","2022","COM","2020","1143","20","1163","2023-01-02"
"60007","2022","COM","2020","3054","99","3153","2023-01-02"
"60008","2022","COM","2020","370","163","533","2023-01-02"
"60009","2022","COM","2020","1659","33","1692","2023-01-02"
"60010","2022","COM","2020","1752","18","1770","2023-01-02"
"60011","2022","COM","2020","410","2","412","2023-01-02"
"60012","2022","COM","2020","3332","40","3372","2023-01-02"
"60013","2022","COM","2020","1374","28","1402","2023-01-02"
"60014","2022","COM","2020","166","5","171","2023-01-02"
"60015","2022","COM","2020","1147","14","1161","2023-01-02"
"60016","2022","COM","2020","273","8","281","2023-01-02"
"60017","2022","COM","2020","1185","20","1205","2023-01-02"
"60019","2022","COM","2020","417","12","429","2023-01-02"
"60020","2022","COM","2020","261","3","264","2023-01-02"
"60021","2022","COM","2020","529","6","535","2023-01-02"
"60022","2022","COM","2020","642","14","656","2023-01-02"
"60023","2022","COM","2020","539","17","556","2023-01-02"
"60024","2022","COM","2020","784","9","793","2023-01-02"
"60025","2022","COM","2020","1864","41","1905","2023-01-02"
"60026","2022","COM","2020","577","10","587","2023-01-02"
"60027","2022","COM","2020","532","14","546","2023-01-02"
"60028","2022","COM","2020","494","22","516","2023-01-02"
"60029","2022","COM","2020","2856","39","2895","2023-01-02"
"60030","2022","COM","2020","556","9","565","2023-01-02"
"60031","2022","COM","2020","265","7","272","2023-01-02"
"60032","2022","COM","2020","717","14","731","2023-01-02"
"60033","2022","COM","2020","885","39","924","2023-01-02"
"60034","2022","COM","2020","1169","17","1186","2023-01-02"
"60035","2022","COM","2020","245","4","249","2023-01-02"
"60036","2022","COM","2020","390","6","396","2023-01-02"
"60037","2022","COM","2020","510","8","518","2023-01-02"
"60039","2022","COM","2020","484","6","490","2023-01-02"
"60040","2022","COM","2020","642","11","653","2023-01-02"
"60041","2022","COM","2020","2321","60","2381","2023-01-02"
"60042","2022","COM","2020","1486","46","1532","2023-01-02"
"60043","2022","COM","2020","615","13","628","2023-01-02"
"60044","2022","COM","2020","1671","26","1697","2023-01-02"
"60045","2022","COM","2020","563","10","573","2023-01-02"
"60046","2022","COM","2020","342","6","348","2023-01-02"
"60047","2022","COM","2020","763","16","779","2023-01-02"
"60048","2022","COM","2020","278","5","283","2023-01-02"
"60049","2022","COM","2020","106","3","109","2023-01-02"
"60050","2022","COM","2020","351","8","359","2023-01-02"
"60051","2022","COM","2020","177","1","178","2023-01-02"
"60052","2022","COM","2020","98","3","101","2023-01-02"
"60053","2022","COM","2020","591","50","641","2023-01-02"
"60054","2022","COM","2020","873","19","892","2023-01-02"
"60055","2022","COM","2020","340","5","345","2023-01-02"
"60056","2022","COM","2020","65","1","66","2023-01-02"
"60057","2022","COM","2020","56889","1417","58306","2023-01-02"
"60058","2022","COM","2020","212","4","216","2023-01-02"
"60059","2022","COM","2020","202","3","205","2023-01-02"
"60060","2022","COM","2020","656","11","667","2023-01-02"
"60061","2022","COM","2020","79","5","84","2023-01-02"
"60062","2022","COM","2020","316","4","320","2023-01-02"
"60063","2022","COM","2020","798","19","817","2023-01-02"
"60064","2022","COM","2020","989","17","1006","2023-01-02"
"60065","2022","COM","2020","1616","33","1649","2023-01-02"
"60066","2022","COM","2020","202","10","212","2023-01-02"
"60067","2022","COM","2020","999","19","1018","2023-01-02"
"60068","2022","COM","2020","3154","41","3195","2023-01-02"
"60069","2022","COM","2020","1131","40","1171","2023-01-02"
"60070","2022","COM","2020","452","10","462","2023-01-02"
"60071","2022","COM","2020","172","5","177","2023-01-02"
"60072","2022","COM","2020","317","12","329","2023-01-02"
"60073","2022","COM","2020","568","6","574","2023-01-02"
"60074","2022","COM","2020","1191","29","1220","2023-01-02"
"60075","2022","COM","2020","142","0","142","2023-01-02"
"60076","2022","COM","2020","516","9","525","2023-01-02"
"60077","2022","COM","2020","354","9","363","2023-01-02"
"60078","2022","COM","2020","116","2","118","2023-01-02"
"60079","2022","COM","2020","981","12","993","2023-01-02"
"60081","2022","COM","2020","477","9","486","2023-01-02"
"60082","2022","COM","2020","782","16","798","2023-01-02"
"60083","2022","COM","2020","982","23","1005","2023-01-02"
"60084","2022","COM","2020","189","1","190","2023-01-02"
"60085","2022","COM","2020","196","1","197","2023-01-02"
"60086","2022","COM","2020","2129","45","2174","2023-01-02"
"60087","2022","COM","2020","340","17","357","2023-01-02"
"60088","2022","COM","2020","4774","70","4844","2023-01-02"
"60089","2022","COM","2020","401","5","406","2023-01-02"
"60090","2022","COM","2020","386","6","392","2023-01-02"
"60091","2022","COM","2020","420","6","426","2023-01-02"
"60092","2022","COM","2020","214","5","219","2023-01-02"
"60093","2022","COM","2020","462","9","471","2023-01-02"
"60094","2022","COM","2020","314","3","317","2023-01-02"
"60095","2022","COM","2020","343","7","350","2023-01-02"
"60097","2022","COM","2020","209","5","214","2023-01-02"
"60098","2022","COM","2020","159","4","163","2023-01-02"
"60099","2022","COM","2020","174","3","177","2023-01-02"
"60100","2022","COM","2020","113","6","119","2023-01-02"
"60101","2022","COM","2020","661","14","675","2023-01-02"
"60102","2022","COM","2020","2008","39","2047","2023-01-02"
"60103","2022","COM","2020","3993","54","4047","2023-01-02"
"60104","2022","COM","2020","4192","110","4302","2023-01-02"
"60105","2022","COM","2020","427","8","435","2023-01-02"
"60106","2022","COM","2020","2668","39","2707","2023-01-02"
"60107","2022","COM","2020","3133","145","3278","2023-01-02"
"60108","2022","COM","2020","293","8","301","2023-01-02"
"60109","2022","COM","2020","254","4","258","2023-01-02"
"60110","2022","COM","2020","252","0","252","2023-01-02"
"60111","2022","COM","2020","148","2","150","2023-01-02"
"60112","2022","COM","2020","351","1","352","2023-01-02"
"60113","2022","COM","2020","203","2","205","2023-01-02"
"60114","2022","COM","2020","148","1","149","2023-01-02"
"60115","2022","COM","2020","878","16","894","2023-01-02"
"60116","2022","COM","2020","2951","41","2992","2023-01-02"
"60117","2022","COM","2020","310","13","323","2023-01-02"
"60118","2022","COM","2020","507","9","516","2023-01-02"
"60119","2022","COM","2020","1920","31","1951","2023-01-02"
"60120","2022","COM","2020","1203","25","1228","2023-01-02"
"60121","2022","COM","2020","160","4","164","2023-01-02"
"60122","2022","COM","2020","490","10","500","2023-01-02"
"60123","2022","COM","2020","481","0","481","2023-01-02"
"60124","2022","COM","2020","317","7","324","2023-01-02"
"60125","2022","COM","2020","754","19","773","2023-01-02"
"60126","2022","COM","2020","513","12","525","2023-01-02"
"60127","2022","COM","2020","403","3","406","2023-01-02"
"60128","2022","COM","2020","225","0","225","2023-01-02"
"60129","2022","COM","2020","1475","30","1505","2023-01-02"
"60130","2022","COM","2020","1035","23","1058","2023-01-02"
"60131","2022","COM","2020","104","2","106","2023-01-02"
"60132","2022","COM","2020","185","3","188","2023-01-02"
"60133","2022","COM","2020","538","4","542","2023-01-02"
"60134","2022","COM","2020","2634","26","2660","2023-01-02"
"60135","2022","COM","2020","1629","37","1666","2023-01-02"
"60136","2022","COM","2020","502","12","514","2023-01-02"
"60137","2022","COM","2020","293","3","296","2023-01-02"
"60138","2022","COM","2020","1025","28","1053","2023-01-02"
"60139","2022","COM","2020","10127","139","10266","2023-01-02"
"60140","2022","COM","2020","310","7","317","2023-01-02"
"60141","2022","COM","2020","10604","217","10821","2023-01-02"
"60142","2022","COM","2020","3141","90","3231","2023-01-02"
"60143","2022","COM","2020","3348","43","3391","2023-01-02"
"60144","2022","COM","2020","172","4","176","2023-01-02"
"60145","2022","COM","2020","473","12","485","2023-01-02"
"60146","2022","COM","2020","463","4","467","2023-01-02"
"60147","2022","COM","2020","790","33","823","2023-01-02"
"60148","2022","COM","2020","412","10","422","2023-01-02"
"60149","2022","COM","2020","2018","67","2085","2023-01-02"
"60150","2022","COM","2020","1177","26","1203","2023-01-02"
"60151","2022","COM","2020","3307","105","3412","2023-01-02"
"60152","2022","COM","2020","247","1","248","2023-01-02"
"60153","2022","COM","2020","102","0","102","2023-01-02"
"60154","2022","COM","2020","1604","57","1661","2023-01-02"
"60155","2022","COM","2020","3995","55","4050","2023-01-02"
"60156","2022","COM","2020","2245","47","2292","2023-01-02"
"60157","2022","COM","2020","10268","213","10481","2023-01-02"
"60158","2022","COM","2020","245","2","247","2023-01-02"
"60159","2022","COM","2020","40453","1017","41470","2023-01-02"
"60160","2022","COM","2020","728","13","741","2023-01-02"
"60161","2022","COM","2020","72","0","72","2023-01-02"
"60162","2022","COM","2020","312","8","320","2023-01-02"
"60163","2022","COM","2020","403","6","409","2023-01-02"
"60164","2022","COM","2020","859","10","869","2023-01-02"
"60165","2022","COM","2020","528","14","542","2023-01-02"
"60166","2022","COM","2020","1063","32","1095","2023-01-02"
"60167","2022","COM","2020","592","14","606","2023-01-02"
"60168","2022","COM","2020","214","2","216","2023-01-02"
"60169","2022","COM","2020","810","22","832","2023-01-02"
"60170","2022","COM","2020","568","35","603","2023-01-02"
"60171","2022","COM","2020","179","3","182","2023-01-02"
"60172","2022","COM","2020","3972","146","4118","2023-01-02"
"60173","2022","COM","2020","810","12","822","2023-01-02"
"60174","2022","COM","2020","211","4","215","2023-01-02"
"60175","2022","COM","2020","35970","223","36193","2023-01-02"
"60176","2022","COM","2020","14365","280","14645","2023-01-02"
"60177","2022","COM","2020","442","8","450","2023-01-02"
"60178","2022","COM","2020","3472","126","3598","2023-01-02"
"60179","2022","COM","2020","151","1","152","2023-01-02"
"60180","2022","COM","2020","497","15","512","2023-01-02"
"60181","2022","COM","2020","908","18","926","2023-01-02"
"60182","2022","COM","2020","176","4","180","2023-01-02"
"60183","2022","COM","2020","248","9","257","2023-01-02"
"60184","2022","COM","2020","207","10","217","2023-01-02"
"60185","2022","COM","2020","1117","9","1126","2023-01-02"
"60186","2022","COM","2020","251","3","254","2023-01-02"
"60187","2022","COM","2020","975","15","990","2023-01-02"
"60188","2022","COM","2020","2220","106","2326","2023-01-02"
"60189","2022","COM","2020","967","21","988","2023-01-02"
"60190","2022","COM","2020","300","6","306","2023-01-02"
"60191","2022","COM","2020","623","6","629","2023-01-02"
"60192","2022","COM","2020","219","6","225","2023-01-02"
"60193","2022","COM","2020","204","2","206","2023-01-02"
"60194","2022","COM","2020","246","2","248","2023-01-02"
"60195","2022","COM","2020","514","10","524","2023-01-02"
"60196","2022","COM","2020","1047","16","1063","2023-01-02"
"60197","2022","COM","2020","924","7","931","2023-01-02"
"60198","2022","COM","2020","392","9","401","2023-01-02"
"60199","2022","COM","2020","256","8","264","2023-01-02"
"60200","2022","COM","2020","318","2","320","2023-01-02"
"60201","2022","COM","2020","242","3","245","2023-01-02"
"60203","2022","COM","2020","429","7","436","2023-01-02"
"60204","2022","COM","2020","303","5","308","2023-01-02"
"60205","2022","COM","2020","50","1","51","2023-01-02"
"60206","2022","COM","2020","877","20","897","2023-01-02"
"60207","2022","COM","2020","286","6","292","2023-01-02"
"60208","2022","COM","2020","121","6","127","2023-01-02"
"60209","2022","COM","2020","544","10","554","2023-01-02"
"60210","2022","COM","2020","267","4","271","2023-01-02"
"60211","2022","COM","2020","598","4","602","2023-01-02"
"60212","2022","COM","2020","1606","26","1632","2023-01-02"
"60213","2022","COM","2020","946","21","967","2023-01-02"
"60214","2022","COM","2020","203","8","211","2023-01-02"
"60215","2022","COM","2020","595","13","608","2023-01-02"
"60216","2022","COM","2020","185","2","187","2023-01-02"
"60217","2022","COM","2020","217","4","221","2023-01-02"
"60218","2022","COM","2020","1626","11","1637","2023-01-02"
"60219","2022","COM","2020","168","1","169","2023-01-02"
"60220","2022","COM","2020","503","16","519","2023-01-02"
"60221","2022","COM","2020","719","3","722","2023-01-02"
"60222","2022","COM","2020","552","17","569","2023-01-02"
"60223","2022","COM","2020","3726","84","3810","2023-01-02"
"60224","2022","COM","2020","160","5","165","2023-01-02"
"60225","2022","COM","2020","821","42","863","2023-01-02"
"60226","2022","COM","2020","421","6","427","2023-01-02"
"60227","2022","COM","2020","233","3","236","2023-01-02"
"60228","2022","COM","2020","465","9","474","2023-01-02"
"60229","2022","COM","2020","230","4","234","2023-01-02"
"60230","2022","COM","2020","524","14","538","2023-01-02"
"60231","2022","COM","2020","422","14","436","2023-01-02"
"60232","2022","COM","2020","468","4","472","2023-01-02"
"60233","2022","COM","2020","1360","21","1381","2023-01-02"
"60234","2022","COM","2020","2578","28","2606","2023-01-02"
"60235","2022","COM","2020","663","20","683","2023-01-02"
"60236","2022","COM","2020","220","3","223","2023-01-02"
"60237","2022","COM","2020","88","1","89","2023-01-02"
"60238","2022","COM","2020","1844","80","1924","2023-01-02"
"60239","2022","COM","2020","575","12","587","2023-01-02"
"60240","2022","COM","2020","234","3","237","2023-01-02"
"60241","2022","COM","2020","330","15","345","2023-01-02"
"60242","2022","COM","2020","504","10","514","2023-01-02"
"60243","2022","COM","2020","175","7","182","2023-01-02"
"60244","2022","COM","2020","146","1","147","2023-01-02"
"60245","2022","COM","2020","2109","24","2133","2023-01-02"
"60247","2022","COM","2020","145","2","147","2023-01-02"
"60248","2022","COM","2020","216","7","223","2023-01-02"
"60249","2022","COM","2020","197","4","201","2023-01-02"
"60250","2022","COM","2020","421","13","434","2023-01-02"
"60251","2022","COM","2020","280","5","285","2023-01-02"
"60252","2022","COM","2020","526","3","529","2023-01-02"
"60253","2022","COM","2020","497","8","505","2023-01-02"
"60254","2022","COM","2020","552","16","568","2023-01-02"
"60255","2022","COM","2020","332","3","335","2023-01-02"
"60256","2022","COM","2020","1324","21","1345","2023-01-02"
"60257","2022","COM","2020","440","10","450","2023-01-02"
"60258","2022","COM","2020","161","6","167","2023-01-02"
"60259","2022","COM","2020","885","23","908","2023-01-02"
"60260","2022","COM","2020","677","21","698","2023-01-02"
"60261","2022","COM","2020","538","13","551","2023-01-02"
"60262","2022","COM","2020","244","6","250","2023-01-02"
"60263","2022","COM","2020","264","1","265","2023-01-02"
"60264","2022","COM","2020","510","13","523","2023-01-02"
"60265","2022","COM","2020","978","15","993","2023-01-02"
"60267","2022","COM","2020","170","6","176","2023-01-02"
"60268","2022","COM","2020","337","1","338","2023-01-02"
"60269","2022","COM","2020","344","5","349","2023-01-02"
"60270","2022","COM","2020","335","85","420","2023-01-02"
"60271","2022","COM","2020","83","2","85","2023-01-02"
"60272","2022","COM","2020","631","19","650","2023-01-02"
"60273","2022","COM","2020","530","16","546","2023-01-02"
"60274","2022","COM","2020","379","14","393","2023-01-02"
"60275","2022","COM","2020","221","0","221","2023-01-02"
"60276","2022","COM","2020","208","2","210","2023-01-02"
"60277","2022","COM","2020","1560","40","1600","2023-01-02"
"60278","2022","COM","2020","406","5","411","2023-01-02"
"60279","2022","COM","2020","195","5","200","2023-01-02"
"60280","2022","COM","2020","107","0","107","2023-01-02"
"60281","2022","COM","2020","539","14","553","2023-01-02"
"60282","2022","COM","2020","8946","386","9332","2023-01-02"
"60283","2022","COM","2020","16","1","17","2023-01-02"
"60284","2022","COM","2020","1804","62","1866","2023-01-02"
"60285","2022","COM","2020","304","15","319","2023-01-02"
"60286","2022","COM","2020","2793","76","2869","2023-01-02"
"60287","2022","COM","2020","360","4","364","2023-01-02"
"60288","2022","COM","2020","475","9","484","2023-01-02"
"60289","2022","COM","2020","265","5","270","2023-01-02"
"60290","2022","COM","2020","387","7","394","2023-01-02"
"60291","2022","COM","2020","1800","23","1823","2023-01-02"
"60292","2022","COM","2020","235","7","242","2023-01-02"
"60293","2022","COM","2020","375","7","382","2023-01-02"
"60294","2022","COM","2020","85","1","86","2023-01-02"
"60295","2022","COM","2020","445","8","453","2023-01-02"
"60296","2022","COM","2020","135","4","139","2023-01-02"
"60297","2022","COM","2020","188","1","189","2023-01-02"
"60298","2022","COM","2020","648","13","661","2023-01-02"
"60299","2022","COM","2020","540","9","549","2023-01-02"
"60301","2022","COM","2020","134","6","140","2023-01-02"
"60302","2022","COM","2020","781","23","804","2023-01-02"
"60303","2022","COM","2020","198","1","199","2023-01-02"
"60304","2022","COM","2020","272","9","281","2023-01-02"
"60305","2022","COM","2020","339","7","346","2023-01-02"
"60306","2022","COM","2020","153","3","156","2023-01-02"
"60307","2022","COM","2020","648","11","659","2023-01-02"
"60308","2022","COM","2020","468","6","474","2023-01-02"
"60309","2022","COM","2020","896","20","916","2023-01-02"
"60310","2022","COM","2020","615","14","629","2023-01-02"
"60311","2022","COM","2020","236","2","238","2023-01-02"
"60312","2022","COM","2020","112","2","114","2023-01-02"
"60313","2022","COM","2020","2510","41","2551","2023-01-02"
"60314","2022","COM","2020","327","4","331","2023-01-02"
"60315","2022","COM","2020","492","12","504","2023-01-02"
"60316","2022","COM","2020","239","6","245","2023-01-02"
"60317","2022","COM","2020","725","8","733","2023-01-02"
"60318","2022","COM","2020","665","13","678","2023-01-02"
"60319","2022","COM","2020","607","5","612","2023-01-02"
"60320","2022","COM","2020","257","6","263","2023-01-02"
"60321","2022","COM","2020","843","7","850","2023-01-02"
"60322","2022","COM","2020","324","5","329","2023-01-02"
"60323","2022","COM","2020","646","11","657","2023-01-02"
"60324","2022","COM","2020","873","11","884","2023-01-02"
"60325","2022","COM","2020","2282","64","2346","2023-01-02"
"60326","2022","COM","2020","599","22","621","2023-01-02"
"60327","2022","COM","2020","1048","18","1066","2023-01-02"
"60328","2022","COM","2020","302","9","311","2023-01-02"
"60329","2022","COM","2020","202","6","208","2023-01-02"
"60330","2022","COM","2020","1339","26","1365","2023-01-02"
"60331","2022","COM","2020","445","6","451","2023-01-02"
"60332","2022","COM","2020","724","9","733","2023-01-02"
"60333","2022","COM","2020","1618","30","1648","2023-01-02"
"60334","2022","COM","2020","846","14","860","2023-01-02"
"60335","2022","COM","2020","148","1","149","2023-01-02"
"60336","2022","COM","2020","189","3","192","2023-01-02"
"60337","2022","COM","2020","773","29","802","2023-01-02"
"60338","2022","COM","2020","4943","164","5107","2023-01-02"
"60339","2022","COM","2020","358","9","367","2023-01-02"
"60340","2022","COM","2020","533","18","551","2023-01-02"
"60341","2022","COM","2020","2055","55","2110","2023-01-02"
"60342","2022","COM","2020","4722","53","4775","2023-01-02"
"60343","2022","COM","2020","615","23","638","2023-01-02"
"60344","2022","COM","2020","507","9","516","2023-01-02"
"60345","2022","COM","2020","190","2","192","2023-01-02"
"60346","2022","COM","2020","8889","241","9130","2023-01-02"
"60347","2022","COM","2020","282","5","287","2023-01-02"
"60348","2022","COM","2020","516","9","525","2023-01-02"
"60350","2022","COM","2020","1371","25","1396","2023-01-02"
"60351","2022","COM","2020","120","2","122","2023-01-02"
"60352","2022","COM","2020","170","2","172","2023-01-02"
"60353","2022","COM","2020","189","1","190","2023-01-02"
"60354","2022","COM","2020","31","1","32","2023-01-02"
"60355","2022","COM","2020","1169","52","1221","2023-01-02"
"60356","2022","COM","2020","640","16","656","2023-01-02"
"60357","2022","COM","2020","551","7","558","2023-01-02"
"60358","2022","COM","2020","1015","25","1040","2023-01-02"
"60359","2022","COM","2020","199","3","202","2023-01-02"
"60360","2022","COM","2020","7083","66","7149","2023-01-02"
"60361","2022","COM","2020","587","12","599","2023-01-02"
"60362","2022","COM","2020","174","6","180","2023-01-02"
"60363","2022","COM","2020","221","1","222","2023-01-02"
"60364","2022","COM","2020","702","8","710","2023-01-02"
"60365","2022","COM","2020","428","5","433","2023-01-02"
"60366","2022","COM","2020","364","5","369","2023-01-02"
"60367","2022","COM","2020","332","8","340","2023-01-02"
"60368","2022","COM","2020","2594","51","2645","2023-01-02"
"60369","2022","COM","2020","2000","36","2036","2023-01-02"
"60370","2022","COM","2020","1314","14","1328","2023-01-02"
"60371","2022","COM","2020","152","2","154","2023-01-02"
"60372","2022","COM","2020","663","16","679","2023-01-02"
"60373","2022","COM","2020","806","20","826","2023-01-02"
"60374","2022","COM","2020","2616","38","2654","2023-01-02"
"60375","2022","COM","2020","394","10","404","2023-01-02"
"60376","2022","COM","2020","175","1","176","2023-01-02"
"60377","2022","COM","2020","284","8","292","2023-01-02"
"60378","2022","COM","2020","388","5","393","2023-01-02"
"60379","2022","COM","2020","612","16","628","2023-01-02"
"60380","2022","COM","2020","1601","26","1627","2023-01-02"
"60381","2022","COM","2020","254","3","257","2023-01-02"
"60382","2022","COM","2020","8704","179","8883","2023-01-02"
"60383","2022","COM","2020","540","13","553","2023-01-02"
"60385","2022","COM","2020","659","14","673","2023-01-02"
"60386","2022","COM","2020","479","8","487","2023-01-02"
"60387","2022","COM","2020","1469","11","1480","2023-01-02"
"60388","2022","COM","2020","135","7","142","2023-01-02"
"60389","2022","COM","2020","244","2","246","2023-01-02"
"60390","2022","COM","2020","329","7","336","2023-01-02"
"60391","2022","COM","2020","220","3","223","2023-01-02"
"60392","2022","COM","2020","792","16","808","2023-01-02"
"60393","2022","COM","2020","601","13","614","2023-01-02"
"60394","2022","COM","2020","104","1","105","2023-01-02"
"60395","2022","COM","2020","14354","192","14546","2023-01-02"
"60396","2022","COM","2020","628","5","633","2023-01-02"
"60397","2022","COM","2020","74","1","75","2023-01-02"
"60398","2022","COM","2020","2267","27","2294","2023-01-02"
"60399","2022","COM","2020","251","3","254","2023-01-02"
"60400","2022","COM","2020","269","7","276","2023-01-02"
"60401","2022","COM","2020","785","20","805","2023-01-02"
"60402","2022","COM","2020","2331","55","2386","2023-01-02"
"60403","2022","COM","2020","1836","35","1871","2023-01-02"
"60404","2022","COM","2020","1467","36","1503","2023-01-02"
"60405","2022","COM","2020","1144","17","1161","2023-01-02"
"60406","2022","COM","2020","869","20","889","2023-01-02"
"60407","2022","COM","2020","215","2","217","2023-01-02"
"60408","2022","COM","2020","784","16","800","2023-01-02"
"60409","2022","COM","2020","2164","40","2204","2023-01-02"
"60410","2022","COM","2020","249","8","257","2023-01-02"
"60411","2022","COM","2020","773","23","796","2023-01-02"
"60412","2022","COM","2020","683","11","694","2023-01-02"
"60413","2022","COM","2020","420","9","429","2023-01-02"
"60414","2022","COM","2020","13683","151","13834","2023-01-02"
"60415","2022","COM","2020","136","9","145","2023-01-02"
"60416","2022","COM","2020","170","2","172","2023-01-02"
"60418","2022","COM","2020","406","13","419","2023-01-02"
"60420","2022","COM","2020","495","9","504","2023-01-02"
"60421","2022","COM","2020","397","6","403","2023-01-02"
"60422","2022","COM","2020","200","11","211","2023-01-02"
"60423","2022","COM","2020","1151","26","1177","2023-01-02"
"60424","2022","COM","2020","272","4","276","2023-01-02"
"60425","2022","COM","2020","483","13","496","2023-01-02"
"60426","2022","COM","2020","248","1","249","2023-01-02"
"60427","2022","COM","2020","184","1","185","2023-01-02"
"60428","2022","COM","2020","642","27","669","2023-01-02"
"60429","2022","COM","2020","408","16","424","2023-01-02"
"60430","2022","COM","2020","1096","13","1109","2023-01-02"
"60431","2022","COM","2020","538","11","549","2023-01-02"
"60432","2022","COM","2020","875","29","904","2023-01-02"
"60433","2022","COM","2020","1008","20","1028","2023-01-02"
"60434","2022","COM","2020","223","6","229","2023-01-02"
"60435","2022","COM","2020","491","9","500","2023-01-02"
"60436","2022","COM","2020","72","2","74","2023-01-02"
"60437","2022","COM","2020","82","0","82","2023-01-02"
"60438","2022","COM","2020","196","5","201","2023-01-02"
"60439","2022","COM","2020","5270","59","5329","2023-01-02"
"60440","2022","COM","2020","599","16","615","2023-01-02"
"60441","2022","COM","2020","705","7","712","2023-01-02"
"60442","2022","COM","2020","143","6","149","2023-01-02"
"60443","2022","COM","2020","588","4","592","2023-01-02"
"60444","2022","COM","2020","153","2","155","2023-01-02"
"60445","2022","COM","2020","310","2","312","2023-01-02"
"60446","2022","COM","2020","4153","63","4216","2023-01-02"
"60447","2022","COM","2020","651","14","665","2023-01-02"
"60448","2022","COM","2020","388","6","394","2023-01-02"
"60449","2022","COM","2020","279","6","285","2023-01-02"
"60450","2022","COM","2020","4023","41","4064","2023-01-02"
"60451","2022","COM","2020","1632","27","1659","2023-01-02"
"60452","2022","COM","2020","484","14","498","2023-01-02"
"60454","2022","COM","2020","956","31","987","2023-01-02"
"60456","2022","COM","2020","915","28","943","2023-01-02"
"60457","2022","COM","2020","163","2","165","2023-01-02"
"60458","2022","COM","2020","312","15","327","2023-01-02"
"60459","2022","COM","2020","203","3","206","2023-01-02"
"60460","2022","COM","2020","200","8","208","2023-01-02"
"60461","2022","COM","2020","199","13","212","2023-01-02"
"60462","2022","COM","2020","2819","48","2867","2023-01-02"
"60463","2022","COM","2020","21589","344","21933","2023-01-02"
"60464","2022","COM","2020","1122","15","1137","2023-01-02"
"60465","2022","COM","2020","183","6","189","2023-01-02"
"60466","2022","COM","2020","257","3","260","2023-01-02"
"60468","2022","COM","2020","305","4","309","2023-01-02"
"60469","2022","COM","2020","358","9","367","2023-01-02"
"60470","2022","COM","2020","903","14","917","2023-01-02"
"60471","2022","COM","2020","13197","212","13409","2023-01-02"
"60472","2022","COM","2020","118","1","119","2023-01-02"
"60473","2022","COM","2020","293","1","294","2023-01-02"
"60474","2022","COM","2020","286","6","292","2023-01-02"
"60476","2022","COM","2020","200","7","207","2023-01-02"
"60477","2022","COM","2020","1399","22","1421","2023-01-02"
"60478","2022","COM","2020","363","9","372","2023-01-02"
"60479","2022","COM","2020","687","10","697","2023-01-02"
"60480","2022","COM","2020","549","17","566","2023-01-02"
"60481","2022","COM","2020","617","13","630","2023-01-02"
"60482","2022","COM","2020","3385","88","3473","2023-01-02"
"60483","2022","COM","2020","535","45","580","2023-01-02"
"60484","2022","COM","2020","284","6","290","2023-01-02"
"60485","2022","COM","2020","240","5","245","2023-01-02"
"60486","2022","COM","2020","571","10","581","2023-01-02"
"60487","2022","COM","2020","327","15","342","2023-01-02"
"60488","2022","COM","2020","272","6","278","2023-01-02"
"60489","2022","COM","2020","1189","19","1208","2023-01-02"
"60490","2022","COM","2020","369","14","383","2023-01-02"
"60491","2022","COM","2020","1877","150","2027","2023-01-02"
"60492","2022","COM","2020","856","19","875","2023-01-02"
"60493","2022","COM","2020","509","10","519","2023-01-02"
"60494","2022","COM","2020","1852","37","1889","2023-01-02"
"60495","2022","COM","2020","410","5","415","2023-01-02"
"60496","2022","COM","2020","164","1","165","2023-01-02"
"60497","2022","COM","2020","212","1","213","2023-01-02"
"60498","2022","COM","2020","532","3","535","2023-01-02"
"60499","2022","COM","2020","231","5","236","2023-01-02"
"60500","2022","COM","2020","3832","54","3886","2023-01-02"
"60501","2022","COM","2020","1332","31","1363","2023-01-02"
"60502","2022","COM","2020","95","4","99","2023-01-02"
"60503","2022","COM","2020","112","3","115","2023-01-02"
"60504","2022","COM","2020","1127","15","1142","2023-01-02"
"60505","2022","COM","2020","872","22","894","2023-01-02"
"60506","2022","COM","2020","679","12","691","2023-01-02"
"60507","2022","COM","2020","453","11","464","2023-01-02"
"60508","2022","COM","2020","3235","74","3309","2023-01-02"
"60509","2022","COM","2020","12512","125","12637","2023-01-02"
"60510","2022","COM","2020","663","16","679","2023-01-02"
"60511","2022","COM","2020","401","11","412","2023-01-02"
"60512","2022","COM","2020","158","2","160","2023-01-02"
"60513","2022","COM","2020","3227","71","3298","2023-01-02"
"60514","2022","COM","2020","247","1","248","2023-01-02"
"60515","2022","COM","2020","374","13","387","2023-01-02"
"60516","2022","COM","2020","407","8","415","2023-01-02"
"60517","2022","COM","2020","845","12","857","2023-01-02"
"60518","2022","COM","2020","205","4","209","2023-01-02"
"60519","2022","COM","2020","174","5","179","2023-01-02"
"60520","2022","COM","2020","225","7","232","2023-01-02"
"60521","2022","COM","2020","400","17","417","2023-01-02"
"60522","2022","COM","2020","312","3","315","2023-01-02"
"60523","2022","COM","2020","907","15","922","2023-01-02"
"60524","2022","COM","2020","2540","29","2569","2023-01-02"
"60525","2022","COM","2020","124","5","129","2023-01-02"
"60526","2022","COM","2020","1064","13","1077","2023-01-02"
"60527","2022","COM","2020","143","0","143","2023-01-02"
"60528","2022","COM","2020","125","4","129","2023-01-02"
"60529","2022","COM","2020","76","2","78","2023-01-02"
"60530","2022","COM","2020","215","9","224","2023-01-02"
"60531","2022","COM","2020","1960","39","1999","2023-01-02"
"60533","2022","COM","2020","1707","29","1736","2023-01-02"
"60534","2022","COM","2020","636","20","656","2023-01-02"
"60535","2022","COM","2020","329","6","335","2023-01-02"
"60536","2022","COM","2020","134","8","142","2023-01-02"
"60537","2022","COM","2020","3683","174","3857","2023-01-02"
"60538","2022","COM","2020","298","5","303","2023-01-02"
"60539","2022","COM","2020","1542","21","1563","2023-01-02"
"60540","2022","COM","2020","627","15","642","2023-01-02"
"60541","2022","COM","2020","354","12","366","2023-01-02"
"60542","2022","COM","2020","995","17","1012","2023-01-02"
"60543","2022","COM","2020","118","1","119","2023-01-02"
"60544","2022","COM","2020","195","1","196","2023-01-02"
"60545","2022","COM","2020","529","9","538","2023-01-02"
"60546","2022","COM","2020","139","4","143","2023-01-02"
"60547","2022","COM","2020","624","17","641","2023-01-02"
"60548","2022","COM","2020","603","7","610","2023-01-02"
"60549","2022","COM","2020","223","6","229","2023-01-02"
"60550","2022","COM","2020","224","0","224","2023-01-02"
"60551","2022","COM","2020","292","7","299","2023-01-02"
"60552","2022","COM","2020","243","9","252","2023-01-02"
"60553","2022","COM","2020","272","7","279","2023-01-02"
"60554","2022","COM","2020","475","9","484","2023-01-02"
"60555","2022","COM","2020","59","1","60","2023-01-02"
"60556","2022","COM","2020","202","3","205","2023-01-02"
"60557","2022","COM","2020","315","8","323","2023-01-02"
"60558","2022","COM","2020","458","19","477","2023-01-02"
"60559","2022","COM","2020","834","9","843","2023-01-02"
"60560","2022","COM","2020","730","33","763","2023-01-02"
"60561","2022","COM","2020","209","6","215","2023-01-02"
"60562","2022","COM","2020","1589","25","1614","2023-01-02"
"60563","2022","COM","2020","617","7","624","2023-01-02"
"60564","2022","COM","2020","281","3","284","2023-01-02"
"60565","2022","COM","2020","516","4","520","2023-01-02"
"60566","2022","COM","2020","199","3","202","2023-01-02"
"60567","2022","COM","2020","1175","28","1203","2023-01-02"
"60568","2022","COM","2020","332","8","340","2023-01-02"
"60569","2022","COM","2020","180","9","189","2023-01-02"
"60570","2022","COM","2020","1578","23","1601","2023-01-02"
"60571","2022","COM","2020","82","2","84","2023-01-02"
"60572","2022","COM","2020","290","9","299","2023-01-02"
"60573","2022","COM","2020","335","2","337","2023-01-02"
"60574","2022","COM","2020","620","14","634","2023-01-02"
"60575","2022","COM","2020","3380","43","3423","2023-01-02"
"60576","2022","COM","2020","484","14","498","2023-01-02"
"60577","2022","COM","2020","1706","34","1740","2023-01-02"
"60578","2022","COM","2020","1074","17","1091","2023-01-02"
"60579","2022","COM","2020","330","6","336","2023-01-02"
"60581","2022","COM","2020","6056","49","6105","2023-01-02"
"60582","2022","COM","2020","759","20","779","2023-01-02"
"60583","2022","COM","2020","365","9","374","2023-01-02"
"60584","2022","COM","2020","4637","110","4747","2023-01-02"
"60585","2022","COM","2020","285","5","290","2023-01-02"
"60586","2022","COM","2020","1025","22","1047","2023-01-02"
"60587","2022","COM","2020","1450","29","1479","2023-01-02"
"60588","2022","COM","2020","370","6","376","2023-01-02"
"60589","2022","COM","2020","2907","114","3021","2023-01-02"
"60590","2022","COM","2020","1245","24","1269","2023-01-02"
"60591","2022","COM","2020","1571","65","1636","2023-01-02"
"60592","2022","COM","2020","698","19","717","2023-01-02"
"60593","2022","COM","2020","135","2","137","2023-01-02"
"60594","2022","COM","2020","277","6","283","2023-01-02"
"60595","2022","COM","2020","438","3","441","2023-01-02"
"60596","2022","COM","2020","244","2","246","2023-01-02"
"60597","2022","COM","2020","1735","33","1768","2023-01-02"
"60598","2022","COM","2020","1047","85","1132","2023-01-02"
"60599","2022","COM","2020","289","5","294","2023-01-02"
"60600","2022","COM","2020","633","7","640","2023-01-02"
"60601","2022","COM","2020","1037","14","1051","2023-01-02"
"60602","2022","COM","2020","56","6","62","2023-01-02"
"60603","2022","COM","2020","898","23","921","2023-01-02"
"60604","2022","COM","2020","267","2","269","2023-01-02"
"60605","2022","COM","2020","349","5","354","2023-01-02"
"60608","2022","COM","2020","106","1","107","2023-01-02"
"60609","2022","COM","2020","908","25","933","2023-01-02"
"60610","2022","COM","2020","766","12","778","2023-01-02"
"60611","2022","COM","2020","589","14","603","2023-01-02"
"60612","2022","COM","2020","15128","581","15709","2023-01-02"
"60613","2022","COM","2020","344","7","351","2023-01-02"
"60614","2022","COM","2020","197","6","203","2023-01-02"
"60615","2022","COM","2020","133","1","134","2023-01-02"
"60616","2022","COM","2020","2759","29","2788","2023-01-02"
"60617","2022","COM","2020","273","3","276","2023-01-02"
"60618","2022","COM","2020","279","5","284","2023-01-02"
"60619","2022","COM","2020","1185","27","1212","2023-01-02"
"60620","2022","COM","2020","455","9","464","2023-01-02"
"60621","2022","COM","2020","138","0","138","2023-01-02"
"60622","2022","COM","2020","482","5","487","2023-01-02"
"60623","2022","COM","2020","950","82","1032","2023-01-02"
"60624","2022","COM","2020","171","3","174","2023-01-02"
"60625","2022","COM","2020","574","13","587","2023-01-02"
"60626","2022","COM","2020","662","17","679","2023-01-02"
"60627","2022","COM","2020","256","3","259","2023-01-02"
"60628","2022","COM","2020","1067","23","1090","2023-01-02"
"60629","2022","COM","2020","195","9","204","2023-01-02"
"60630","2022","COM","2020","196","3","199","2023-01-02"
"60631","2022","COM","2020","1080","23","1103","2023-01-02"
"60632","2022","COM","2020","754","16","770","2023-01-02"
"60633","2022","COM","2020","406","0","406","2023-01-02"
"60634","2022","COM","2020","438","9","447","2023-01-02"
"60635","2022","COM","2020","1078","10","1088","2023-01-02"
"60636","2022","COM","2020","4455","75","4530","2023-01-02"
"60637","2022","COM","2020","497","11","508","2023-01-02"
"60638","2022","COM","2020","675","9","684","2023-01-02"
"60639","2022","COM","2020","1251","26","1277","2023-01-02"
"60640","2022","COM","2020","172","1","173","2023-01-02"
"60641","2022","COM","2020","1720","47","1767","2023-01-02"
"60642","2022","COM","2020","1063","32","1095","2023-01-02"
"60643","2022","COM","2020","1369","14","1383","2023-01-02"
"60644","2022","COM","2020","1914","33","1947","2023-01-02"
"60645","2022","COM","2020","306","6","312","2023-01-02"
"60646","2022","COM","2020","1347","35","1382","2023-01-02"
"60647","2022","COM","2020","2050","55","2105","2023-01-02"
"60648","2022","COM","2020","321","3","324","2023-01-02"
"60650","2022","COM","2020","529","25","554","2023-01-02"
"60651","2022","COM","2020","1895","31","1926","2023-01-02"
"60652","2022","COM","2020","913","10","923","2023-01-02"
"60653","2022","COM","2020","300","6","306","2023-01-02"
"60654","2022","COM","2020","263","5","268","2023-01-02"
"60655","2022","COM","2020","364","10","374","2023-01-02"
"60656","2022","COM","2020","280","2","282","2023-01-02"
"60657","2022","COM","2020","246","5","251","2023-01-02"
"60658","2022","COM","2020","694","9","703","2023-01-02"
"60659","2022","COM","2020","171","2","173","2023-01-02"
"60660","2022","COM","2020","405","11","416","2023-01-02"
"60661","2022","COM","2020","986","74","1060","2023-01-02"
"60662","2022","COM","2020","505","13","518","2023-01-02"
"60663","2022","COM","2020","260","3","263","2023-01-02"
"60664","2022","COM","2020","446","11","457","2023-01-02"
"60665","2022","COM","2020","2840","58","2898","2023-01-02"
"60666","2022","COM","2020","1141","26","1167","2023-01-02"
"60667","2022","COM","2020","3788","54","3842","2023-01-02"
"60668","2022","COM","2020","733","17","750","2023-01-02"
"60669","2022","COM","2020","490","12","502","2023-01-02"
"60670","2022","COM","2020","4738","115","4853","2023-01-02"
"60671","2022","COM","2020","350","19","369","2023-01-02"
"60672","2022","COM","2020","270","13","283","2023-01-02"
"60673","2022","COM","2020","213","1","214","2023-01-02"
"60674","2022","COM","2020","600","31","631","2023-01-02"
"60675","2022","COM","2020","429","5","434","2023-01-02"
"60676","2022","COM","2020","755","17","772","2023-01-02"
"60677","2022","COM","2020","253","10","263","2023-01-02"
"60678","2022","COM","2020","1153","24","1177","2023-01-02"
"60679","2022","COM","2020","151","6","157","2023-01-02"
"60680","2022","COM","2020","682","19","701","2023-01-02"
"60681","2022","COM","2020","463","17","480","2023-01-02"
"60682","2022","COM","2020","714","18","732","2023-01-02"
"60683","2022","COM","2020","390","16","406","2023-01-02"
"60684","2022","COM","2020","6442","65","6507","2023-01-02"
"60685","2022","COM","2020","1028","10","1038","2023-01-02"
"60686","2022","COM","2020","2307","57","2364","2023-01-02"
"60687","2022","COM","2020","372","10","382","2023-01-02"
"60688","2022","COM","2020","159","1","160","2023-01-02"
"60689","2022","COM","2020","1400","48","1448","2023-01-02"
"60691","2022","COM","2020","115","0","115","2023-01-02"
"60692","2022","COM","2020","143","2","145","2023-01-02"
"60693","2022","COM","2020","412","3","415","2023-01-02"
"60695","2022","COM","2020","1397","49","1446","2023-01-02"
"60697","2022","COM","2020","34","1","35","2023-01-02"
"60698","2022","COM","2020","276","9","285","2023-01-02"
"60699","2022","COM","2020","165","5","170","2023-01-02"
"60700","2022","COM","2020","1200","22","1222","2023-01-02"
"60701","2022","COM","2020","1325","8","1333","2023-01-02"
"60702","2022","COM","2020","247","3","250","2023-01-02"
"60703","2022","COM","2020","891","19","910","2023-01-02"
"61001","2022","COM","2020","25744","720","26464","2023-01-02"
"61002","2022","COM","2020","647","10","657","2023-01-02"
"61005","2022","COM","2020","280","8","288","2023-01-02"
"61006","2022","COM","2020","13401","364","13765","2023-01-02"
"61007","2022","COM","2020","4224","83","4307","2023-01-02"
"61008","2022","COM","2020","1258","46","1304","2023-01-02"
"61010","2022","COM","2020","123","6","129","2023-01-02"
"61011","2022","COM","2020","408","14","422","2023-01-02"
"61012","2022","COM","2020","210","2","212","2023-01-02"
"61013","2022","COM","2020","138","0","138","2023-01-02"
"61014","2022","COM","2020","248","9","257","2023-01-02"
"61015","2022","COM","2020","261","5","266","2023-01-02"
"61017","2022","COM","2020","82","0","82","2023-01-02"
"61018","2022","COM","2020","65","1","66","2023-01-02"
"61020","2022","COM","2020","214","7","221","2023-01-02"
"61021","2022","COM","2020","100","4","104","2023-01-02"
"61023","2022","COM","2020","612","22","634","2023-01-02"
"61024","2022","COM","2020","610","16","626","2023-01-02"
"61026","2022","COM","2020","181","8","189","2023-01-02"
"61028","2022","COM","2020","456","11","467","2023-01-02"
"61029","2022","COM","2020","838","23","861","2023-01-02"
"61030","2022","COM","2020","272","6","278","2023-01-02"
"61032","2022","COM","2020","329","8","337","2023-01-02"
"61034","2022","COM","2020","199","7","206","2023-01-02"
"61035","2022","COM","2020","272","3","275","2023-01-02"
"61036","2022","COM","2020","204","0","204","2023-01-02"
"61037","2022","COM","2020","130","3","133","2023-01-02"
"61038","2022","COM","2020","1455","20","1475","2023-01-02"
"61039","2022","COM","2020","131","1","132","2023-01-02"
"61040","2022","COM","2020","1053","30","1083","2023-01-02"
"61041","2022","COM","2020","205","4","209","2023-01-02"
"61043","2022","COM","2020","1088","21","1109","2023-01-02"
"61044","2022","COM","2020","446","15","461","2023-01-02"
"61046","2022","COM","2020","134","0","134","2023-01-02"
"61048","2022","COM","2020","124","4","128","2023-01-02"
"61049","2022","COM","2020","121","1","122","2023-01-02"
"61050","2022","COM","2020","588","21","609","2023-01-02"
"61051","2022","COM","2020","358","5","363","2023-01-02"
"61052","2022","COM","2020","190","4","194","2023-01-02"
"61053","2022","COM","2020","233","7","240","2023-01-02"
"61054","2022","COM","2020","254","4","258","2023-01-02"
"61055","2022","COM","2020","598","8","606","2023-01-02"
"61056","2022","COM","2020","167","1","168","2023-01-02"
"61060","2022","COM","2020","156","5","161","2023-01-02"
"61061","2022","COM","2020","1475","30","1505","2023-01-02"
"61062","2022","COM","2020","92","1","93","2023-01-02"
"61063","2022","COM","2020","1510","38","1548","2023-01-02"
"61064","2022","COM","2020","93","1","94","2023-01-02"
"61066","2022","COM","2020","105","6","111","2023-01-02"
"61067","2022","COM","2020","163","1","164","2023-01-02"
"61068","2022","COM","2020","203","1","204","2023-01-02"
"61069","2022","COM","2020","164","7","171","2023-01-02"
"61070","2022","COM","2020","825","23","848","2023-01-02"
"61071","2022","COM","2020","170","7","177","2023-01-02"
"61072","2022","COM","2020","201","4","205","2023-01-02"
"61074","2022","COM","2020","630","9","639","2023-01-02"
"61075","2022","COM","2020","1161","26","1187","2023-01-02"
"61076","2022","COM","2020","138","5","143","2023-01-02"
"61077","2022","COM","2020","876","17","893","2023-01-02"
"61078","2022","COM","2020","713","48","761","2023-01-02"
"61079","2022","COM","2020","1768","24","1792","2023-01-02"
"61080","2022","COM","2020","84","2","86","2023-01-02"
"61081","2022","COM","2020","894","24","918","2023-01-02"
"61082","2022","COM","2020","86","5","91","2023-01-02"
"61084","2022","COM","2020","175","4","179","2023-01-02"
"61085","2022","COM","2020","31","0","31","2023-01-02"
"61086","2022","COM","2020","102","0","102","2023-01-02"
"61087","2022","COM","2020","160","4","164","2023-01-02"
"61088","2022","COM","2020","44","1","45","2023-01-02"
"61089","2022","COM","2020","96","0","96","2023-01-02"
"61091","2022","COM","2020","915","30","945","2023-01-02"
"61092","2022","COM","2020","685","6","691","2023-01-02"
"61093","2022","COM","2020","1259","17","1276","2023-01-02"
"61094","2022","COM","2020","590","17","607","2023-01-02"
"61095","2022","COM","2020","532","8","540","2023-01-02"
"61096","2022","COM","2020","2982","92","3074","2023-01-02"
"61097","2022","COM","2020","515","14","529","2023-01-02"
"61098","2022","COM","2020","461","32","493","2023-01-02"
"61099","2022","COM","2020","245","8","253","2023-01-02"
"61100","2022","COM","2020","287","17","304","2023-01-02"
"61101","2022","COM","2020","196","4","200","2023-01-02"
"61102","2022","COM","2020","404","9","413","2023-01-02"
"61103","2022","COM","2020","172","1","173","2023-01-02"
"61104","2022","COM","2020","52","1","53","2023-01-02"
"61105","2022","COM","2020","179","7","186","2023-01-02"
"61107","2022","COM","2020","397","11","408","2023-01-02"
"61108","2022","COM","2020","175","4","179","2023-01-02"
"61111","2022","COM","2020","331","5","336","2023-01-02"
"61113","2022","COM","2020","64","1","65","2023-01-02"
"61114","2022","COM","2020","154","5","159","2023-01-02"
"61116","2022","COM","2020","2005","41","2046","2023-01-02"
"61117","2022","COM","2020","2494","48","2542","2023-01-02"
"61118","2022","COM","2020","116","5","121","2023-01-02"
"61120","2022","COM","2020","76","1","77","2023-01-02"
"61121","2022","COM","2020","297","9","306","2023-01-02"
"61122","2022","COM","2020","82","6","88","2023-01-02"
"61123","2022","COM","2020","219","5","224","2023-01-02"
"61124","2022","COM","2020","503","5","508","2023-01-02"
"61126","2022","COM","2020","489","10","499","2023-01-02"
"61129","2022","COM","2020","361","8","369","2023-01-02"
"61130","2022","COM","2020","461","11","472","2023-01-02"
"61133","2022","COM","2020","708","17","725","2023-01-02"
"61137","2022","COM","2020","131","4","135","2023-01-02"
"61138","2022","COM","2020","210","4","214","2023-01-02"
"61139","2022","COM","2020","301","11","312","2023-01-02"
"61140","2022","COM","2020","832","21","853","2023-01-02"
"61141","2022","COM","2020","419","14","433","2023-01-02"
"61142","2022","COM","2020","135","4","139","2023-01-02"
"61143","2022","COM","2020","2436","63","2499","2023-01-02"
"61145","2022","COM","2020","4180","117","4297","2023-01-02"
"61146","2022","COM","2020","394","5","399","2023-01-02"
"61148","2022","COM","2020","292","9","301","2023-01-02"
"61149","2022","COM","2020","371","12","383","2023-01-02"
"61150","2022","COM","2020","740","13","753","2023-01-02"
"61151","2022","COM","2020","395","11","406","2023-01-02"
"61152","2022","COM","2020","100","0","100","2023-01-02"
"61153","2022","COM","2020","2200","51","2251","2023-01-02"
"61156","2022","COM","2020","538","14","552","2023-01-02"
"61158","2022","COM","2020","143","3","146","2023-01-02"
"61159","2022","COM","2020","69","1","70","2023-01-02"
"61160","2022","COM","2020","184","4","188","2023-01-02"
"61162","2022","COM","2020","155","2","157","2023-01-02"
"61163","2022","COM","2020","1552","21","1573","2023-01-02"
"61164","2022","COM","2020","242","2","244","2023-01-02"
"61165","2022","COM","2020","733","19","752","2023-01-02"
"61166","2022","COM","2020","139","3","142","2023-01-02"
"61167","2022","COM","2020","3029","63","3092","2023-01-02"
"61168","2022","COM","2020","5138","351","5489","2023-01-02"
"61169","2022","COM","2020","14589","339","14928","2023-01-02"
"61170","2022","COM","2020","199","8","207","2023-01-02"
"61171","2022","COM","2020","107","2","109","2023-01-02"
"61176","2022","COM","2020","139","2","141","2023-01-02"
"61178","2022","COM","2020","53","1","54","2023-01-02"
"61180","2022","COM","2020","92","1","93","2023-01-02"
"61181","2022","COM","2020","1796","59","1855","2023-01-02"
"61182","2022","COM","2020","421","5","426","2023-01-02"
"61183","2022","COM","2020","145","2","147","2023-01-02"
"61187","2022","COM","2020","183","2","185","2023-01-02"
"61188","2022","COM","2020","90","5","95","2023-01-02"
"61189","2022","COM","2020","468","207","675","2023-01-02"
"61190","2022","COM","2020","73","1","74","2023-01-02"
"61192","2022","COM","2020","105","4","109","2023-01-02"
"61193","2022","COM","2020","278","3","281","2023-01-02"
"61194","2022","COM","2020","873","14","887","2023-01-02"
"61195","2022","COM","2020","197","1","198","2023-01-02"
"61196","2022","COM","2020","1508","51","1559","2023-01-02"
"61197","2022","COM","2020","133","4","137","2023-01-02"
"61198","2022","COM","2020","134","0","134","2023-01-02"
"61199","2022","COM","2020","331","8","339","2023-01-02"
"61202","2022","COM","2020","462","11","473","2023-01-02"
"61203","2022","COM","2020","897","25","922","2023-01-02"
"61206","2022","COM","2020","252","2","254","2023-01-02"
"61207","2022","COM","2020","597","22","619","2023-01-02"
"61208","2022","COM","2020","621","15","636","2023-01-02"
"61209","2022","COM","2020","409","8","417","2023-01-02"
"61210","2022","COM","2020","246","9","255","2023-01-02"
"61211","2022","COM","2020","2124","53","2177","2023-01-02"
"61212","2022","COM","2020","130","4","134","2023-01-02"
"61213","2022","COM","2020","270","10","280","2023-01-02"
"61214","2022","COM","2020","7903","241","8144","2023-01-02"
"61215","2022","COM","2020","353","6","359","2023-01-02"
"61216","2022","COM","2020","191","3","194","2023-01-02"
"61217","2022","COM","2020","54","1","55","2023-01-02"
"61218","2022","COM","2020","1784","49","1833","2023-01-02"
"61219","2022","COM","2020","159","1","160","2023-01-02"
"61221","2022","COM","2020","448","8","456","2023-01-02"
"61222","2022","COM","2020","765","19","784","2023-01-02"
"61224","2022","COM","2020","457","6","463","2023-01-02"
"61225","2022","COM","2020","29","0","29","2023-01-02"
"61227","2022","COM","2020","146","3","149","2023-01-02"
"61228","2022","COM","2020","773","16","789","2023-01-02"
"61229","2022","COM","2020","129","2","131","2023-01-02"
"61230","2022","COM","2020","2930","48","2978","2023-01-02"
"61232","2022","COM","2020","1117","39","1156","2023-01-02"
"61233","2022","COM","2020","231","5","236","2023-01-02"
"61234","2022","COM","2020","1127","36","1163","2023-01-02"
"61237","2022","COM","2020","316","0","316","2023-01-02"
"61238","2022","COM","2020","91","1","92","2023-01-02"
"61240","2022","COM","2020","393","10","403","2023-01-02"
"61241","2022","COM","2020","410","11","421","2023-01-02"
"61242","2022","COM","2020","219","8","227","2023-01-02"
"61243","2022","COM","2020","1377","40","1417","2023-01-02"
"61244","2022","COM","2020","269","12","281","2023-01-02"
"61248","2022","COM","2020","513","10","523","2023-01-02"
"61251","2022","COM","2020","154","6","160","2023-01-02"
"61252","2022","COM","2020","136","4","140","2023-01-02"
"61255","2022","COM","2020","529","14","543","2023-01-02"
"61256","2022","COM","2020","152","5","157","2023-01-02"
"61257","2022","COM","2020","121","0","121","2023-01-02"
"61258","2022","COM","2020","659","13","672","2023-01-02"
"61259","2022","COM","2020","71","0","71","2023-01-02"
"61260","2022","COM","2020","535","10","545","2023-01-02"
"61261","2022","COM","2020","170","3","173","2023-01-02"
"61262","2022","COM","2020","111","1","112","2023-01-02"
"61263","2022","COM","2020","202","6","208","2023-01-02"
"61264","2022","COM","2020","57","1","58","2023-01-02"
"61265","2022","COM","2020","162","3","165","2023-01-02"
"61266","2022","COM","2020","78","2","80","2023-01-02"
"61267","2022","COM","2020","203","3","206","2023-01-02"
"61268","2022","COM","2020","109","5","114","2023-01-02"
"61269","2022","COM","2020","482","8","490","2023-01-02"
"61271","2022","COM","2020","84","0","84","2023-01-02"
"61272","2022","COM","2020","23","0","23","2023-01-02"
"61273","2022","COM","2020","51","3","54","2023-01-02"
"61274","2022","COM","2020","239","5","244","2023-01-02"
"61275","2022","COM","2020","753","17","770","2023-01-02"
"61276","2022","COM","2020","153","6","159","2023-01-02"
"61277","2022","COM","2020","279","11","290","2023-01-02"
"61278","2022","COM","2020","1846","54","1900","2023-01-02"
"61279","2022","COM","2020","610","16","626","2023-01-02"
"61281","2022","COM","2020","259","5","264","2023-01-02"
"61283","2022","COM","2020","284","9","293","2023-01-02"
"61284","2022","COM","2020","221","2","223","2023-01-02"
"61286","2022","COM","2020","79","0","79","2023-01-02"
"61287","2022","COM","2020","724","18","742","2023-01-02"
"61288","2022","COM","2020","531","6","537","2023-01-02"
"61289","2022","COM","2020","49","1","50","2023-01-02"
"61290","2022","COM","2020","129","3","132","2023-01-02"
"61291","2022","COM","2020","69","2","71","2023-01-02"
"61292","2022","COM","2020","650","9","659","2023-01-02"
"61293","2022","COM","2020","3758","297","4055","2023-01-02"
"61294","2022","COM","2020","1144","23","1167","2023-01-02"
"61295","2022","COM","2020","163","2","165","2023-01-02"
"61297","2022","COM","2020","731","11","742","2023-01-02"
"61298","2022","COM","2020","316","11","327","2023-01-02"
"61300","2022","COM","2020","378","7","385","2023-01-02"
"61301","2022","COM","2020","212","1","213","2023-01-02"
"61302","2022","COM","2020","136","3","139","2023-01-02"
"61303","2022","COM","2020","519","13","532","2023-01-02"
"61304","2022","COM","2020","293","9","302","2023-01-02"
"61307","2022","COM","2020","230","2","232","2023-01-02"
"61308","2022","COM","2020","204","4","208","2023-01-02"
"61309","2022","COM","2020","2010","63","2073","2023-01-02"
"61310","2022","COM","2020","421","27","448","2023-01-02"
"61314","2022","COM","2020","676","17","693","2023-01-02"
"61316","2022","COM","2020","113","3","116","2023-01-02"
"61317","2022","COM","2020","182","5","187","2023-01-02"
"61319","2022","COM","2020","258","7","265","2023-01-02"
"61321","2022","COM","2020","419","7","426","2023-01-02"
"61322","2022","COM","2020","108","3","111","2023-01-02"
"61323","2022","COM","2020","125","2","127","2023-01-02"
"61324","2022","COM","2020","1163","16","1179","2023-01-02"
"61326","2022","COM","2020","349","5","354","2023-01-02"
"61327","2022","COM","2020","339","11","350","2023-01-02"
"61328","2022","COM","2020","266","5","271","2023-01-02"
"61329","2022","COM","2020","632","10","642","2023-01-02"
"61330","2022","COM","2020","183","3","186","2023-01-02"
"61331","2022","COM","2020","132","2","134","2023-01-02"
"61332","2022","COM","2020","311","29","340","2023-01-02"
"61333","2022","COM","2020","167","3","170","2023-01-02"
"61336","2022","COM","2020","102","7","109","2023-01-02"
"61339","2022","COM","2020","2140","32","2172","2023-01-02"
"61341","2022","COM","2020","1656","43","1699","2023-01-02"
"61342","2022","COM","2020","1416","21","1437","2023-01-02"
"61344","2022","COM","2020","1033","11","1044","2023-01-02"
"61345","2022","COM","2020","1898","42","1940","2023-01-02"
"61346","2022","COM","2020","204","6","210","2023-01-02"
"61347","2022","COM","2020","178","0","178","2023-01-02"
"61348","2022","COM","2020","370","7","377","2023-01-02"
"61349","2022","COM","2020","158","3","161","2023-01-02"
"61350","2022","COM","2020","161","8","169","2023-01-02"
"61351","2022","COM","2020","134","4","138","2023-01-02"
"61352","2022","COM","2020","177","5","182","2023-01-02"
"61357","2022","COM","2020","191","6","197","2023-01-02"
"61358","2022","COM","2020","226","5","231","2023-01-02"
"61360","2022","COM","2020","90","2","92","2023-01-02"
"61361","2022","COM","2020","170","5","175","2023-01-02"
"61362","2022","COM","2020","529","18","547","2023-01-02"
"61363","2022","COM","2020","57","1","58","2023-01-02"
"61365","2022","COM","2020","407","8","415","2023-01-02"
"61366","2022","COM","2020","132","2","134","2023-01-02"
"61367","2022","COM","2020","131","2","133","2023-01-02"
"61369","2022","COM","2020","1027","35","1062","2023-01-02"
"61370","2022","COM","2020","149","2","151","2023-01-02"
"61371","2022","COM","2020","134","2","136","2023-01-02"
"61372","2022","COM","2020","112","4","116","2023-01-02"
"61373","2022","COM","2020","246","8","254","2023-01-02"
"61374","2022","COM","2020","96","4","100","2023-01-02"
"61375","2022","COM","2020","1189","37","1226","2023-01-02"
"61376","2022","COM","2020","849","18","867","2023-01-02"
"61379","2022","COM","2020","234","5","239","2023-01-02"
"61381","2022","COM","2020","59","4","63","2023-01-02"
"61382","2022","COM","2020","1125","19","1144","2023-01-02"
"61384","2022","COM","2020","258","2","260","2023-01-02"
"61385","2022","COM","2020","336","9","345","2023-01-02"
"61386","2022","COM","2020","441","31","472","2023-01-02"
"61387","2022","COM","2020","537","18","555","2023-01-02"
"61388","2022","COM","2020","163","7","170","2023-01-02"
"61389","2022","COM","2020","1022","23","1045","2023-01-02"
"61390","2022","COM","2020","161","0","161","2023-01-02"
"61391","2022","COM","2020","3164","112","3276","2023-01-02"
"61392","2022","COM","2020","133","1","134","2023-01-02"
"61393","2022","COM","2020","134","5","139","2023-01-02"
"61394","2022","COM","2020","816","21","837","2023-01-02"
"61395","2022","COM","2020","227","4","231","2023-01-02"
"61396","2022","COM","2020","81","5","86","2023-01-02"
"61397","2022","COM","2020","3738","98","3836","2023-01-02"
"61398","2022","COM","2020","60","1","61","2023-01-02"
"61399","2022","COM","2020","73","3","76","2023-01-02"
"61400","2022","COM","2020","357","4","361","2023-01-02"
"61401","2022","COM","2020","104","4","108","2023-01-02"
"61402","2022","COM","2020","308","8","316","2023-01-02"
"61404","2022","COM","2020","654","12","666","2023-01-02"
"61405","2022","COM","2020","516","17","533","2023-01-02"
"61406","2022","COM","2020","307","4","311","2023-01-02"
"61407","2022","COM","2020","692","13","705","2023-01-02"
"61408","2022","COM","2020","336","7","343","2023-01-02"
"61411","2022","COM","2020","289","7","296","2023-01-02"
"61412","2022","COM","2020","694","14","708","2023-01-02"
"61413","2022","COM","2020","136","4","140","2023-01-02"
"61414","2022","COM","2020","878","23","901","2023-01-02"
"61415","2022","COM","2020","314","6","320","2023-01-02"
"61416","2022","COM","2020","77","1","78","2023-01-02"
"61418","2022","COM","2020","413","12","425","2023-01-02"
"61419","2022","COM","2020","212","5","217","2023-01-02"
"61420","2022","COM","2020","89","1","90","2023-01-02"
"61421","2022","COM","2020","653","18","671","2023-01-02"
"61422","2022","COM","2020","611","15","626","2023-01-02"
"61423","2022","COM","2020","637","26","663","2023-01-02"
"61424","2022","COM","2020","190","4","194","2023-01-02"
"61425","2022","COM","2020","137","3","140","2023-01-02"
"61426","2022","COM","2020","553","16","569","2023-01-02"
"61427","2022","COM","2020","192","3","195","2023-01-02"
"61429","2022","COM","2020","773","15","788","2023-01-02"
"61432","2022","COM","2020","589","21","610","2023-01-02"
"61433","2022","COM","2020","285","8","293","2023-01-02"
"61435","2022","COM","2020","272","5","277","2023-01-02"
"61436","2022","COM","2020","237","2","239","2023-01-02"
"61438","2022","COM","2020","172","5","177","2023-01-02"
"61439","2022","COM","2020","119","4","123","2023-01-02"
"61440","2022","COM","2020","830","35","865","2023-01-02"
"61442","2022","COM","2020","227","6","233","2023-01-02"
"61443","2022","COM","2020","694","15","709","2023-01-02"
"61444","2022","COM","2020","117","0","117","2023-01-02"
"61445","2022","COM","2020","660","9","669","2023-01-02"
"61446","2022","COM","2020","157","6","163","2023-01-02"
"61447","2022","COM","2020","1381","32","1413","2023-01-02"
"61448","2022","COM","2020","431","6","437","2023-01-02"
"61450","2022","COM","2020","72","1","73","2023-01-02"
"61451","2022","COM","2020","313","6","319","2023-01-02"
"61452","2022","COM","2020","166","4","170","2023-01-02"
"61453","2022","COM","2020","244","7","251","2023-01-02"
"61454","2022","COM","2020","586","15","601","2023-01-02"
"61456","2022","COM","2020","1642","37","1679","2023-01-02"
"61457","2022","COM","2020","476","8","484","2023-01-02"
"61459","2022","COM","2020","304","7","311","2023-01-02"
"61460","2022","COM","2020","960","10","970","2023-01-02"
"61461","2022","COM","2020","127","3","130","2023-01-02"
"61462","2022","COM","2020","1042","34","1076","2023-01-02"
"61463","2022","COM","2020","1737","32","1769","2023-01-02"
"61464","2022","COM","2020","4199","435","4634","2023-01-02"
"61466","2022","COM","2020","1451","31","1482","2023-01-02"
"61467","2022","COM","2020","333","10","343","2023-01-02"
"61472","2022","COM","2020","304","12","316","2023-01-02"
"61473","2022","COM","2020","272","5","277","2023-01-02"
"61474","2022","COM","2020","3687","81","3768","2023-01-02"
"61475","2022","COM","2020","667","15","682","2023-01-02"
"61476","2022","COM","2020","274","5","279","2023-01-02"
"61479","2022","COM","2020","157","4","161","2023-01-02"
"61480","2022","COM","2020","231","5","236","2023-01-02"
"61481","2022","COM","2020","77","3","80","2023-01-02"
"61482","2022","COM","2020","380","9","389","2023-01-02"
"61483","2022","COM","2020","2720","47","2767","2023-01-02"
"61484","2022","COM","2020","3410","72","3482","2023-01-02"
"61485","2022","COM","2020","193","7","200","2023-01-02"
"61486","2022","COM","2020","4896","86","4982","2023-01-02"
"61487","2022","COM","2020","301","4","305","2023-01-02"
"61488","2022","COM","2020","85","2","87","2023-01-02"
"61490","2022","COM","2020","300","4","304","2023-01-02"
"61491","2022","COM","2020","3069","48","3117","2023-01-02"
"61492","2022","COM","2020","119","3","122","2023-01-02"
"61493","2022","COM","2020","57","5","62","2023-01-02"
"61494","2022","COM","2020","1223","67","1290","2023-01-02"
"61497","2022","COM","2020","1760","31","1791","2023-01-02"
"61498","2022","COM","2020","99","4","103","2023-01-02"
"61499","2022","COM","2020","145","3","148","2023-01-02"
"61500","2022","COM","2020","125","4","129","2023-01-02"
"61501","2022","COM","2020","421","5","426","2023-01-02"
"61502","2022","COM","2020","90","2","92","2023-01-02"
"61503","2022","COM","2020","198","4","202","2023-01-02"
"61505","2022","COM","2020","215","6","221","2023-01-02"
"61507","2022","COM","2020","268","6","274","2023-01-02"
"61508","2022","COM","2020","3096","88","3184","2023-01-02"
"61510","2022","COM","2020","225","6","231","2023-01-02"
"61512","2022","COM","2020","104","2","106","2023-01-02"
"62001","2022","COM","2020","1929","39","1968","2023-01-02"
"62002","2022","COM","2020","231","3","234","2023-01-02"
"62003","2022","COM","2020","599","22","621","2023-01-02"
"62004","2022","COM","2020","7981","110","8091","2023-01-02"
"62005","2022","COM","2020","969","5","974","2023-01-02"
"62006","2022","COM","2020","312","5","317","2023-01-02"
"62007","2022","COM","2020","805","5","810","2023-01-02"
"62008","2022","COM","2020","796","11","807","2023-01-02"
"62009","2022","COM","2020","282","7","289","2023-01-02"
"62010","2022","COM","2020","256","0","256","2023-01-02"
"62011","2022","COM","2020","662","16","678","2023-01-02"
"62012","2022","COM","2020","255","4","259","2023-01-02"
"62013","2022","COM","2020","1891","35","1926","2023-01-02"
"62014","2022","COM","2020","9610","259","9869","2023-01-02"
"62015","2022","COM","2020","245","5","250","2023-01-02"
"62016","2022","COM","2020","189","5","194","2023-01-02"
"62017","2022","COM","2020","202","1","203","2023-01-02"
"62018","2022","COM","2020","273","5","278","2023-01-02"
"62019","2022","COM","2020","3917","41","3958","2023-01-02"
"62020","2022","COM","2020","622","11","633","2023-01-02"
"62021","2022","COM","2020","385","1","386","2023-01-02"
"62022","2022","COM","2020","306","10","316","2023-01-02"
"62023","2022","COM","2020","2871","31","2902","2023-01-02"
"62024","2022","COM","2020","994","13","1007","2023-01-02"
"62025","2022","COM","2020","1998","33","2031","2023-01-02"
"62026","2022","COM","2020","120","9","129","2023-01-02"
"62027","2022","COM","2020","217","0","217","2023-01-02"
"62028","2022","COM","2020","627","8","635","2023-01-02"
"62029","2022","COM","2020","461","1","462","2023-01-02"
"62030","2022","COM","2020","301","4","305","2023-01-02"
"62031","2022","COM","2020","1552","23","1575","2023-01-02"
"62032","2022","COM","2020","4777","57","4834","2023-01-02"
"62033","2022","COM","2020","4477","25","4502","2023-01-02"
"62034","2022","COM","2020","2143","13","2156","2023-01-02"
"62035","2022","COM","2020","5807","50","5857","2023-01-02"
"62036","2022","COM","2020","736","14","750","2023-01-02"
"62037","2022","COM","2020","2778","72","2850","2023-01-02"
"62038","2022","COM","2020","4404","49","4453","2023-01-02"
"62039","2022","COM","2020","886","21","907","2023-01-02"
"62040","2022","COM","2020","9521","120","9641","2023-01-02"
"62041","2022","COM","2020","42337","796","43133","2023-01-02"
"62042","2022","COM","2020","1058","12","1070","2023-01-02"
"62043","2022","COM","2020","2040","20","2060","2023-01-02"
"62044","2022","COM","2020","811","7","818","2023-01-02"
"62045","2022","COM","2020","1479","17","1496","2023-01-02"
"62046","2022","COM","2020","734","6","740","2023-01-02"
"62047","2022","COM","2020","148","1","149","2023-01-02"
"62048","2022","COM","2020","10221","42","10263","2023-01-02"
"62049","2022","COM","2020","534","1","535","2023-01-02"
"62050","2022","COM","2020","1544","15","1559","2023-01-02"
"62051","2022","COM","2020","4656","30","4686","2023-01-02"
"62052","2022","COM","2020","458","13","471","2023-01-02"
"62053","2022","COM","2020","662","5","667","2023-01-02"
"62054","2022","COM","2020","594","8","602","2023-01-02"
"62055","2022","COM","2020","522","9","531","2023-01-02"
"62056","2022","COM","2020","628","5","633","2023-01-02"
"62057","2022","COM","2020","5428","52","5480","2023-01-02"
"62058","2022","COM","2020","201","5","206","2023-01-02"
"62059","2022","COM","2020","288","14","302","2023-01-02"
"62060","2022","COM","2020","2563","25","2588","2023-01-02"
"62061","2022","COM","2020","293","7","300","2023-01-02"
"62062","2022","COM","2020","55","1","56","2023-01-02"
"62063","2022","COM","2020","1820","29","1849","2023-01-02"
"62064","2022","COM","2020","167","2","169","2023-01-02"
"62065","2022","COM","2020","17676","136","17812","2023-01-02"
"62066","2022","COM","2020","34","2","36","2023-01-02"
"62067","2022","COM","2020","593","7","600","2023-01-02"
"62068","2022","COM","2020","324","7","331","2023-01-02"
"62069","2022","COM","2020","311","8","319","2023-01-02"
"62070","2022","COM","2020","263","5","268","2023-01-02"
"62071","2022","COM","2020","406","7","413","2023-01-02"
"62072","2022","COM","2020","220","2","222","2023-01-02"
"62073","2022","COM","2020","1428","25","1453","2023-01-02"
"62074","2022","COM","2020","232","8","240","2023-01-02"
"62075","2022","COM","2020","1296","29","1325","2023-01-02"
"62076","2022","COM","2020","217","1","218","2023-01-02"
"62077","2022","COM","2020","363","6","369","2023-01-02"
"62078","2022","COM","2020","1225","23","1248","2023-01-02"
"62079","2022","COM","2020","86","1","87","2023-01-02"
"62080","2022","COM","2020","3749","319","4068","2023-01-02"
"62081","2022","COM","2020","463","10","473","2023-01-02"
"62082","2022","COM","2020","319","4","323","2023-01-02"
"62083","2022","COM","2020","7456","45","7501","2023-01-02"
"62084","2022","COM","2020","207","7","214","2023-01-02"
"62085","2022","COM","2020","134","5","139","2023-01-02"
"62086","2022","COM","2020","396","6","402","2023-01-02"
"62087","2022","COM","2020","1010","23","1033","2023-01-02"
"62088","2022","COM","2020","328","6","334","2023-01-02"
"62089","2022","COM","2020","398","9","407","2023-01-02"
"62090","2022","COM","2020","128","4","132","2023-01-02"
"62091","2022","COM","2020","90","2","92","2023-01-02"
"62092","2022","COM","2020","406","3","409","2023-01-02"
"62093","2022","COM","2020","226","0","226","2023-01-02"
"62094","2022","COM","2020","401","9","410","2023-01-02"
"62095","2022","COM","2020","241","1","242","2023-01-02"
"62096","2022","COM","2020","559","9","568","2023-01-02"
"62097","2022","COM","2020","999","14","1013","2023-01-02"
"62099","2022","COM","2020","5509","62","5571","2023-01-02"
"62100","2022","COM","2020","2071","28","2099","2023-01-02"
"62101","2022","COM","2020","136","1","137","2023-01-02"
"62102","2022","COM","2020","275","3","278","2023-01-02"
"62103","2022","COM","2020","134","2","136","2023-01-02"
"62104","2022","COM","2020","437","7","444","2023-01-02"
"62105","2022","COM","2020","565","16","581","2023-01-02"
"62106","2022","COM","2020","206","2","208","2023-01-02"
"62107","2022","COM","2020","350","8","358","2023-01-02"
"62108","2022","COM","2020","13442","336","13778","2023-01-02"
"62109","2022","COM","2020","218","1","219","2023-01-02"
"62111","2022","COM","2020","280","79","359","2023-01-02"
"62112","2022","COM","2020","520","8","528","2023-01-02"
"62113","2022","COM","2020","496","12","508","2023-01-02"
"62114","2022","COM","2020","172","4","176","2023-01-02"
"62115","2022","COM","2020","466","18","484","2023-01-02"
"62116","2022","COM","2020","178","2","180","2023-01-02"
"62117","2022","COM","2020","913","14","927","2023-01-02"
"62118","2022","COM","2020","143","4","147","2023-01-02"
"62119","2022","COM","2020","24983","331","25314","2023-01-02"
"62120","2022","COM","2020","466","8","474","2023-01-02"
"62121","2022","COM","2020","174","4","178","2023-01-02"
"62122","2022","COM","2020","358","4","362","2023-01-02"
"62123","2022","COM","2020","537","4","541","2023-01-02"
"62124","2022","COM","2020","446","5","451","2023-01-02"
"62125","2022","COM","2020","460","11","471","2023-01-02"
"62126","2022","COM","2020","9164","159","9323","2023-01-02"
"62127","2022","COM","2020","383","12","395","2023-01-02"
"62128","2022","COM","2020","4413","46","4459","2023-01-02"
"62129","2022","COM","2020","96","2","98","2023-01-02"
"62130","2022","COM","2020","654","14","668","2023-01-02"
"62131","2022","COM","2020","338","3","341","2023-01-02"
"62132","2022","COM","2020","5034","41","5075","2023-01-02"
"62133","2022","COM","2020","8185","37","8222","2023-01-02"
"62134","2022","COM","2020","109","2","111","2023-01-02"
"62135","2022","COM","2020","307","2","309","2023-01-02"
"62137","2022","COM","2020","94","0","94","2023-01-02"
"62138","2022","COM","2020","704","13","717","2023-01-02"
"62139","2022","COM","2020","4926","174","5100","2023-01-02"
"62140","2022","COM","2020","492","5","497","2023-01-02"
"62141","2022","COM","2020","903","12","915","2023-01-02"
"62142","2022","COM","2020","157","7","164","2023-01-02"
"62143","2022","COM","2020","48","1","49","2023-01-02"
"62144","2022","COM","2020","469","7","476","2023-01-02"
"62145","2022","COM","2020","439","6","445","2023-01-02"
"62146","2022","COM","2020","268","2","270","2023-01-02"
"62147","2022","COM","2020","402","4","406","2023-01-02"
"62148","2022","COM","2020","821","8","829","2023-01-02"
"62149","2022","COM","2020","244","8","252","2023-01-02"
"62150","2022","COM","2020","502","7","509","2023-01-02"
"62151","2022","COM","2020","510","10","520","2023-01-02"
"62152","2022","COM","2020","248","2","250","2023-01-02"
"62153","2022","COM","2020","653","9","662","2023-01-02"
"62154","2022","COM","2020","682","14","696","2023-01-02"
"62155","2022","COM","2020","635","14","649","2023-01-02"
"62156","2022","COM","2020","572","20","592","2023-01-02"
"62157","2022","COM","2020","75","2","77","2023-01-02"
"62158","2022","COM","2020","580","12","592","2023-01-02"
"62160","2022","COM","2020","40588","397","40985","2023-01-02"
"62161","2022","COM","2020","787","5","792","2023-01-02"
"62162","2022","COM","2020","589","6","595","2023-01-02"
"62163","2022","COM","2020","249","3","252","2023-01-02"
"62164","2022","COM","2020","1133","19","1152","2023-01-02"
"62165","2022","COM","2020","231","5","236","2023-01-02"
"62166","2022","COM","2020","612","10","622","2023-01-02"
"62167","2022","COM","2020","254","4","258","2023-01-02"
"62168","2022","COM","2020","841","12","853","2023-01-02"
"62169","2022","COM","2020","246","6","252","2023-01-02"
"62170","2022","COM","2020","2376","95","2471","2023-01-02"
"62171","2022","COM","2020","130","2","132","2023-01-02"
"62172","2022","COM","2020","362","4","366","2023-01-02"
"62173","2022","COM","2020","5128","73","5201","2023-01-02"
"62174","2022","COM","2020","1294","12","1306","2023-01-02"
"62175","2022","COM","2020","158","4","162","2023-01-02"
"62176","2022","COM","2020","642","18","660","2023-01-02"
"62177","2022","COM","2020","861","17","878","2023-01-02"
"62178","2022","COM","2020","21953","353","22306","2023-01-02"
"62179","2022","COM","2020","408","7","415","2023-01-02"
"62180","2022","COM","2020","293","5","298","2023-01-02"
"62181","2022","COM","2020","1454","108","1562","2023-01-02"
"62182","2022","COM","2020","239","7","246","2023-01-02"
"62183","2022","COM","2020","759","3","762","2023-01-02"
"62184","2022","COM","2020","294","3","297","2023-01-02"
"62185","2022","COM","2020","227","2","229","2023-01-02"
"62186","2022","COM","2020","12080","72","12152","2023-01-02"
"62187","2022","COM","2020","182","2","184","2023-01-02"
"62188","2022","COM","2020","2812","28","2840","2023-01-02"
"62189","2022","COM","2020","132","2","134","2023-01-02"
"62190","2022","COM","2020","1244","17","1261","2023-01-02"
"62191","2022","COM","2020","728","3","731","2023-01-02"
"62192","2022","COM","2020","426","11","437","2023-01-02"
"62193","2022","COM","2020","67544","649","68193","2023-01-02"
"62194","2022","COM","2020","5511","28","5539","2023-01-02"
"62195","2022","COM","2020","1543","20","1563","2023-01-02"
"62196","2022","COM","2020","599","11","610","2023-01-02"
"62197","2022","COM","2020","1774","17","1791","2023-01-02"
"62198","2022","COM","2020","338","10","348","2023-01-02"
"62199","2022","COM","2020","671","122","793","2023-01-02"
"62200","2022","COM","2020","1221","13","1234","2023-01-02"
"62201","2022","COM","2020","2707","39","2746","2023-01-02"
"62202","2022","COM","2020","676","98","774","2023-01-02"
"62203","2022","COM","2020","437","6","443","2023-01-02"
"62204","2022","COM","2020","1945","30","1975","2023-01-02"
"62205","2022","COM","2020","1288","27","1315","2023-01-02"
"62206","2022","COM","2020","284","15","299","2023-01-02"
"62207","2022","COM","2020","544","14","558","2023-01-02"
"62208","2022","COM","2020","71","2","73","2023-01-02"
"62209","2022","COM","2020","152","10","162","2023-01-02"
"62211","2022","COM","2020","217","4","221","2023-01-02"
"62212","2022","COM","2020","507","11","518","2023-01-02"
"62213","2022","COM","2020","796","11","807","2023-01-02"
"62214","2022","COM","2020","607","11","618","2023-01-02"
"62215","2022","COM","2020","17667","94","17761","2023-01-02"
"62216","2022","COM","2020","208","2","210","2023-01-02"
"62217","2022","COM","2020","2723","14","2737","2023-01-02"
"62218","2022","COM","2020","334","8","342","2023-01-02"
"62219","2022","COM","2020","158","4","162","2023-01-02"
"62220","2022","COM","2020","445","5","450","2023-01-02"
"62221","2022","COM","2020","245","5","250","2023-01-02"
"62222","2022","COM","2020","159","1","160","2023-01-02"
"62223","2022","COM","2020","290","5","295","2023-01-02"
"62224","2022","COM","2020","2821","27","2848","2023-01-02"
"62225","2022","COM","2020","600","11","611","2023-01-02"
"62227","2022","COM","2020","185","2","187","2023-01-02"
"62228","2022","COM","2020","320","4","324","2023-01-02"
"62229","2022","COM","2020","804","16","820","2023-01-02"
"62230","2022","COM","2020","950","15","965","2023-01-02"
"62231","2022","COM","2020","128","0","128","2023-01-02"
"62232","2022","COM","2020","892","15","907","2023-01-02"
"62233","2022","COM","2020","1113","14","1127","2023-01-02"
"62234","2022","COM","2020","221","4","225","2023-01-02"
"62235","2022","COM","2020","2482","89","2571","2023-01-02"
"62236","2022","COM","2020","343","8","351","2023-01-02"
"62237","2022","COM","2020","518","10","528","2023-01-02"
"62238","2022","COM","2020","81","1","82","2023-01-02"
"62239","2022","COM","2020","2601","34","2635","2023-01-02"
"62240","2022","COM","2020","2272","15","2287","2023-01-02"
"62241","2022","COM","2020","312","5","317","2023-01-02"
"62242","2022","COM","2020","88","5","93","2023-01-02"
"62243","2022","COM","2020","125","3","128","2023-01-02"
"62244","2022","COM","2020","5451","207","5658","2023-01-02"
"62245","2022","COM","2020","763","7","770","2023-01-02"
"62246","2022","COM","2020","150","0","150","2023-01-02"
"62247","2022","COM","2020","602","11","613","2023-01-02"
"62248","2022","COM","2020","473","6","479","2023-01-02"
"62249","2022","COM","2020","8166","38","8204","2023-01-02"
"62250","2022","COM","2020","10360","95","10455","2023-01-02"
"62251","2022","COM","2020","512","191","703","2023-01-02"
"62252","2022","COM","2020","2643","70","2713","2023-01-02"
"62253","2022","COM","2020","74","0","74","2023-01-02"
"62254","2022","COM","2020","602","13","615","2023-01-02"
"62255","2022","COM","2020","796","15","811","2023-01-02"
"62256","2022","COM","2020","153","2","155","2023-01-02"
"62257","2022","COM","2020","463","10","473","2023-01-02"
"62258","2022","COM","2020","265","5","270","2023-01-02"
"62259","2022","COM","2020","1961","24","1985","2023-01-02"
"62260","2022","COM","2020","330","3","333","2023-01-02"
"62261","2022","COM","2020","5094","84","5178","2023-01-02"
"62262","2022","COM","2020","1751","22","1773","2023-01-02"
"62263","2022","COM","2020","5689","102","5791","2023-01-02"
"62264","2022","COM","2020","1332","4","1336","2023-01-02"
"62265","2022","COM","2020","1192","16","1208","2023-01-02"
"62266","2022","COM","2020","90","2","92","2023-01-02"
"62267","2022","COM","2020","400","6","406","2023-01-02"
"62268","2022","COM","2020","4861","37","4898","2023-01-02"
"62269","2022","COM","2020","725","11","736","2023-01-02"
"62270","2022","COM","2020","6957","37","6994","2023-01-02"
"62271","2022","COM","2020","834","18","852","2023-01-02"
"62272","2022","COM","2020","314","2","316","2023-01-02"
"62273","2022","COM","2020","630","9","639","2023-01-02"
"62274","2022","COM","2020","5927","40","5967","2023-01-02"
"62275","2022","COM","2020","300","7","307","2023-01-02"
"62276","2022","COM","2020","5733","48","5781","2023-01-02"
"62277","2022","COM","2020","2935","16","2951","2023-01-02"
"62278","2022","COM","2020","610","20","630","2023-01-02"
"62279","2022","COM","2020","1374","66","1440","2023-01-02"
"62280","2022","COM","2020","318","2","320","2023-01-02"
"62281","2022","COM","2020","384","9","393","2023-01-02"
"62282","2022","COM","2020","181","0","181","2023-01-02"
"62283","2022","COM","2020","131","0","131","2023-01-02"
"62284","2022","COM","2020","1686","19","1705","2023-01-02"
"62285","2022","COM","2020","490","10","500","2023-01-02"
"62286","2022","COM","2020","506","4","510","2023-01-02"
"62288","2022","COM","2020","2178","44","2222","2023-01-02"
"62289","2022","COM","2020","694","21","715","2023-01-02"
"62290","2022","COM","2020","380","7","387","2023-01-02"
"62291","2022","COM","2020","2844","31","2875","2023-01-02"
"62292","2022","COM","2020","868","14","882","2023-01-02"
"62293","2022","COM","2020","231","5","236","2023-01-02"
"62295","2022","COM","2020","1613","26","1639","2023-01-02"
"62296","2022","COM","2020","268","9","277","2023-01-02"
"62297","2022","COM","2020","3745","45","3790","2023-01-02"
"62298","2022","COM","2020","549","13","562","2023-01-02"
"62299","2022","COM","2020","246","6","252","2023-01-02"
"62300","2022","COM","2020","2624","28","2652","2023-01-02"
"62301","2022","COM","2020","81","1","82","2023-01-02"
"62302","2022","COM","2020","236","2","238","2023-01-02"
"62303","2022","COM","2020","237","3","240","2023-01-02"
"62304","2022","COM","2020","335","2","337","2023-01-02"
"62306","2022","COM","2020","391","3","394","2023-01-02"
"62307","2022","COM","2020","219","9","228","2023-01-02"
"62308","2022","COM","2020","476","10","486","2023-01-02"
"62309","2022","COM","2020","1631","21","1652","2023-01-02"
"62310","2022","COM","2020","1758","19","1777","2023-01-02"
"62311","2022","COM","2020","2031","8","2039","2023-01-02"
"62312","2022","COM","2020","290","6","296","2023-01-02"
"62313","2022","COM","2020","915","6","921","2023-01-02"
"62314","2022","COM","2020","357","2","359","2023-01-02"
"62315","2022","COM","2020","346","9","355","2023-01-02"
"62316","2022","COM","2020","208","6","214","2023-01-02"
"62317","2022","COM","2020","455","3","458","2023-01-02"
"62318","2022","COM","2020","10813","115","10928","2023-01-02"
"62319","2022","COM","2020","258","3","261","2023-01-02"
"62320","2022","COM","2020","316","5","321","2023-01-02"
"62321","2022","COM","2020","4662","26","4688","2023-01-02"
"62322","2022","COM","2020","111","1","112","2023-01-02"
"62323","2022","COM","2020","1209","19","1228","2023-01-02"
"62324","2022","COM","2020","604","11","615","2023-01-02"
"62325","2022","COM","2020","949","17","966","2023-01-02"
"62326","2022","COM","2020","245","5","250","2023-01-02"
"62327","2022","COM","2020","614","4","618","2023-01-02"
"62328","2022","COM","2020","895","7","902","2023-01-02"
"62329","2022","COM","2020","1751","20","1771","2023-01-02"
"62330","2022","COM","2020","1268","24","1292","2023-01-02"
"62331","2022","COM","2020","1027","20","1047","2023-01-02"
"62332","2022","COM","2020","501","10","511","2023-01-02"
"62333","2022","COM","2020","390","6","396","2023-01-02"
"62334","2022","COM","2020","856","16","872","2023-01-02"
"62335","2022","COM","2020","514","5","519","2023-01-02"
"62336","2022","COM","2020","480","7","487","2023-01-02"
"62337","2022","COM","2020","222","5","227","2023-01-02"
"62338","2022","COM","2020","2779","51","2830","2023-01-02"
"62339","2022","COM","2020","109","1","110","2023-01-02"
"62340","2022","COM","2020","883","7","890","2023-01-02"
"62341","2022","COM","2020","412","8","420","2023-01-02"
"62342","2022","COM","2020","106","1","107","2023-01-02"
"62343","2022","COM","2020","262","2","264","2023-01-02"
"62344","2022","COM","2020","111","3","114","2023-01-02"
"62345","2022","COM","2020","97","1","98","2023-01-02"
"62346","2022","COM","2020","216","4","220","2023-01-02"
"62347","2022","COM","2020","128","3","131","2023-01-02"
"62348","2022","COM","2020","159","2","161","2023-01-02"
"62349","2022","COM","2020","1629","23","1652","2023-01-02"
"62350","2022","COM","2020","1124","20","1144","2023-01-02"
"62351","2022","COM","2020","6333","35","6368","2023-01-02"
"62352","2022","COM","2020","109","3","112","2023-01-02"
"62353","2022","COM","2020","237","3","240","2023-01-02"
"62354","2022","COM","2020","896","18","914","2023-01-02"
"62355","2022","COM","2020","590","5","595","2023-01-02"
"62356","2022","COM","2020","801","8","809","2023-01-02"
"62357","2022","COM","2020","71","1","72","2023-01-02"
"62358","2022","COM","2020","235","6","241","2023-01-02"
"62359","2022","COM","2020","583","12","595","2023-01-02"
"62360","2022","COM","2020","1390","14","1404","2023-01-02"
"62361","2022","COM","2020","3348","47","3395","2023-01-02"
"62362","2022","COM","2020","240","3","243","2023-01-02"
"62363","2022","COM","2020","380","9","389","2023-01-02"
"62364","2022","COM","2020","2338","242","2580","2023-01-02"
"62365","2022","COM","2020","201","0","201","2023-01-02"
"62366","2022","COM","2020","308","7","315","2023-01-02"
"62367","2022","COM","2020","811","18","829","2023-01-02"
"62368","2022","COM","2020","210","0","210","2023-01-02"
"62369","2022","COM","2020","817","17","834","2023-01-02"
"62370","2022","COM","2020","124","1","125","2023-01-02"
"62371","2022","COM","2020","2003","45","2048","2023-01-02"
"62372","2022","COM","2020","150","3","153","2023-01-02"
"62373","2022","COM","2020","1023","11","1034","2023-01-02"
"62374","2022","COM","2020","153","1","154","2023-01-02"
"62375","2022","COM","2020","89","1","90","2023-01-02"
"62376","2022","COM","2020","2512","38","2550","2023-01-02"
"62377","2022","COM","2020","949","7","956","2023-01-02"
"62378","2022","COM","2020","200","4","204","2023-01-02"
"62379","2022","COM","2020","325","8","333","2023-01-02"
"62380","2022","COM","2020","350","1","351","2023-01-02"
"62381","2022","COM","2020","132","1","133","2023-01-02"
"62382","2022","COM","2020","652","13","665","2023-01-02"
"62383","2022","COM","2020","1392","18","1410","2023-01-02"
"62384","2022","COM","2020","649","8","657","2023-01-02"
"62385","2022","COM","2020","381","4","385","2023-01-02"
"62386","2022","COM","2020","6748","30","6778","2023-01-02"
"62387","2022","COM","2020","358","10","368","2023-01-02"
"62388","2022","COM","2020","295","3","298","2023-01-02"
"62389","2022","COM","2020","29","2","31","2023-01-02"
"62390","2022","COM","2020","1514","37","1551","2023-01-02"
"62391","2022","COM","2020","1388","13","1401","2023-01-02"
"62392","2022","COM","2020","378","9","387","2023-01-02"
"62393","2022","COM","2020","1112","22","1134","2023-01-02"
"62395","2022","COM","2020","130","4","134","2023-01-02"
"62396","2022","COM","2020","15","1","16","2023-01-02"
"62397","2022","COM","2020","5581","73","5654","2023-01-02"
"62398","2022","COM","2020","270","12","282","2023-01-02"
"62399","2022","COM","2020","658","14","672","2023-01-02"
"62400","2022","COM","2020","4864","36","4900","2023-01-02"
"62401","2022","COM","2020","4416","30","4446","2023-01-02"
"62402","2022","COM","2020","310","6","316","2023-01-02"
"62403","2022","COM","2020","1211","15","1226","2023-01-02"
"62404","2022","COM","2020","202","2","204","2023-01-02"
"62405","2022","COM","2020","470","10","480","2023-01-02"
"62406","2022","COM","2020","267","8","275","2023-01-02"
"62407","2022","COM","2020","947","13","960","2023-01-02"
"62408","2022","COM","2020","1457","18","1475","2023-01-02"
"62409","2022","COM","2020","196","3","199","2023-01-02"
"62410","2022","COM","2020","185","3","188","2023-01-02"
"62411","2022","COM","2020","54","0","54","2023-01-02"
"62412","2022","COM","2020","1217","6","1223","2023-01-02"
"62413","2022","COM","2020","12277","92","12369","2023-01-02"
"62414","2022","COM","2020","213","2","215","2023-01-02"
"62415","2022","COM","2020","437","9","446","2023-01-02"
"62416","2022","COM","2020","216","2","218","2023-01-02"
"62418","2022","COM","2020","308","8","316","2023-01-02"
"62419","2022","COM","2020","176","1","177","2023-01-02"
"62421","2022","COM","2020","389","5","394","2023-01-02"
"62422","2022","COM","2020","521","5","526","2023-01-02"
"62423","2022","COM","2020","1737","29","1766","2023-01-02"
"62424","2022","COM","2020","316","11","327","2023-01-02"
"62425","2022","COM","2020","139","4","143","2023-01-02"
"62426","2022","COM","2020","186","2","188","2023-01-02"
"62427","2022","COM","2020","25886","372","26258","2023-01-02"
"62428","2022","COM","2020","527","7","534","2023-01-02"
"62429","2022","COM","2020","280","4","284","2023-01-02"
"62430","2022","COM","2020","161","1","162","2023-01-02"
"62432","2022","COM","2020","405","8","413","2023-01-02"
"62433","2022","COM","2020","83","6","89","2023-01-02"
"62434","2022","COM","2020","139","2","141","2023-01-02"
"62435","2022","COM","2020","107","0","107","2023-01-02"
"62436","2022","COM","2020","161","3","164","2023-01-02"
"62437","2022","COM","2020","308","7","315","2023-01-02"
"62438","2022","COM","2020","536","8","544","2023-01-02"
"62439","2022","COM","2020","418","7","425","2023-01-02"
"62440","2022","COM","2020","1159","25","1184","2023-01-02"
"62441","2022","COM","2020","209","2","211","2023-01-02"
"62442","2022","COM","2020","548","11","559","2023-01-02"
"62443","2022","COM","2020","6196","43","6239","2023-01-02"
"62444","2022","COM","2020","225","6","231","2023-01-02"
"62445","2022","COM","2020","827","17","844","2023-01-02"
"62446","2022","COM","2020","805","23","828","2023-01-02"
"62447","2022","COM","2020","2218","11","2229","2023-01-02"
"62448","2022","COM","2020","1891","29","1920","2023-01-02"
"62449","2022","COM","2020","159","6","165","2023-01-02"
"62450","2022","COM","2020","225","6","231","2023-01-02"
"62451","2022","COM","2020","492","10","502","2023-01-02"
"62452","2022","COM","2020","1371","36","1407","2023-01-02"
"62453","2022","COM","2020","128","3","131","2023-01-02"
"62454","2022","COM","2020","2413","50","2463","2023-01-02"
"62455","2022","COM","2020","111","1","112","2023-01-02"
"62456","2022","COM","2020","718","7","725","2023-01-02"
"62457","2022","COM","2020","7066","59","7125","2023-01-02"
"62458","2022","COM","2020","1163","12","1175","2023-01-02"
"62459","2022","COM","2020","238","3","241","2023-01-02"
"62460","2022","COM","2020","270","5","275","2023-01-02"
"62461","2022","COM","2020","869","7","876","2023-01-02"
"62462","2022","COM","2020","154","5","159","2023-01-02"
"62463","2022","COM","2020","454","50","504","2023-01-02"
"62464","2022","COM","2020","3380","19","3399","2023-01-02"
"62465","2022","COM","2020","218","0","218","2023-01-02"
"62466","2022","COM","2020","238","1","239","2023-01-02"
"62467","2022","COM","2020","180","1","181","2023-01-02"
"62468","2022","COM","2020","214","1","215","2023-01-02"
"62469","2022","COM","2020","578","7","585","2023-01-02"
"62470","2022","COM","2020","86","0","86","2023-01-02"
"62471","2022","COM","2020","1084","21","1105","2023-01-02"
"62472","2022","COM","2020","160","6","166","2023-01-02"
"62473","2022","COM","2020","8683","77","8760","2023-01-02"
"62474","2022","COM","2020","1154","21","1175","2023-01-02"
"62475","2022","COM","2020","243","3","246","2023-01-02"
"62476","2022","COM","2020","1056","11","1067","2023-01-02"
"62477","2022","COM","2020","730","17","747","2023-01-02"
"62478","2022","COM","2020","288","3","291","2023-01-02"
"62479","2022","COM","2020","1662","14","1676","2023-01-02"
"62480","2022","COM","2020","2912","23","2935","2023-01-02"
"62481","2022","COM","2020","150","3","153","2023-01-02"
"62483","2022","COM","2020","248","2","250","2023-01-02"
"62484","2022","COM","2020","319","6","325","2023-01-02"
"62485","2022","COM","2020","369","3","372","2023-01-02"
"62486","2022","COM","2020","1058","13","1071","2023-01-02"
"62487","2022","COM","2020","1252","22","1274","2023-01-02"
"62488","2022","COM","2020","775","20","795","2023-01-02"
"62489","2022","COM","2020","3525","29","3554","2023-01-02"
"62490","2022","COM","2020","279","3","282","2023-01-02"
"62491","2022","COM","2020","4969","83","5052","2023-01-02"
"62492","2022","COM","2020","240","3","243","2023-01-02"
"62493","2022","COM","2020","233","4","237","2023-01-02"
"62494","2022","COM","2020","46","0","46","2023-01-02"
"62495","2022","COM","2020","327","6","333","2023-01-02"
"62496","2022","COM","2020","230","6","236","2023-01-02"
"62497","2022","COM","2020","7236","49","7285","2023-01-02"
"62498","2022","COM","2020","32458","193","32651","2023-01-02"
"62499","2022","COM","2020","289","8","297","2023-01-02"
"62500","2022","COM","2020","404","3","407","2023-01-02"
"62501","2022","COM","2020","227","4","231","2023-01-02"
"62502","2022","COM","2020","5104","84","5188","2023-01-02"
"62503","2022","COM","2020","297","6","303","2023-01-02"
"62504","2022","COM","2020","258","5","263","2023-01-02"
"62505","2022","COM","2020","512","9","521","2023-01-02"
"62506","2022","COM","2020","1639","20","1659","2023-01-02"
"62507","2022","COM","2020","297","7","304","2023-01-02"
"62508","2022","COM","2020","367","7","374","2023-01-02"
"62509","2022","COM","2020","343","9","352","2023-01-02"
"62510","2022","COM","2020","30102","330","30432","2023-01-02"
"62511","2022","COM","2020","141","1","142","2023-01-02"
"62512","2022","COM","2020","568","15","583","2023-01-02"
"62513","2022","COM","2020","187","6","193","2023-01-02"
"62514","2022","COM","2020","244","3","247","2023-01-02"
"62515","2022","COM","2020","521","17","538","2023-01-02"
"62516","2022","COM","2020","9866","91","9957","2023-01-02"
"62517","2022","COM","2020","192","6","198","2023-01-02"
"62518","2022","COM","2020","171","1","172","2023-01-02"
"62519","2022","COM","2020","609","8","617","2023-01-02"
"62520","2022","COM","2020","2361","56","2417","2023-01-02"
"62521","2022","COM","2020","205","5","210","2023-01-02"
"62522","2022","COM","2020","278","3","281","2023-01-02"
"62523","2022","COM","2020","5308","35","5343","2023-01-02"
"62524","2022","COM","2020","1504","17","1521","2023-01-02"
"62525","2022","COM","2020","10600","478","11078","2023-01-02"
"62526","2022","COM","2020","147","2","149","2023-01-02"
"62527","2022","COM","2020","256","5","261","2023-01-02"
"62528","2022","COM","2020","6904","62","6966","2023-01-02"
"62529","2022","COM","2020","1589","19","1608","2023-01-02"
"62530","2022","COM","2020","533","9","542","2023-01-02"
"62531","2022","COM","2020","945","19","964","2023-01-02"
"62532","2022","COM","2020","1300","13","1313","2023-01-02"
"62533","2022","COM","2020","145","2","147","2023-01-02"
"62534","2022","COM","2020","3582","69","3651","2023-01-02"
"62535","2022","COM","2020","151","8","159","2023-01-02"
"62536","2022","COM","2020","640","5","645","2023-01-02"
"62537","2022","COM","2020","103","3","106","2023-01-02"
"62538","2022","COM","2020","456","9","465","2023-01-02"
"62539","2022","COM","2020","238","3","241","2023-01-02"
"62540","2022","COM","2020","1698","15","1713","2023-01-02"
"62541","2022","COM","2020","121","4","125","2023-01-02"
"62542","2022","COM","2020","203","4","207","2023-01-02"
"62543","2022","COM","2020","2006","32","2038","2023-01-02"
"62544","2022","COM","2020","181","1","182","2023-01-02"
"62545","2022","COM","2020","145","0","145","2023-01-02"
"62546","2022","COM","2020","307","9","316","2023-01-02"
"62547","2022","COM","2020","60","1","61","2023-01-02"
"62548","2022","COM","2020","10523","142","10665","2023-01-02"
"62549","2022","COM","2020","1070","64","1134","2023-01-02"
"62550","2022","COM","2020","1090","20","1110","2023-01-02"
"62551","2022","COM","2020","240","2","242","2023-01-02"
"62552","2022","COM","2020","1038","8","1046","2023-01-02"
"62553","2022","COM","2020","282","6","288","2023-01-02"
"62554","2022","COM","2020","101","4","105","2023-01-02"
"62555","2022","COM","2020","5524","25","5549","2023-01-02"
"62556","2022","COM","2020","313","5","318","2023-01-02"
"62557","2022","COM","2020","2454","56","2510","2023-01-02"
"62558","2022","COM","2020","179","0","179","2023-01-02"
"62559","2022","COM","2020","976","13","989","2023-01-02"
"62560","2022","COM","2020","5072","61","5133","2023-01-02"
"62561","2022","COM","2020","192","1","193","2023-01-02"
"62562","2022","COM","2020","175","3","178","2023-01-02"
"62563","2022","COM","2020","8029","39","8068","2023-01-02"
"62564","2022","COM","2020","466","9","475","2023-01-02"
"62565","2022","COM","2020","76","0","76","2023-01-02"
"62566","2022","COM","2020","664","16","680","2023-01-02"
"62567","2022","COM","2020","647","7","654","2023-01-02"
"62568","2022","COM","2020","726","9","735","2023-01-02"
"62569","2022","COM","2020","668","6","674","2023-01-02"
"62570","2022","COM","2020","11374","58","11432","2023-01-02"
"62571","2022","COM","2020","3389","70","3459","2023-01-02"
"62572","2022","COM","2020","615","10","625","2023-01-02"
"62573","2022","COM","2020","3728","24","3752","2023-01-02"
"62574","2022","COM","2020","233","5","238","2023-01-02"
"62576","2022","COM","2020","146","0","146","2023-01-02"
"62577","2022","COM","2020","77","2","79","2023-01-02"
"62578","2022","COM","2020","98","4","102","2023-01-02"
"62579","2022","COM","2020","545","3","548","2023-01-02"
"62580","2022","COM","2020","526","8","534","2023-01-02"
"62581","2022","COM","2020","297","2","299","2023-01-02"
"62582","2022","COM","2020","657","37","694","2023-01-02"
"62583","2022","COM","2020","561","9","570","2023-01-02"
"62584","2022","COM","2020","1326","32","1358","2023-01-02"
"62585","2022","COM","2020","396","5","401","2023-01-02"
"62586","2022","COM","2020","446","5","451","2023-01-02"
"62587","2022","COM","2020","10086","42","10128","2023-01-02"
"62588","2022","COM","2020","1913","123","2036","2023-01-02"
"62589","2022","COM","2020","1016","21","1037","2023-01-02"
"62590","2022","COM","2020","63","0","63","2023-01-02"
"62591","2022","COM","2020","209","5","214","2023-01-02"
"62592","2022","COM","2020","556","12","568","2023-01-02"
"62593","2022","COM","2020","89","0","89","2023-01-02"
"62594","2022","COM","2020","308","3","311","2023-01-02"
"62595","2022","COM","2020","1136","30","1166","2023-01-02"
"62596","2022","COM","2020","241","5","246","2023-01-02"
"62597","2022","COM","2020","286","3","289","2023-01-02"
"62598","2022","COM","2020","712","12","724","2023-01-02"
"62599","2022","COM","2020","224","7","231","2023-01-02"
"62600","2022","COM","2020","152","3","155","2023-01-02"
"62601","2022","COM","2020","350","5","355","2023-01-02"
"62602","2022","COM","2020","202","3","205","2023-01-02"
"62603","2022","COM","2020","1067","7","1074","2023-01-02"
"62604","2022","COM","2020","3748","70","3818","2023-01-02"
"62605","2022","COM","2020","25","0","25","2023-01-02"
"62606","2022","COM","2020","1435","23","1458","2023-01-02"
"62607","2022","COM","2020","64","3","67","2023-01-02"
"62608","2022","COM","2020","168","1","169","2023-01-02"
"62609","2022","COM","2020","1594","37","1631","2023-01-02"
"62610","2022","COM","2020","650","9","659","2023-01-02"
"62611","2022","COM","2020","496","13","509","2023-01-02"
"62612","2022","COM","2020","585","12","597","2023-01-02"
"62613","2022","COM","2020","898","8","906","2023-01-02"
"62614","2022","COM","2020","592","14","606","2023-01-02"
"62615","2022","COM","2020","286","6","292","2023-01-02"
"62616","2022","COM","2020","184","2","186","2023-01-02"
"62617","2022","COM","2020","11638","52","11690","2023-01-02"
"62618","2022","COM","2020","1336","15","1351","2023-01-02"
"62619","2022","COM","2020","141","2","143","2023-01-02"
"62620","2022","COM","2020","1377","22","1399","2023-01-02"
"62621","2022","COM","2020","1743","31","1774","2023-01-02"
"62622","2022","COM","2020","266","3","269","2023-01-02"
"62623","2022","COM","2020","710","10","720","2023-01-02"
"62624","2022","COM","2020","5864","28","5892","2023-01-02"
"62625","2022","COM","2020","56","2","58","2023-01-02"
"62626","2022","COM","2020","2297","21","2318","2023-01-02"
"62627","2022","COM","2020","829","14","843","2023-01-02"
"62628","2022","COM","2020","6590","44","6634","2023-01-02"
"62629","2022","COM","2020","161","1","162","2023-01-02"
"62630","2022","COM","2020","297","5","302","2023-01-02"
"62631","2022","COM","2020","488","7","495","2023-01-02"
"62632","2022","COM","2020","381","6","387","2023-01-02"
"62633","2022","COM","2020","256","2","258","2023-01-02"
"62634","2022","COM","2020","1214","10","1224","2023-01-02"
"62635","2022","COM","2020","199","2","201","2023-01-02"
"62636","2022","COM","2020","269","2","271","2023-01-02"
"62637","2022","COM","2020","10130","43","10173","2023-01-02"
"62638","2022","COM","2020","1175","14","1189","2023-01-02"
"62639","2022","COM","2020","383","9","392","2023-01-02"
"62640","2022","COM","2020","370","1","371","2023-01-02"
"62641","2022","COM","2020","213","3","216","2023-01-02"
"62642","2022","COM","2020","750","5","755","2023-01-02"
"62643","2022","COM","2020","13178","162","13340","2023-01-02"
"62644","2022","COM","2020","503","7","510","2023-01-02"
"62645","2022","COM","2020","5630","83","5713","2023-01-02"
"62646","2022","COM","2020","573","7","580","2023-01-02"
"62647","2022","COM","2020","738","15","753","2023-01-02"
"62648","2022","COM","2020","522","9","531","2023-01-02"
"62649","2022","COM","2020","754","10","764","2023-01-02"
"62650","2022","COM","2020","765","8","773","2023-01-02"
"62651","2022","COM","2020","488","7","495","2023-01-02"
"62652","2022","COM","2020","1606","29","1635","2023-01-02"
"62653","2022","COM","2020","414","19","433","2023-01-02"
"62654","2022","COM","2020","784","13","797","2023-01-02"
"62655","2022","COM","2020","316","8","324","2023-01-02"
"62656","2022","COM","2020","947","27","974","2023-01-02"
"62657","2022","COM","2020","503","7","510","2023-01-02"
"62658","2022","COM","2020","117","9","126","2023-01-02"
"62659","2022","COM","2020","102","3","105","2023-01-02"
"62660","2022","COM","2020","457","7","464","2023-01-02"
"62661","2022","COM","2020","507","0","507","2023-01-02"
"62662","2022","COM","2020","870","21","891","2023-01-02"
"62663","2022","COM","2020","310","4","314","2023-01-02"
"62664","2022","COM","2020","234","6","240","2023-01-02"
"62665","2022","COM","2020","213","6","219","2023-01-02"
"62666","2022","COM","2020","3116","18","3134","2023-01-02"
"62667","2022","COM","2020","8985","113","9098","2023-01-02"
"62668","2022","COM","2020","189","1","190","2023-01-02"
"62669","2022","COM","2020","309","5","314","2023-01-02"
"62670","2022","COM","2020","623","7","630","2023-01-02"
"62671","2022","COM","2020","316","5","321","2023-01-02"
"62672","2022","COM","2020","647","5","652","2023-01-02"
"62673","2022","COM","2020","643","8","651","2023-01-02"
"62674","2022","COM","2020","544","18","562","2023-01-02"
"62675","2022","COM","2020","275","2","277","2023-01-02"
"62676","2022","COM","2020","448","7","455","2023-01-02"
"62677","2022","COM","2020","340","5","345","2023-01-02"
"62678","2022","COM","2020","701","9","710","2023-01-02"
"62679","2022","COM","2020","324","8","332","2023-01-02"
"62680","2022","COM","2020","729","13","742","2023-01-02"
"62681","2022","COM","2020","625","22","647","2023-01-02"
"62682","2022","COM","2020","66","0","66","2023-01-02"
"62683","2022","COM","2020","226","2","228","2023-01-02"
"62684","2022","COM","2020","2218","30","2248","2023-01-02"
"62685","2022","COM","2020","270","163","433","2023-01-02"
"62686","2022","COM","2020","348","6","354","2023-01-02"
"62688","2022","COM","2020","4329","119","4448","2023-01-02"
"62689","2022","COM","2020","395","2","397","2023-01-02"
"62690","2022","COM","2020","233","6","239","2023-01-02"
"62691","2022","COM","2020","824","12","836","2023-01-02"
"62692","2022","COM","2020","374","4","378","2023-01-02"
"62693","2022","COM","2020","1071","22","1093","2023-01-02"
"62694","2022","COM","2020","188","2","190","2023-01-02"
"62695","2022","COM","2020","261","2","263","2023-01-02"
"62696","2022","COM","2020","233","3","236","2023-01-02"
"62697","2022","COM","2020","248","0","248","2023-01-02"
"62698","2022","COM","2020","272","5","277","2023-01-02"
"62699","2022","COM","2020","655","13","668","2023-01-02"
"62700","2022","COM","2020","213","1","214","2023-01-02"
"62701","2022","COM","2020","453","2","455","2023-01-02"
"62702","2022","COM","2020","358","4","362","2023-01-02"
"62703","2022","COM","2020","378","3","381","2023-01-02"
"62704","2022","COM","2020","588","18","606","2023-01-02"
"62705","2022","COM","2020","2087","16","2103","2023-01-02"
"62706","2022","COM","2020","2628","58","2686","2023-01-02"
"62708","2022","COM","2020","31","1","32","2023-01-02"
"62709","2022","COM","2020","249","5","254","2023-01-02"
"62710","2022","COM","2020","182","4","186","2023-01-02"
"62711","2022","COM","2020","3048","31","3079","2023-01-02"
"62712","2022","COM","2020","1125","29","1154","2023-01-02"
"62713","2022","COM","2020","1335","23","1358","2023-01-02"
"62714","2022","COM","2020","783","18","801","2023-01-02"
"62715","2022","COM","2020","289","0","289","2023-01-02"
"62716","2022","COM","2020","550","6","556","2023-01-02"
"62717","2022","COM","2020","528","9","537","2023-01-02"
"62718","2022","COM","2020","1404","22","1426","2023-01-02"
"62719","2022","COM","2020","280","35","315","2023-01-02"
"62720","2022","COM","2020","43","2","45","2023-01-02"
"62721","2022","COM","2020","1947","47","1994","2023-01-02"
"62722","2022","COM","2020","89","3","92","2023-01-02"
"62723","2022","COM","2020","238","1","239","2023-01-02"
"62724","2022","COM","2020","8925","35","8960","2023-01-02"
"62725","2022","COM","2020","140","0","140","2023-01-02"
"62726","2022","COM","2020","204","5","209","2023-01-02"
"62727","2022","COM","2020","1521","23","1544","2023-01-02"
"62728","2022","COM","2020","693","11","704","2023-01-02"
"62729","2022","COM","2020","246","8","254","2023-01-02"
"62730","2022","COM","2020","1612","23","1635","2023-01-02"
"62731","2022","COM","2020","281","3","284","2023-01-02"
"62732","2022","COM","2020","323","2","325","2023-01-02"
"62733","2022","COM","2020","301","3","304","2023-01-02"
"62734","2022","COM","2020","672","8","680","2023-01-02"
"62735","2022","COM","2020","2520","19","2539","2023-01-02"
"62736","2022","COM","2020","3900","72","3972","2023-01-02"
"62737","2022","COM","2020","6035","34","6069","2023-01-02"
"62738","2022","COM","2020","155","1","156","2023-01-02"
"62739","2022","COM","2020","327","3","330","2023-01-02"
"62740","2022","COM","2020","306","9","315","2023-01-02"
"62741","2022","COM","2020","117","3","120","2023-01-02"
"62742","2022","COM","2020","270","6","276","2023-01-02"
"62743","2022","COM","2020","380","9","389","2023-01-02"
"62744","2022","COM","2020","3653","60","3713","2023-01-02"
"62745","2022","COM","2020","159","6","165","2023-01-02"
"62746","2022","COM","2020","5094","65","5159","2023-01-02"
"62747","2022","COM","2020","625","16","641","2023-01-02"
"62748","2022","COM","2020","2318","40","2358","2023-01-02"
"62749","2022","COM","2020","338","6","344","2023-01-02"
"62750","2022","COM","2020","817","9","826","2023-01-02"
"62751","2022","COM","2020","801","9","810","2023-01-02"
"62752","2022","COM","2020","1105","41","1146","2023-01-02"
"62753","2022","COM","2020","6522","56","6578","2023-01-02"
"62754","2022","COM","2020","495","3","498","2023-01-02"
"62755","2022","COM","2020","3377","50","3427","2023-01-02"
"62756","2022","COM","2020","1671","17","1688","2023-01-02"
"62757","2022","COM","2020","5970","134","6104","2023-01-02"
"62758","2022","COM","2020","11165","173","11338","2023-01-02"
"62759","2022","COM","2020","463","10","473","2023-01-02"
"62760","2022","COM","2020","275","6","281","2023-01-02"
"62761","2022","COM","2020","211","4","215","2023-01-02"
"62762","2022","COM","2020","122","5","127","2023-01-02"
"62763","2022","COM","2020","854","15","869","2023-01-02"
"62764","2022","COM","2020","4659","51","4710","2023-01-02"
"62765","2022","COM","2020","14782","646","15428","2023-01-02"
"62766","2022","COM","2020","1109","12","1121","2023-01-02"
"62767","2022","COM","2020","4870","153","5023","2023-01-02"
"62768","2022","COM","2020","105","2","107","2023-01-02"
"62769","2022","COM","2020","765","14","779","2023-01-02"
"62770","2022","COM","2020","3041","95","3136","2023-01-02"
"62771","2022","COM","2020","9575","43","9618","2023-01-02"
"62772","2022","COM","2020","492","10","502","2023-01-02"
"62773","2022","COM","2020","4656","138","4794","2023-01-02"
"62774","2022","COM","2020","4840","129","4969","2023-01-02"
"62775","2022","COM","2020","351","2","353","2023-01-02"
"62776","2022","COM","2020","193","4","197","2023-01-02"
"62777","2022","COM","2020","160","1","161","2023-01-02"
"62778","2022","COM","2020","77","1","78","2023-01-02"
"62779","2022","COM","2020","189","1","190","2023-01-02"
"62780","2022","COM","2020","364","3","367","2023-01-02"
"62781","2022","COM","2020","466","3","469","2023-01-02"
"62782","2022","COM","2020","433","6","439","2023-01-02"
"62783","2022","COM","2020","317","4","321","2023-01-02"
"62784","2022","COM","2020","771","12","783","2023-01-02"
"62785","2022","COM","2020","891","185","1076","2023-01-02"
"62786","2022","COM","2020","320","4","324","2023-01-02"
"62787","2022","COM","2020","319","3","322","2023-01-02"
"62788","2022","COM","2020","694","17","711","2023-01-02"
"62789","2022","COM","2020","268","5","273","2023-01-02"
"62790","2022","COM","2020","162","7","169","2023-01-02"
"62791","2022","COM","2020","49","0","49","2023-01-02"
"62792","2022","COM","2020","1151","32","1183","2023-01-02"
"62793","2022","COM","2020","1133","18","1151","2023-01-02"
"62794","2022","COM","2020","589","11","600","2023-01-02"
"62795","2022","COM","2020","110","2","112","2023-01-02"
"62796","2022","COM","2020","557","12","569","2023-01-02"
"62797","2022","COM","2020","278","3","281","2023-01-02"
"62798","2022","COM","2020","228","5","233","2023-01-02"
"62799","2022","COM","2020","914","28","942","2023-01-02"
"62800","2022","COM","2020","378","3","381","2023-01-02"
"62801","2022","COM","2020","2643","50","2693","2023-01-02"
"62802","2022","COM","2020","185","2","187","2023-01-02"
"62803","2022","COM","2020","640","5","645","2023-01-02"
"62804","2022","COM","2020","365","5","370","2023-01-02"
"62805","2022","COM","2020","267","4","271","2023-01-02"
"62806","2022","COM","2020","150","5","155","2023-01-02"
"62808","2022","COM","2020","258","2","260","2023-01-02"
"62809","2022","COM","2020","139","3","142","2023-01-02"
"62810","2022","COM","2020","1239","23","1262","2023-01-02"
"62811","2022","COM","2020","1101","26","1127","2023-01-02"
"62812","2022","COM","2020","835","7","842","2023-01-02"
"62813","2022","COM","2020","494","2","496","2023-01-02"
"62814","2022","COM","2020","97","1","98","2023-01-02"
"62815","2022","COM","2020","174","0","174","2023-01-02"
"62816","2022","COM","2020","218","5","223","2023-01-02"
"62817","2022","COM","2020","1475","110","1585","2023-01-02"
"62818","2022","COM","2020","155","1","156","2023-01-02"
"62819","2022","COM","2020","1077","30","1107","2023-01-02"
"62820","2022","COM","2020","811","18","829","2023-01-02"
"62821","2022","COM","2020","294","7","301","2023-01-02"
"62822","2022","COM","2020","92","3","95","2023-01-02"
"62823","2022","COM","2020","172","5","177","2023-01-02"
"62824","2022","COM","2020","219","5","224","2023-01-02"
"62825","2022","COM","2020","839","8","847","2023-01-02"
"62826","2022","COM","2020","4226","301","4527","2023-01-02"
"62827","2022","COM","2020","1391","17","1408","2023-01-02"
"62828","2022","COM","2020","57","0","57","2023-01-02"
"62829","2022","COM","2020","430","4","434","2023-01-02"
"62830","2022","COM","2020","175","2","177","2023-01-02"
"62831","2022","COM","2020","296","10","306","2023-01-02"
"62832","2022","COM","2020","575","19","594","2023-01-02"
"62833","2022","COM","2020","75","2","77","2023-01-02"
"62834","2022","COM","2020","252","4","256","2023-01-02"
"62835","2022","COM","2020","551","17","568","2023-01-02"
"62836","2022","COM","2020","1079","19","1098","2023-01-02"
"62837","2022","COM","2020","501","8","509","2023-01-02"
"62838","2022","COM","2020","90","3","93","2023-01-02"
"62839","2022","COM","2020","1047","8","1055","2023-01-02"
"62840","2022","COM","2020","132","0","132","2023-01-02"
"62841","2022","COM","2020","2413","24","2437","2023-01-02"
"62842","2022","COM","2020","8419","46","8465","2023-01-02"
"62843","2022","COM","2020","233","2","235","2023-01-02"
"62844","2022","COM","2020","631","14","645","2023-01-02"
"62845","2022","COM","2020","502","4","506","2023-01-02"
"62846","2022","COM","2020","4767","42","4809","2023-01-02"
"62847","2022","COM","2020","2021","24","2045","2023-01-02"
"62848","2022","COM","2020","3477","37","3514","2023-01-02"
"62849","2022","COM","2020","2510","55","2565","2023-01-02"
"62850","2022","COM","2020","344","6","350","2023-01-02"
"62851","2022","COM","2020","833","17","850","2023-01-02"
"62852","2022","COM","2020","1440","11","1451","2023-01-02"
"62853","2022","COM","2020","376","10","386","2023-01-02"
"62854","2022","COM","2020","614","9","623","2023-01-02"
"62855","2022","COM","2020","246","1","247","2023-01-02"
"62856","2022","COM","2020","368","3","371","2023-01-02"
"62857","2022","COM","2020","130","9","139","2023-01-02"
"62858","2022","COM","2020","256","5","261","2023-01-02"
"62859","2022","COM","2020","260","4","264","2023-01-02"
"62860","2022","COM","2020","126","3","129","2023-01-02"
"62861","2022","COM","2020","4332","58","4390","2023-01-02"
"62862","2022","COM","2020","154","3","157","2023-01-02"
"62863","2022","COM","2020","3814","29","3843","2023-01-02"
"62864","2022","COM","2020","644","15","659","2023-01-02"
"62865","2022","COM","2020","4732","49","4781","2023-01-02"
"62866","2022","COM","2020","435","15","450","2023-01-02"
"62867","2022","COM","2020","264","7","271","2023-01-02"
"62868","2022","COM","2020","257","6","263","2023-01-02"
"62869","2022","COM","2020","1076","33","1109","2023-01-02"
"62870","2022","COM","2020","1041","26","1067","2023-01-02"
"62871","2022","COM","2020","261","1","262","2023-01-02"
"62872","2022","COM","2020","233","5","238","2023-01-02"
"62873","2022","COM","2020","637","10","647","2023-01-02"
"62874","2022","COM","2020","716","15","731","2023-01-02"
"62875","2022","COM","2020","1354","18","1372","2023-01-02"
"62876","2022","COM","2020","132","2","134","2023-01-02"
"62877","2022","COM","2020","156","5","161","2023-01-02"
"62878","2022","COM","2020","382","7","389","2023-01-02"
"62879","2022","COM","2020","224","3","227","2023-01-02"
"62880","2022","COM","2020","198","3","201","2023-01-02"
"62881","2022","COM","2020","374","9","383","2023-01-02"
"62882","2022","COM","2020","1240","33","1273","2023-01-02"
"62883","2022","COM","2020","195","2","197","2023-01-02"
"62885","2022","COM","2020","253","2","255","2023-01-02"
"62886","2022","COM","2020","271","3","274","2023-01-02"
"62887","2022","COM","2020","245","1","246","2023-01-02"
"62888","2022","COM","2020","226","9","235","2023-01-02"
"62889","2022","COM","2020","867","19","886","2023-01-02"
"62890","2022","COM","2020","183","3","186","2023-01-02"
"62891","2022","COM","2020","137","4","141","2023-01-02"
"62892","2022","COM","2020","657","10","667","2023-01-02"
"62893","2022","COM","2020","6311","164","6475","2023-01-02"
"62894","2022","COM","2020","3937","52","3989","2023-01-02"
"62895","2022","COM","2020","8750","47","8797","2023-01-02"
"62896","2022","COM","2020","748","20","768","2023-01-02"
"62897","2022","COM","2020","512","9","521","2023-01-02"
"62898","2022","COM","2020","224","9","233","2023-01-02"
"62899","2022","COM","2020","850","16","866","2023-01-02"
"62900","2022","COM","2020","599","15","614","2023-01-02"
"62901","2022","COM","2020","999","13","1012","2023-01-02"
"62902","2022","COM","2020","3308","41","3349","2023-01-02"
"62903","2022","COM","2020","609","13","622","2023-01-02"
"62904","2022","COM","2020","596","9","605","2023-01-02"
"62905","2022","COM","2020","1033","50","1083","2023-01-02"
"62906","2022","COM","2020","1788","11","1799","2023-01-02"
"62907","2022","COM","2020","8230","41","8271","2023-01-02"
"62908","2022","COM","2020","1610","38","1648","2023-01-02"
"62909","2022","COM","2020","433","5","438","2023-01-02"
"63001","2022","COM","2020","2770","34","2804","2023-01-02"
"63002","2022","COM","2020","96","3","99","2023-01-02"
"63003","2022","COM","2020","6636","241","6877","2023-01-02"
"63004","2022","COM","2020","1705","31","1736","2023-01-02"
"63005","2022","COM","2020","411","5","416","2023-01-02"
"63006","2022","COM","2020","173","2","175","2023-01-02"
"63007","2022","COM","2020","161","3","164","2023-01-02"
"63008","2022","COM","2020","585","11","596","2023-01-02"
"63009","2022","COM","2020","598","5","603","2023-01-02"
"63010","2022","COM","2020","1803","38","1841","2023-01-02"
"63011","2022","COM","2020","219","13","232","2023-01-02"
"63012","2022","COM","2020","918","18","936","2023-01-02"
"63013","2022","COM","2020","955","9","964","2023-01-02"
"63014","2022","COM","2020","10581","175","10756","2023-01-02"
"63015","2022","COM","2020","223","2","225","2023-01-02"
"63016","2022","COM","2020","879","20","899","2023-01-02"
"63017","2022","COM","2020","193","1","194","2023-01-02"
"63019","2022","COM","2020","4103","39","4142","2023-01-02"
"63020","2022","COM","2020","369","13","382","2023-01-02"
"63021","2022","COM","2020","680","15","695","2023-01-02"
"63022","2022","COM","2020","1985","25","2010","2023-01-02"
"63023","2022","COM","2020","381","10","391","2023-01-02"
"63024","2022","COM","2020","174","3","177","2023-01-02"
"63025","2022","COM","2020","137","5","142","2023-01-02"
"63026","2022","COM","2020","2511","45","2556","2023-01-02"
"63027","2022","COM","2020","111","1","112","2023-01-02"
"63028","2022","COM","2020","405","12","417","2023-01-02"
"63029","2022","COM","2020","261","3","264","2023-01-02"
"63030","2022","COM","2020","342","4","346","2023-01-02"
"63031","2022","COM","2020","477","5","482","2023-01-02"
"63032","2022","COM","2020","10630","218","10848","2023-01-02"
"63033","2022","COM","2020","310","3","313","2023-01-02"
"63034","2022","COM","2020","1547","25","1572","2023-01-02"
"63035","2022","COM","2020","1269","19","1288","2023-01-02"
"63036","2022","COM","2020","320","4","324","2023-01-02"
"63037","2022","COM","2020","455","13","468","2023-01-02"
"63038","2022","COM","2020","1476","67","1543","2023-01-02"
"63039","2022","COM","2020","285","10","295","2023-01-02"
"63040","2022","COM","2020","4790","95","4885","2023-01-02"
"63041","2022","COM","2020","319","9","328","2023-01-02"
"63042","2022","COM","2020","3795","39","3834","2023-01-02"
"63043","2022","COM","2020","445","4","449","2023-01-02"
"63044","2022","COM","2020","427","7","434","2023-01-02"
"63045","2022","COM","2020","705","17","722","2023-01-02"
"63046","2022","COM","2020","282","5","287","2023-01-02"
"63047","2022","COM","2020","1757","33","1790","2023-01-02"
"63048","2022","COM","2020","867","17","884","2023-01-02"
"63049","2022","COM","2020","730","6","736","2023-01-02"
"63050","2022","COM","2020","3373","133","3506","2023-01-02"
"63051","2022","COM","2020","629","13","642","2023-01-02"
"63052","2022","COM","2020","1046","88","1134","2023-01-02"
"63053","2022","COM","2020","262","7","269","2023-01-02"
"63054","2022","COM","2020","661","16","677","2023-01-02"
"63055","2022","COM","2020","994","14","1008","2023-01-02"
"63056","2022","COM","2020","330","4","334","2023-01-02"
"63057","2022","COM","2020","243","6","249","2023-01-02"
"63058","2022","COM","2020","550","10","560","2023-01-02"
"63059","2022","COM","2020","218","5","223","2023-01-02"
"63060","2022","COM","2020","96","1","97","2023-01-02"
"63061","2022","COM","2020","481","7","488","2023-01-02"
"63062","2022","COM","2020","235","2","237","2023-01-02"
"63063","2022","COM","2020","8951","124","9075","2023-01-02"
"63064","2022","COM","2020","79","0","79","2023-01-02"
"63065","2022","COM","2020","172","2","174","2023-01-02"
"63066","2022","COM","2020","1646","29","1675","2023-01-02"
"63067","2022","COM","2020","162","2","164","2023-01-02"
"63069","2022","COM","2020","5525","53","5578","2023-01-02"
"63070","2022","COM","2020","6338","135","6473","2023-01-02"
"63071","2022","COM","2020","691","13","704","2023-01-02"
"63072","2022","COM","2020","1189","14","1203","2023-01-02"
"63073","2022","COM","2020","434","13","447","2023-01-02"
"63074","2022","COM","2020","182","0","182","2023-01-02"
"63075","2022","COM","2020","17196","560","17756","2023-01-02"
"63076","2022","COM","2020","143","3","146","2023-01-02"
"63077","2022","COM","2020","418","13","431","2023-01-02"
"63079","2022","COM","2020","151","2","153","2023-01-02"
"63080","2022","COM","2020","1424","23","1447","2023-01-02"
"63081","2022","COM","2020","275","4","279","2023-01-02"
"63082","2022","COM","2020","403","8","411","2023-01-02"
"63083","2022","COM","2020","932","28","960","2023-01-02"
"63084","2022","COM","2020","1712","38","1750","2023-01-02"
"63085","2022","COM","2020","1136","8","1144","2023-01-02"
"63086","2022","COM","2020","332","13","345","2023-01-02"
"63087","2022","COM","2020","68","1","69","2023-01-02"
"63088","2022","COM","2020","84","0","84","2023-01-02"
"63089","2022","COM","2020","1632","29","1661","2023-01-02"
"63090","2022","COM","2020","509","7","516","2023-01-02"
"63091","2022","COM","2020","919","16","935","2023-01-02"
"63092","2022","COM","2020","1840","28","1868","2023-01-02"
"63093","2022","COM","2020","1145","22","1167","2023-01-02"
"63094","2022","COM","2020","480","5","485","2023-01-02"
"63095","2022","COM","2020","206","3","209","2023-01-02"
"63096","2022","COM","2020","381","8","389","2023-01-02"
"63097","2022","COM","2020","80","2","82","2023-01-02"
"63098","2022","COM","2020","227","5","232","2023-01-02"
"63099","2022","COM","2020","3104","52","3156","2023-01-02"
"63100","2022","COM","2020","328","3","331","2023-01-02"
"63101","2022","COM","2020","68","2","70","2023-01-02"
"63102","2022","COM","2020","776","15","791","2023-01-02"
"63103","2022","COM","2020","6283","178","6461","2023-01-02"
"63104","2022","COM","2020","113","5","118","2023-01-02"
"63105","2022","COM","2020","228","6","234","2023-01-02"
"63106","2022","COM","2020","1731","16","1747","2023-01-02"
"63107","2022","COM","2020","516","10","526","2023-01-02"
"63108","2022","COM","2020","681","18","699","2023-01-02"
"63109","2022","COM","2020","531","13","544","2023-01-02"
"63110","2022","COM","2020","464","7","471","2023-01-02"
"63111","2022","COM","2020","120","5","125","2023-01-02"
"63112","2022","COM","2020","627","18","645","2023-01-02"
"63113","2022","COM","2020","147284","2614","149898","2023-01-02"
"63114","2022","COM","2020","157","2","159","2023-01-02"
"63115","2022","COM","2020","218","5","223","2023-01-02"
"63116","2022","COM","2020","2143","36","2179","2023-01-02"
"63117","2022","COM","2020","127","4","131","2023-01-02"
"63118","2022","COM","2020","410","7","417","2023-01-02"
"63119","2022","COM","2020","228","7","235","2023-01-02"
"63120","2022","COM","2020","766","9","775","2023-01-02"
"63121","2022","COM","2020","1273","14","1287","2023-01-02"
"63122","2022","COM","2020","61","1","62","2023-01-02"
"63123","2022","COM","2020","233","6","239","2023-01-02"
"63124","2022","COM","2020","20356","356","20712","2023-01-02"
"63125","2022","COM","2020","4005","143","4148","2023-01-02"
"63126","2022","COM","2020","1279","22","1301","2023-01-02"
"63128","2022","COM","2020","968","15","983","2023-01-02"
"63129","2022","COM","2020","167","0","167","2023-01-02"
"63130","2022","COM","2020","259","10","269","2023-01-02"
"63131","2022","COM","2020","1139","19","1158","2023-01-02"
"63132","2022","COM","2020","1319","23","1342","2023-01-02"
"63134","2022","COM","2020","68","3","71","2023-01-02"
"63135","2022","COM","2020","606","6","612","2023-01-02"
"63136","2022","COM","2020","382","8","390","2023-01-02"
"63137","2022","COM","2020","174","3","177","2023-01-02"
"63138","2022","COM","2020","725","10","735","2023-01-02"
"63139","2022","COM","2020","660","8","668","2023-01-02"
"63140","2022","COM","2020","213","5","218","2023-01-02"
"63141","2022","COM","2020","2065","44","2109","2023-01-02"
"63142","2022","COM","2020","249","12","261","2023-01-02"
"63143","2022","COM","2020","1134","19","1153","2023-01-02"
"63144","2022","COM","2020","338","6","344","2023-01-02"
"63145","2022","COM","2020","153","5","158","2023-01-02"
"63146","2022","COM","2020","808","65","873","2023-01-02"
"63147","2022","COM","2020","272","5","277","2023-01-02"
"63148","2022","COM","2020","2532","59","2591","2023-01-02"
"63149","2022","COM","2020","697","12","709","2023-01-02"
"63150","2022","COM","2020","1556","22","1578","2023-01-02"
"63151","2022","COM","2020","1348","39","1387","2023-01-02"
"63152","2022","COM","2020","286","4","290","2023-01-02"
"63153","2022","COM","2020","95","3","98","2023-01-02"
"63154","2022","COM","2020","436","8","444","2023-01-02"
"63155","2022","COM","2020","491","14","505","2023-01-02"
"63156","2022","COM","2020","57","0","57","2023-01-02"
"63157","2022","COM","2020","372","7","379","2023-01-02"
"63158","2022","COM","2020","107","4","111","2023-01-02"
"63159","2022","COM","2020","135","0","135","2023-01-02"
"63160","2022","COM","2020","930","33","963","2023-01-02"
"63161","2022","COM","2020","319","12","331","2023-01-02"
"63162","2022","COM","2020","315","10","325","2023-01-02"
"63163","2022","COM","2020","940","61","1001","2023-01-02"
"63164","2022","COM","2020","10395","96","10491","2023-01-02"
"63165","2022","COM","2020","796","35","831","2023-01-02"
"63166","2022","COM","2020","249","5","254","2023-01-02"
"63167","2022","COM","2020","398","5","403","2023-01-02"
"63168","2022","COM","2020","589","11","600","2023-01-02"
"63169","2022","COM","2020","16","0","16","2023-01-02"
"63170","2022","COM","2020","622","12","634","2023-01-02"
"63171","2022","COM","2020","326","13","339","2023-01-02"
"63172","2022","COM","2020","53","1","54","2023-01-02"
"63173","2022","COM","2020","201","7","208","2023-01-02"
"63174","2022","COM","2020","119","3","122","2023-01-02"
"63175","2022","COM","2020","230","8","238","2023-01-02"
"63176","2022","COM","2020","108","3","111","2023-01-02"
"63177","2022","COM","2020","412","8","420","2023-01-02"
"63178","2022","COM","2020","15297","384","15681","2023-01-02"
"63179","2022","COM","2020","1013","30","1043","2023-01-02"
"63180","2022","COM","2020","1145","18","1163","2023-01-02"
"63181","2022","COM","2020","549","13","562","2023-01-02"
"63182","2022","COM","2020","566","14","580","2023-01-02"
"63183","2022","COM","2020","67","1","68","2023-01-02"
"63184","2022","COM","2020","278","5","283","2023-01-02"
"63185","2022","COM","2020","641","12","653","2023-01-02"
"63186","2022","COM","2020","223","8","231","2023-01-02"
"63187","2022","COM","2020","520","11","531","2023-01-02"
"63188","2022","COM","2020","586","16","602","2023-01-02"
"63189","2022","COM","2020","364","14","378","2023-01-02"
"63190","2022","COM","2020","284","4","288","2023-01-02"
"63191","2022","COM","2020","102","3","105","2023-01-02"
"63192","2022","COM","2020","629","33","662","2023-01-02"
"63193","2022","COM","2020","8669","436","9105","2023-01-02"
"63194","2022","COM","2020","398","6","404","2023-01-02"
"63195","2022","COM","2020","6287","68","6355","2023-01-02"
"63196","2022","COM","2020","747","14","761","2023-01-02"
"63197","2022","COM","2020","121","3","124","2023-01-02"
"63198","2022","COM","2020","1418","21","1439","2023-01-02"
"63199","2022","COM","2020","509","5","514","2023-01-02"
"63200","2022","COM","2020","925","17","942","2023-01-02"
"63201","2022","COM","2020","1145","19","1164","2023-01-02"
"63202","2022","COM","2020","117","2","119","2023-01-02"
"63203","2022","COM","2020","1160","18","1178","2023-01-02"
"63204","2022","COM","2020","1134","19","1153","2023-01-02"
"63205","2022","COM","2020","469","9","478","2023-01-02"
"63206","2022","COM","2020","1395","21","1416","2023-01-02"
"63207","2022","COM","2020","814","11","825","2023-01-02"
"63208","2022","COM","2020","309","3","312","2023-01-02"
"63209","2022","COM","2020","215","5","220","2023-01-02"
"63210","2022","COM","2020","3112","53","3165","2023-01-02"
"63211","2022","COM","2020","1434","40","1474","2023-01-02"
"63212","2022","COM","2020","1456","38","1494","2023-01-02"
"63213","2022","COM","2020","2185","22","2207","2023-01-02"
"63214","2022","COM","2020","3941","63","4004","2023-01-02"
"63215","2022","COM","2020","680","7","687","2023-01-02"
"63216","2022","COM","2020","116","2","118","2023-01-02"
"63218","2022","COM","2020","197","6","203","2023-01-02"
"63219","2022","COM","2020","707","11","718","2023-01-02"
"63220","2022","COM","2020","96","3","99","2023-01-02"
"63221","2022","COM","2020","125","2","127","2023-01-02"
"63222","2022","COM","2020","485","8","493","2023-01-02"
"63223","2022","COM","2020","536","13","549","2023-01-02"
"63224","2022","COM","2020","1643","24","1667","2023-01-02"
"63225","2022","COM","2020","1034","20","1054","2023-01-02"
"63226","2022","COM","2020","3313","63","3376","2023-01-02"
"63227","2022","COM","2020","2353","57","2410","2023-01-02"
"63228","2022","COM","2020","292","10","302","2023-01-02"
"63229","2022","COM","2020","1245","22","1267","2023-01-02"
"63230","2022","COM","2020","236","5","241","2023-01-02"
"63231","2022","COM","2020","1669","30","1699","2023-01-02"
"63232","2022","COM","2020","553","14","567","2023-01-02"
"63233","2022","COM","2020","985","7","992","2023-01-02"
"63234","2022","COM","2020","891","28","919","2023-01-02"
"63235","2022","COM","2020","546","6","552","2023-01-02"
"63236","2022","COM","2020","1274","18","1292","2023-01-02"
"63237","2022","COM","2020","422","6","428","2023-01-02"
"63238","2022","COM","2020","229","1","230","2023-01-02"
"63239","2022","COM","2020","727","25","752","2023-01-02"
"63240","2022","COM","2020","466","8","474","2023-01-02"
"63241","2022","COM","2020","324","14","338","2023-01-02"
"63242","2022","COM","2020","387","10","397","2023-01-02"
"63243","2022","COM","2020","385","6","391","2023-01-02"
"63244","2022","COM","2020","1805","27","1832","2023-01-02"
"63245","2022","COM","2020","3874","68","3942","2023-01-02"
"63246","2022","COM","2020","488","18","506","2023-01-02"
"63247","2022","COM","2020","610","11","621","2023-01-02"
"63248","2022","COM","2020","853","22","875","2023-01-02"
"63249","2022","COM","2020","510","10","520","2023-01-02"
"63250","2022","COM","2020","855","18","873","2023-01-02"
"63251","2022","COM","2020","297","5","302","2023-01-02"
"63252","2022","COM","2020","378","9","387","2023-01-02"
"63253","2022","COM","2020","235","2","237","2023-01-02"
"63254","2022","COM","2020","2223","35","2258","2023-01-02"
"63255","2022","COM","2020","599","16","615","2023-01-02"
"63256","2022","COM","2020","151","3","154","2023-01-02"
"63257","2022","COM","2020","840","10","850","2023-01-02"
"63258","2022","COM","2020","750","20","770","2023-01-02"
"63259","2022","COM","2020","312","9","321","2023-01-02"
"63260","2022","COM","2020","156","5","161","2023-01-02"
"63261","2022","COM","2020","859","24","883","2023-01-02"
"63262","2022","COM","2020","2781","40","2821","2023-01-02"
"63263","2022","COM","2020","3545","109","3654","2023-01-02"
"63264","2022","COM","2020","247","1","248","2023-01-02"
"63265","2022","COM","2020","2218","44","2262","2023-01-02"
"63267","2022","COM","2020","524","19","543","2023-01-02"
"63268","2022","COM","2020","296","4","300","2023-01-02"
"63269","2022","COM","2020","887","15","902","2023-01-02"
"63270","2022","COM","2020","488","15","503","2023-01-02"
"63271","2022","COM","2020","1478","40","1518","2023-01-02"
"63272","2022","COM","2020","2718","52","2770","2023-01-02"
"63273","2022","COM","2020","1504","23","1527","2023-01-02"
"63274","2022","COM","2020","426","15","441","2023-01-02"
"63275","2022","COM","2020","890","20","910","2023-01-02"
"63276","2022","COM","2020","2115","42","2157","2023-01-02"
"63277","2022","COM","2020","61","1","62","2023-01-02"
"63278","2022","COM","2020","719","13","732","2023-01-02"
"63279","2022","COM","2020","318","10","328","2023-01-02"
"63280","2022","COM","2020","346","6","352","2023-01-02"
"63281","2022","COM","2020","1057","19","1076","2023-01-02"
"63282","2022","COM","2020","1758","22","1780","2023-01-02"
"63283","2022","COM","2020","632","116","748","2023-01-02"
"63284","2022","COM","2020","12324","317","12641","2023-01-02"
"63285","2022","COM","2020","746","4","750","2023-01-02"
"63286","2022","COM","2020","267","3","270","2023-01-02"
"63287","2022","COM","2020","345","7","352","2023-01-02"
"63288","2022","COM","2020","458","12","470","2023-01-02"
"63289","2022","COM","2020","265","7","272","2023-01-02"
"63290","2022","COM","2020","402","8","410","2023-01-02"
"63291","2022","COM","2020","2735","48","2783","2023-01-02"
"63292","2022","COM","2020","145","3","148","2023-01-02"
"63293","2022","COM","2020","215","10","225","2023-01-02"
"63294","2022","COM","2020","288","5","293","2023-01-02"
"63295","2022","COM","2020","1618","14","1632","2023-01-02"
"63296","2022","COM","2020","783","14","797","2023-01-02"
"63297","2022","COM","2020","379","3","382","2023-01-02"
"63298","2022","COM","2020","128","4","132","2023-01-02"
"63299","2022","COM","2020","102","0","102","2023-01-02"
"63300","2022","COM","2020","18733","743","19476","2023-01-02"
"63301","2022","COM","2020","739","9","748","2023-01-02"
"63302","2022","COM","2020","3498","64","3562","2023-01-02"
"63303","2022","COM","2020","42","1","43","2023-01-02"
"63304","2022","COM","2020","110","0","110","2023-01-02"
"63305","2022","COM","2020","850","145","995","2023-01-02"
"63306","2022","COM","2020","624","13","637","2023-01-02"
"63307","2022","COM","2020","7833","154","7987","2023-01-02"
"63308","2022","COM","2020","4395","119","4514","2023-01-02"
"63309","2022","COM","2020","306","3","309","2023-01-02"
"63310","2022","COM","2020","170","3","173","2023-01-02"
"63311","2022","COM","2020","330","12","342","2023-01-02"
"63312","2022","COM","2020","141","3","144","2023-01-02"
"63313","2022","COM","2020","107","7","114","2023-01-02"
"63314","2022","COM","2020","513","14","527","2023-01-02"
"63315","2022","COM","2020","1752","38","1790","2023-01-02"
"63317","2022","COM","2020","535","2","537","2023-01-02"
"63318","2022","COM","2020","464","9","473","2023-01-02"
"63319","2022","COM","2020","707","23","730","2023-01-02"
"63320","2022","COM","2020","213","6","219","2023-01-02"
"63321","2022","COM","2020","933","16","949","2023-01-02"
"63322","2022","COM","2020","2214","28","2242","2023-01-02"
"63323","2022","COM","2020","169","4","173","2023-01-02"
"63324","2022","COM","2020","204","6","210","2023-01-02"
"63325","2022","COM","2020","420","6","426","2023-01-02"
"63326","2022","COM","2020","533","8","541","2023-01-02"
"63327","2022","COM","2020","2033","39","2072","2023-01-02"
"63328","2022","COM","2020","51","2","53","2023-01-02"
"63329","2022","COM","2020","127","5","132","2023-01-02"
"63330","2022","COM","2020","351","7","358","2023-01-02"
"63331","2022","COM","2020","233","6","239","2023-01-02"
"63332","2022","COM","2020","530","9","539","2023-01-02"
"63333","2022","COM","2020","236","3","239","2023-01-02"
"63334","2022","COM","2020","544","19","563","2023-01-02"
"63335","2022","COM","2020","530","16","546","2023-01-02"
"63336","2022","COM","2020","200","4","204","2023-01-02"
"63337","2022","COM","2020","64","1","65","2023-01-02"
"63338","2022","COM","2020","3492","144","3636","2023-01-02"
"63339","2022","COM","2020","130","2","132","2023-01-02"
"63340","2022","COM","2020","257","3","260","2023-01-02"
"63341","2022","COM","2020","549","16","565","2023-01-02"
"63342","2022","COM","2020","246","4","250","2023-01-02"
"63343","2022","COM","2020","277","6","283","2023-01-02"
"63344","2022","COM","2020","149","4","153","2023-01-02"
"63345","2022","COM","2020","3791","106","3897","2023-01-02"
"63346","2022","COM","2020","216","7","223","2023-01-02"
"63347","2022","COM","2020","461","18","479","2023-01-02"
"63348","2022","COM","2020","182","1","183","2023-01-02"
"63349","2022","COM","2020","1914","48","1962","2023-01-02"
"63350","2022","COM","2020","1307","18","1325","2023-01-02"
"63351","2022","COM","2020","66","2","68","2023-01-02"
"63352","2022","COM","2020","2012","42","2054","2023-01-02"
"63353","2022","COM","2020","485","30","515","2023-01-02"
"63354","2022","COM","2020","1239","163","1402","2023-01-02"
"63355","2022","COM","2020","218","4","222","2023-01-02"
"63356","2022","COM","2020","335","14","349","2023-01-02"
"63357","2022","COM","2020","114","4","118","2023-01-02"
"63358","2022","COM","2020","364","10","374","2023-01-02"
"63359","2022","COM","2020","86","0","86","2023-01-02"
"63360","2022","COM","2020","150","3","153","2023-01-02"
"63362","2022","COM","2020","921","15","936","2023-01-02"
"63363","2022","COM","2020","282","8","290","2023-01-02"
"63364","2022","COM","2020","675","15","690","2023-01-02"
"63365","2022","COM","2020","423","12","435","2023-01-02"
"63366","2022","COM","2020","352","2","354","2023-01-02"
"63367","2022","COM","2020","125","1","126","2023-01-02"
"63368","2022","COM","2020","1309","30","1339","2023-01-02"
"63369","2022","COM","2020","120","3","123","2023-01-02"
"63370","2022","COM","2020","368","5","373","2023-01-02"
"63371","2022","COM","2020","152","5","157","2023-01-02"
"63372","2022","COM","2020","667","7","674","2023-01-02"
"63373","2022","COM","2020","189","4","193","2023-01-02"
"63374","2022","COM","2020","295","3","298","2023-01-02"
"63375","2022","COM","2020","170","6","176","2023-01-02"
"63376","2022","COM","2020","147","6","153","2023-01-02"
"63377","2022","COM","2020","372","6","378","2023-01-02"
"63378","2022","COM","2020","963","9","972","2023-01-02"
"63379","2022","COM","2020","528","6","534","2023-01-02"
"63380","2022","COM","2020","765","3","768","2023-01-02"
"63381","2022","COM","2020","1665","23","1688","2023-01-02"
"63382","2022","COM","2020","406","13","419","2023-01-02"
"63383","2022","COM","2020","250","5","255","2023-01-02"
"63384","2022","COM","2020","134","5","139","2023-01-02"
"63385","2022","COM","2020","442","11","453","2023-01-02"
"63386","2022","COM","2020","494","6","500","2023-01-02"
"63387","2022","COM","2020","866","16","882","2023-01-02"
"63388","2022","COM","2020","703","16","719","2023-01-02"
"63389","2022","COM","2020","110","2","112","2023-01-02"
"63390","2022","COM","2020","386","13","399","2023-01-02"
"63391","2022","COM","2020","242","4","246","2023-01-02"
"63392","2022","COM","2020","595","7","602","2023-01-02"
"63393","2022","COM","2020","1753","33","1786","2023-01-02"
"63394","2022","COM","2020","204","6","210","2023-01-02"
"63395","2022","COM","2020","980","21","1001","2023-01-02"
"63396","2022","COM","2020","1160","62","1222","2023-01-02"
"63397","2022","COM","2020","1127","21","1148","2023-01-02"
"63398","2022","COM","2020","85","3","88","2023-01-02"
"63399","2022","COM","2020","84","4","88","2023-01-02"
"63400","2022","COM","2020","1069","23","1092","2023-01-02"
"63401","2022","COM","2020","249","7","256","2023-01-02"
"63402","2022","COM","2020","255","7","262","2023-01-02"
"63403","2022","COM","2020","416","11","427","2023-01-02"
"63404","2022","COM","2020","590","15","605","2023-01-02"
"63405","2022","COM","2020","582","13","595","2023-01-02"
"63406","2022","COM","2020","297","6","303","2023-01-02"
"63407","2022","COM","2020","284","7","291","2023-01-02"
"63408","2022","COM","2020","167","5","172","2023-01-02"
"63409","2022","COM","2020","269","0","269","2023-01-02"
"63410","2022","COM","2020","143","3","146","2023-01-02"
"63411","2022","COM","2020","472","15","487","2023-01-02"
"63412","2022","COM","2020","530","10","540","2023-01-02"
"63413","2022","COM","2020","706","11","717","2023-01-02"
"63414","2022","COM","2020","563","11","574","2023-01-02"
"63415","2022","COM","2020","1311","13","1324","2023-01-02"
"63416","2022","COM","2020","93","2","95","2023-01-02"
"63417","2022","COM","2020","2472","46","2518","2023-01-02"
"63418","2022","COM","2020","576","9","585","2023-01-02"
"63419","2022","COM","2020","557","12","569","2023-01-02"
"63420","2022","COM","2020","791","9","800","2023-01-02"
"63421","2022","COM","2020","157","4","161","2023-01-02"
"63422","2022","COM","2020","518","10","528","2023-01-02"
"63423","2022","COM","2020","601","8","609","2023-01-02"
"63424","2022","COM","2020","591","10","601","2023-01-02"
"63425","2022","COM","2020","1502","42","1544","2023-01-02"
"63426","2022","COM","2020","719","18","737","2023-01-02"
"63427","2022","COM","2020","493","16","509","2023-01-02"
"63428","2022","COM","2020","282","2","284","2023-01-02"
"63429","2022","COM","2020","29","2","31","2023-01-02"
"63430","2022","COM","2020","11470","371","11841","2023-01-02"
"63431","2022","COM","2020","162","1","163","2023-01-02"
"63432","2022","COM","2020","920","37","957","2023-01-02"
"63433","2022","COM","2020","76","3","79","2023-01-02"
"63434","2022","COM","2020","522","15","537","2023-01-02"
"63435","2022","COM","2020","200","6","206","2023-01-02"
"63436","2022","COM","2020","72","0","72","2023-01-02"
"63437","2022","COM","2020","153","5","158","2023-01-02"
"63438","2022","COM","2020","489","8","497","2023-01-02"
"63439","2022","COM","2020","301","2","303","2023-01-02"
"63440","2022","COM","2020","132","0","132","2023-01-02"
"63441","2022","COM","2020","215","4","219","2023-01-02"
"63442","2022","COM","2020","53","2","55","2023-01-02"
"63443","2022","COM","2020","424","12","436","2023-01-02"
"63444","2022","COM","2020","308","4","312","2023-01-02"
"63445","2022","COM","2020","300","4","304","2023-01-02"
"63446","2022","COM","2020","528","6","534","2023-01-02"
"63447","2022","COM","2020","66","5","71","2023-01-02"
"63448","2022","COM","2020","792","85","877","2023-01-02"
"63449","2022","COM","2020","311","8","319","2023-01-02"
"63450","2022","COM","2020","233","2","235","2023-01-02"
"63451","2022","COM","2020","417","17","434","2023-01-02"
"63452","2022","COM","2020","72","1","73","2023-01-02"
"63453","2022","COM","2020","3301","29","3330","2023-01-02"
"63454","2022","COM","2020","540","11","551","2023-01-02"
"63455","2022","COM","2020","3664","59","3723","2023-01-02"
"63456","2022","COM","2020","338","14","352","2023-01-02"
"63457","2022","COM","2020","5188","95","5283","2023-01-02"
"63458","2022","COM","2020","146","1","147","2023-01-02"
"63459","2022","COM","2020","519","5","524","2023-01-02"
"63460","2022","COM","2020","369","11","380","2023-01-02"
"63461","2022","COM","2020","363","3","366","2023-01-02"
"63462","2022","COM","2020","266","5","271","2023-01-02"
"63463","2022","COM","2020","511","9","520","2023-01-02"
"63464","2022","COM","2020","343","13","356","2023-01-02"
"63465","2022","COM","2020","418","9","427","2023-01-02"
"63466","2022","COM","2020","193","3","196","2023-01-02"
"63467","2022","COM","2020","39","2","41","2023-01-02"
"63468","2022","COM","2020","304","10","314","2023-01-02"
"63469","2022","COM","2020","715","17","732","2023-01-02"
"63470","2022","COM","2020","4702","76","4778","2023-01-02"
"63471","2022","COM","2020","895","19","914","2023-01-02"
"63472","2022","COM","2020","649","16","665","2023-01-02"
"63473","2022","COM","2020","393","7","400","2023-01-02"
"64001","2022","COM","2020","188","7","195","2023-01-02"
"64002","2022","COM","2020","165","1","166","2023-01-02"
"64003","2022","COM","2020","212","8","220","2023-01-02"
"64004","2022","COM","2020","107","1","108","2023-01-02"
"64005","2022","COM","2020","537","8","545","2023-01-02"
"64006","2022","COM","2020","459","12","471","2023-01-02"
"64007","2022","COM","2020","1039","27","1066","2023-01-02"
"64008","2022","COM","2020","266","9","275","2023-01-02"
"64009","2022","COM","2020","2027","30","2057","2023-01-02"
"64010","2022","COM","2020","678","23","701","2023-01-02"
"64011","2022","COM","2020","115","6","121","2023-01-02"
"64012","2022","COM","2020","133","4","137","2023-01-02"
"64013","2022","COM","2020","172","5","177","2023-01-02"
"64014","2022","COM","2020","668","7","675","2023-01-02"
"64015","2022","COM","2020","209","2","211","2023-01-02"
"64016","2022","COM","2020","324","6","330","2023-01-02"
"64017","2022","COM","2020","334","4","338","2023-01-02"
"64018","2022","COM","2020","455","9","464","2023-01-02"
"64019","2022","COM","2020","233","1","234","2023-01-02"
"64021","2022","COM","2020","675","23","698","2023-01-02"
"64022","2022","COM","2020","138","3","141","2023-01-02"
"64023","2022","COM","2020","908","23","931","2023-01-02"
"64024","2022","COM","2020","40310","1078","41388","2023-01-02"
"64025","2022","COM","2020","95","5","100","2023-01-02"
"64026","2022","COM","2020","376","11","387","2023-01-02"
"64027","2022","COM","2020","188","3","191","2023-01-02"
"64028","2022","COM","2020","132","2","134","2023-01-02"
"64029","2022","COM","2020","662","15","677","2023-01-02"
"64031","2022","COM","2020","177","3","180","2023-01-02"
"64032","2022","COM","2020","178","8","186","2023-01-02"
"64033","2022","COM","2020","133","1","134","2023-01-02"
"64034","2022","COM","2020","317","5","322","2023-01-02"
"64035","2022","COM","2020","2339","64","2403","2023-01-02"
"64036","2022","COM","2020","314","6","320","2023-01-02"
"64037","2022","COM","2020","1254","23","1277","2023-01-02"
"64038","2022","COM","2020","3326","68","3394","2023-01-02"
"64039","2022","COM","2020","245","8","253","2023-01-02"
"64040","2022","COM","2020","1071","33","1104","2023-01-02"
"64041","2022","COM","2020","796","13","809","2023-01-02"
"64042","2022","COM","2020","702","9","711","2023-01-02"
"64043","2022","COM","2020","296","4","300","2023-01-02"
"64044","2022","COM","2020","79","1","80","2023-01-02"
"64045","2022","COM","2020","74","0","74","2023-01-02"
"64046","2022","COM","2020","390","5","395","2023-01-02"
"64047","2022","COM","2020","237","2","239","2023-01-02"
"64048","2022","COM","2020","134","1","135","2023-01-02"
"64049","2022","COM","2020","231","8","239","2023-01-02"
"64050","2022","COM","2020","94","3","97","2023-01-02"
"64051","2022","COM","2020","417","5","422","2023-01-02"
"64052","2022","COM","2020","107","4","111","2023-01-02"
"64053","2022","COM","2020","192","3","195","2023-01-02"
"64054","2022","COM","2020","783","19","802","2023-01-02"
"64056","2022","COM","2020","138","9","147","2023-01-02"
"64057","2022","COM","2020","1829","41","1870","2023-01-02"
"64058","2022","COM","2020","464","10","474","2023-01-02"
"64059","2022","COM","2020","1077","28","1105","2023-01-02"
"64060","2022","COM","2020","1982","55","2037","2023-01-02"
"64061","2022","COM","2020","3434","62","3496","2023-01-02"
"64062","2022","COM","2020","2253","47","2300","2023-01-02"
"64063","2022","COM","2020","1054","20","1074","2023-01-02"
"64064","2022","COM","2020","445","9","454","2023-01-02"
"64065","2022","COM","2020","4368","115","4483","2023-01-02"
"64066","2022","COM","2020","334","10","344","2023-01-02"
"64067","2022","COM","2020","2025","48","2073","2023-01-02"
"64068","2022","COM","2020","1998","49","2047","2023-01-02"
"64069","2022","COM","2020","230","6","236","2023-01-02"
"64070","2022","COM","2020","321","2","323","2023-01-02"
"64071","2022","COM","2020","210","3","213","2023-01-02"
"64072","2022","COM","2020","649","14","663","2023-01-02"
"64073","2022","COM","2020","264","5","269","2023-01-02"
"64074","2022","COM","2020","44","1","45","2023-01-02"
"64075","2022","COM","2020","165","1","166","2023-01-02"
"64077","2022","COM","2020","176","3","179","2023-01-02"
"64078","2022","COM","2020","226","6","232","2023-01-02"
"64079","2022","COM","2020","101","3","104","2023-01-02"
"64080","2022","COM","2020","805","24","829","2023-01-02"
"64081","2022","COM","2020","238","3","241","2023-01-02"
"64082","2022","COM","2020","141","3","144","2023-01-02"
"64083","2022","COM","2020","201","3","204","2023-01-02"
"64084","2022","COM","2020","141","2","143","2023-01-02"
"64085","2022","COM","2020","106","1","107","2023-01-02"
"64086","2022","COM","2020","1120","34","1154","2023-01-02"
"64087","2022","COM","2020","866","21","887","2023-01-02"
"64088","2022","COM","2020","305","9","314","2023-01-02"
"64089","2022","COM","2020","139","4","143","2023-01-02"
"64090","2022","COM","2020","120","2","122","2023-01-02"
"64091","2022","COM","2020","503","7","510","2023-01-02"
"64092","2022","COM","2020","348","7","355","2023-01-02"
"64093","2022","COM","2020","640","5","645","2023-01-02"
"64094","2022","COM","2020","1838","48","1886","2023-01-02"
"64095","2022","COM","2020","592","12","604","2023-01-02"
"64096","2022","COM","2020","179","2","181","2023-01-02"
"64097","2022","COM","2020","618","11","629","2023-01-02"
"64098","2022","COM","2020","65","2","67","2023-01-02"
"64099","2022","COM","2020","97","4","101","2023-01-02"
"64100","2022","COM","2020","3261","95","3356","2023-01-02"
"64101","2022","COM","2020","575","108","683","2023-01-02"
"64102","2022","COM","2020","52006","1290","53296","2023-01-02"
"64103","2022","COM","2020","207","3","210","2023-01-02"
"64104","2022","COM","2020","592","13","605","2023-01-02"
"64105","2022","COM","2020","269","12","281","2023-01-02"
"64106","2022","COM","2020","514","10","524","2023-01-02"
"64107","2022","COM","2020","71","3","74","2023-01-02"
"64108","2022","COM","2020","913","10","923","2023-01-02"
"64109","2022","COM","2020","1951","44","1995","2023-01-02"
"64110","2022","COM","2020","221","2","223","2023-01-02"
"64111","2022","COM","2020","109","3","112","2023-01-02"
"64112","2022","COM","2020","423","4","427","2023-01-02"
"64113","2022","COM","2020","116","7","123","2023-01-02"
"64114","2022","COM","2020","586","2","588","2023-01-02"
"64115","2022","COM","2020","160","67","227","2023-01-02"
"64116","2022","COM","2020","245","5","250","2023-01-02"
"64117","2022","COM","2020","145","4","149","2023-01-02"
"64118","2022","COM","2020","50","0","50","2023-01-02"
"64119","2022","COM","2020","674","11","685","2023-01-02"
"64120","2022","COM","2020","538","11","549","2023-01-02"
"64121","2022","COM","2020","191","2","193","2023-01-02"
"64122","2022","COM","2020","25885","698","26583","2023-01-02"
"64123","2022","COM","2020","1353","25","1378","2023-01-02"
"64124","2022","COM","2020","662","15","677","2023-01-02"
"64125","2022","COM","2020","7224","130","7354","2023-01-02"
"64126","2022","COM","2020","1109","33","1142","2023-01-02"
"64127","2022","COM","2020","390","14","404","2023-01-02"
"64128","2022","COM","2020","159","5","164","2023-01-02"
"64129","2022","COM","2020","13229","220","13449","2023-01-02"
"64130","2022","COM","2020","1231","20","1251","2023-01-02"
"64131","2022","COM","2020","617","21","638","2023-01-02"
"64132","2022","COM","2020","4522","125","4647","2023-01-02"
"64133","2022","COM","2020","1342","23","1365","2023-01-02"
"64134","2022","COM","2020","369","7","376","2023-01-02"
"64135","2022","COM","2020","813","14","827","2023-01-02"
"64136","2022","COM","2020","129","2","131","2023-01-02"
"64137","2022","COM","2020","673","20","693","2023-01-02"
"64138","2022","COM","2020","2888","51","2939","2023-01-02"
"64139","2022","COM","2020","976","23","999","2023-01-02"
"64140","2022","COM","2020","8764","171","8935","2023-01-02"
"64141","2022","COM","2020","386","9","395","2023-01-02"
"64142","2022","COM","2020","835","27","862","2023-01-02"
"64143","2022","COM","2020","157","0","157","2023-01-02"
"64144","2022","COM","2020","167","2","169","2023-01-02"
"64145","2022","COM","2020","512","8","520","2023-01-02"
"64146","2022","COM","2020","337","4","341","2023-01-02"
"64147","2022","COM","2020","2882","45","2927","2023-01-02"
"64148","2022","COM","2020","862","25","887","2023-01-02"
"64149","2022","COM","2020","245","6","251","2023-01-02"
"64150","2022","COM","2020","133","2","135","2023-01-02"
"64151","2022","COM","2020","99","5","104","2023-01-02"
"64152","2022","COM","2020","1940","54","1994","2023-01-02"
"64153","2022","COM","2020","72","1","73","2023-01-02"
"64154","2022","COM","2020","208","2","210","2023-01-02"
"64155","2022","COM","2020","105","1","106","2023-01-02"
"64156","2022","COM","2020","474","14","488","2023-01-02"
"64157","2022","COM","2020","996","21","1017","2023-01-02"
"64158","2022","COM","2020","173","7","180","2023-01-02"
"64159","2022","COM","2020","119","4","123","2023-01-02"
"64160","2022","COM","2020","6623","108","6731","2023-01-02"
"64161","2022","COM","2020","1017","20","1037","2023-01-02"
"64162","2022","COM","2020","101","3","104","2023-01-02"
"64165","2022","COM","2020","299","10","309","2023-01-02"
"64166","2022","COM","2020","187","9","196","2023-01-02"
"64167","2022","COM","2020","217","2","219","2023-01-02"
"64168","2022","COM","2020","664","15","679","2023-01-02"
"64170","2022","COM","2020","201","1","202","2023-01-02"
"64171","2022","COM","2020","266","2","268","2023-01-02"
"64172","2022","COM","2020","312","3","315","2023-01-02"
"64173","2022","COM","2020","161","1","162","2023-01-02"
"64174","2022","COM","2020","51","1","52","2023-01-02"
"64175","2022","COM","2020","150","4","154","2023-01-02"
"64176","2022","COM","2020","159","3","162","2023-01-02"
"64177","2022","COM","2020","636","26","662","2023-01-02"
"64178","2022","COM","2020","463","15","478","2023-01-02"
"64179","2022","COM","2020","134","6","140","2023-01-02"
"64180","2022","COM","2020","209","5","214","2023-01-02"
"64181","2022","COM","2020","335","4","339","2023-01-02"
"64182","2022","COM","2020","71","2","73","2023-01-02"
"64183","2022","COM","2020","626","19","645","2023-01-02"
"64184","2022","COM","2020","619","28","647","2023-01-02"
"64185","2022","COM","2020","60","1","61","2023-01-02"
"64186","2022","COM","2020","218","3","221","2023-01-02"
"64187","2022","COM","2020","251","8","259","2023-01-02"
"64188","2022","COM","2020","1067","158","1225","2023-01-02"
"64189","2022","COM","2020","6109","132","6241","2023-01-02"
"64190","2022","COM","2020","240","9","249","2023-01-02"
"64191","2022","COM","2020","2168","141","2309","2023-01-02"
"64192","2022","COM","2020","111","0","111","2023-01-02"
"64193","2022","COM","2020","97","2","99","2023-01-02"
"64194","2022","COM","2020","376","10","386","2023-01-02"
"64195","2022","COM","2020","92","2","94","2023-01-02"
"64196","2022","COM","2020","120","3","123","2023-01-02"
"64197","2022","COM","2020","189","5","194","2023-01-02"
"64198","2022","COM","2020","1775","50","1825","2023-01-02"
"64199","2022","COM","2020","141","4","145","2023-01-02"
"64200","2022","COM","2020","178","3","181","2023-01-02"
"64201","2022","COM","2020","229","8","237","2023-01-02"
"64202","2022","COM","2020","464","13","477","2023-01-02"
"64203","2022","COM","2020","322","6","328","2023-01-02"
"64204","2022","COM","2020","191","3","194","2023-01-02"
"64205","2022","COM","2020","237","2","239","2023-01-02"
"64206","2022","COM","2020","122","1","123","2023-01-02"
"64207","2022","COM","2020","428","12","440","2023-01-02"
"64208","2022","COM","2020","427","8","435","2023-01-02"
"64209","2022","COM","2020","435","8","443","2023-01-02"
"64210","2022","COM","2020","143","1","144","2023-01-02"
"64211","2022","COM","2020","369","4","373","2023-01-02"
"64212","2022","COM","2020","141","2","143","2023-01-02"
"64213","2022","COM","2020","2036","48","2084","2023-01-02"
"64214","2022","COM","2020","490","15","505","2023-01-02"
"64215","2022","COM","2020","104","3","107","2023-01-02"
"64216","2022","COM","2020","1195","47","1242","2023-01-02"
"64217","2022","COM","2020","536","12","548","2023-01-02"
"64218","2022","COM","2020","319","2","321","2023-01-02"
"64219","2022","COM","2020","259","6","265","2023-01-02"
"64220","2022","COM","2020","495","11","506","2023-01-02"
"64221","2022","COM","2020","154","29","183","2023-01-02"
"64222","2022","COM","2020","75","0","75","2023-01-02"
"64223","2022","COM","2020","55","2","57","2023-01-02"
"64224","2022","COM","2020","632","18","650","2023-01-02"
"64225","2022","COM","2020","615","14","629","2023-01-02"
"64226","2022","COM","2020","186","2","188","2023-01-02"
"64227","2022","COM","2020","667","14","681","2023-01-02"
"64228","2022","COM","2020","273","2","275","2023-01-02"
"64229","2022","COM","2020","130","5","135","2023-01-02"
"64230","2022","COM","2020","5594","111","5705","2023-01-02"
"64231","2022","COM","2020","485","9","494","2023-01-02"
"64232","2022","COM","2020","220","2","222","2023-01-02"
"64233","2022","COM","2020","1351","24","1375","2023-01-02"
"64234","2022","COM","2020","264","8","272","2023-01-02"
"64235","2022","COM","2020","293","7","300","2023-01-02"
"64236","2022","COM","2020","55","1","56","2023-01-02"
"64237","2022","COM","2020","3639","129","3768","2023-01-02"
"64238","2022","COM","2020","2004","52","2056","2023-01-02"
"64239","2022","COM","2020","138","1","139","2023-01-02"
"64240","2022","COM","2020","179","7","186","2023-01-02"
"64241","2022","COM","2020","478","9","487","2023-01-02"
"64242","2022","COM","2020","76","0","76","2023-01-02"
"64243","2022","COM","2020","203","3","206","2023-01-02"
"64244","2022","COM","2020","259","10","269","2023-01-02"
"64245","2022","COM","2020","552","13","565","2023-01-02"
"64246","2022","COM","2020","301","7","308","2023-01-02"
"64247","2022","COM","2020","472","13","485","2023-01-02"
"64249","2022","COM","2020","1328","37","1365","2023-01-02"
"64250","2022","COM","2020","1006","31","1037","2023-01-02"
"64251","2022","COM","2020","222","9","231","2023-01-02"
"64252","2022","COM","2020","878","27","905","2023-01-02"
"64253","2022","COM","2020","417","10","427","2023-01-02"
"64254","2022","COM","2020","578","17","595","2023-01-02"
"64255","2022","COM","2020","637","6","643","2023-01-02"
"64256","2022","COM","2020","7538","270","7808","2023-01-02"
"64257","2022","COM","2020","341","3","344","2023-01-02"
"64258","2022","COM","2020","85","1","86","2023-01-02"
"64259","2022","COM","2020","747","16","763","2023-01-02"
"64260","2022","COM","2020","17621","450","18071","2023-01-02"
"64261","2022","COM","2020","389","6","395","2023-01-02"
"64262","2022","COM","2020","276","6","282","2023-01-02"
"64263","2022","COM","2020","128","4","132","2023-01-02"
"64264","2022","COM","2020","59","2","61","2023-01-02"
"64265","2022","COM","2020","100","0","100","2023-01-02"
"64266","2022","COM","2020","231","9","240","2023-01-02"
"64267","2022","COM","2020","75","1","76","2023-01-02"
"64268","2022","COM","2020","275","4","279","2023-01-02"
"64269","2022","COM","2020","4915","163","5078","2023-01-02"
"64270","2022","COM","2020","986","49","1035","2023-01-02"
"64271","2022","COM","2020","538","17","555","2023-01-02"
"64272","2022","COM","2020","147","1","148","2023-01-02"
"64273","2022","COM","2020","921","13","934","2023-01-02"
"64274","2022","COM","2020","367","2","369","2023-01-02"
"64275","2022","COM","2020","674","13","687","2023-01-02"
"64276","2022","COM","2020","236","6","242","2023-01-02"
"64277","2022","COM","2020","518","13","531","2023-01-02"
"64279","2022","COM","2020","2163","67","2230","2023-01-02"
"64280","2022","COM","2020","435","3","438","2023-01-02"
"64281","2022","COM","2020","146","3","149","2023-01-02"
"64282","2022","COM","2020","1176","30","1206","2023-01-02"
"64283","2022","COM","2020","201","1","202","2023-01-02"
"64284","2022","COM","2020","7083","237","7320","2023-01-02"
"64285","2022","COM","2020","204","8","212","2023-01-02"
"64286","2022","COM","2020","437","13","450","2023-01-02"
"64287","2022","COM","2020","139","3","142","2023-01-02"
"64288","2022","COM","2020","557","14","571","2023-01-02"
"64289","2022","COM","2020","969","24","993","2023-01-02"
"64290","2022","COM","2020","599","17","616","2023-01-02"
"64291","2022","COM","2020","318","6","324","2023-01-02"
"64292","2022","COM","2020","260","2","262","2023-01-02"
"64293","2022","COM","2020","169","2","171","2023-01-02"
"64294","2022","COM","2020","154","2","156","2023-01-02"
"64295","2022","COM","2020","111","3","114","2023-01-02"
"64296","2022","COM","2020","148","5","153","2023-01-02"
"64297","2022","COM","2020","179","4","183","2023-01-02"
"64298","2022","COM","2020","131","0","131","2023-01-02"
"64299","2022","COM","2020","183","7","190","2023-01-02"
"64300","2022","COM","2020","729","14","743","2023-01-02"
"64301","2022","COM","2020","1140","30","1170","2023-01-02"
"64302","2022","COM","2020","465","11","476","2023-01-02"
"64303","2022","COM","2020","156","8","164","2023-01-02"
"64304","2022","COM","2020","2549","57","2606","2023-01-02"
"64305","2022","COM","2020","522","12","534","2023-01-02"
"64306","2022","COM","2020","702","20","722","2023-01-02"
"64307","2022","COM","2020","206","3","209","2023-01-02"
"64308","2022","COM","2020","262","5","267","2023-01-02"
"64309","2022","COM","2020","208","5","213","2023-01-02"
"64310","2022","COM","2020","489","8","497","2023-01-02"
"64311","2022","COM","2020","152","3","155","2023-01-02"
"64312","2022","COM","2020","304","9","313","2023-01-02"
"64313","2022","COM","2020","280","5","285","2023-01-02"
"64314","2022","COM","2020","441","3","444","2023-01-02"
"64315","2022","COM","2020","1088","29","1117","2023-01-02"
"64316","2022","COM","2020","194","2","196","2023-01-02"
"64317","2022","COM","2020","2134","51","2185","2023-01-02"
"64318","2022","COM","2020","185","2","187","2023-01-02"
"64319","2022","COM","2020","181","0","181","2023-01-02"
"64320","2022","COM","2020","1181","24","1205","2023-01-02"
"64321","2022","COM","2020","244","2","246","2023-01-02"
"64322","2022","COM","2020","342","6","348","2023-01-02"
"64323","2022","COM","2020","109","3","112","2023-01-02"
"64324","2022","COM","2020","1746","51","1797","2023-01-02"
"64325","2022","COM","2020","209","4","213","2023-01-02"
"64326","2022","COM","2020","119","4","123","2023-01-02"
"64327","2022","COM","2020","170","5","175","2023-01-02"
"64328","2022","COM","2020","1025","31","1056","2023-01-02"
"64329","2022","COM","2020","1257","60","1317","2023-01-02"
"64330","2022","COM","2020","242","9","251","2023-01-02"
"64331","2022","COM","2020","768","17","785","2023-01-02"
"64332","2022","COM","2020","166","5","171","2023-01-02"
"64334","2022","COM","2020","214","3","217","2023-01-02"
"64335","2022","COM","2020","9590","417","10007","2023-01-02"
"64336","2022","COM","2020","169","1","170","2023-01-02"
"64337","2022","COM","2020","152","3","155","2023-01-02"
"64338","2022","COM","2020","188","6","194","2023-01-02"
"64339","2022","COM","2020","821","81","902","2023-01-02"
"64340","2022","COM","2020","86","1","87","2023-01-02"
"64341","2022","COM","2020","136","1","137","2023-01-02"
"64342","2022","COM","2020","198","7","205","2023-01-02"
"64343","2022","COM","2020","743","8","751","2023-01-02"
"64344","2022","COM","2020","374","15","389","2023-01-02"
"64345","2022","COM","2020","200","5","205","2023-01-02"
"64346","2022","COM","2020","209","1","210","2023-01-02"
"64347","2022","COM","2020","213","3","216","2023-01-02"
"64348","2022","COM","2020","13843","278","14121","2023-01-02"
"64349","2022","COM","2020","497","18","515","2023-01-02"
"64350","2022","COM","2020","864","19","883","2023-01-02"
"64351","2022","COM","2020","134","9","143","2023-01-02"
"64352","2022","COM","2020","405","11","416","2023-01-02"
"64353","2022","COM","2020","1052","40","1092","2023-01-02"
"64354","2022","COM","2020","124","1","125","2023-01-02"
"64355","2022","COM","2020","138","2","140","2023-01-02"
"64356","2022","COM","2020","109","0","109","2023-01-02"
"64357","2022","COM","2020","63","0","63","2023-01-02"
"64358","2022","COM","2020","249","2","251","2023-01-02"
"64359","2022","COM","2020","921","30","951","2023-01-02"
"64360","2022","COM","2020","196","8","204","2023-01-02"
"64361","2022","COM","2020","182","7","189","2023-01-02"
"64362","2022","COM","2020","412","23","435","2023-01-02"
"64363","2022","COM","2020","325","3","328","2023-01-02"
"64364","2022","COM","2020","582","10","592","2023-01-02"
"64365","2022","COM","2020","420","8","428","2023-01-02"
"64366","2022","COM","2020","120","1","121","2023-01-02"
"64367","2022","COM","2020","881","25","906","2023-01-02"
"64368","2022","COM","2020","253","8","261","2023-01-02"
"64369","2022","COM","2020","244","11","255","2023-01-02"
"64370","2022","COM","2020","566","16","582","2023-01-02"
"64371","2022","COM","2020","2953","236","3189","2023-01-02"
"64372","2022","COM","2020","91","1","92","2023-01-02"
"64373","2022","COM","2020","1817","41","1858","2023-01-02"
"64374","2022","COM","2020","1155","24","1179","2023-01-02"
"64375","2022","COM","2020","284","4","288","2023-01-02"
"64376","2022","COM","2020","935","26","961","2023-01-02"
"64377","2022","COM","2020","836","24","860","2023-01-02"
"64378","2022","COM","2020","204","128","332","2023-01-02"
"64379","2022","COM","2020","156","5","161","2023-01-02"
"64380","2022","COM","2020","233","5","238","2023-01-02"
"64381","2022","COM","2020","279","9","288","2023-01-02"
"64382","2022","COM","2020","334","9","343","2023-01-02"
"64383","2022","COM","2020","137","1","138","2023-01-02"
"64385","2022","COM","2020","277","7","284","2023-01-02"
"64386","2022","COM","2020","1250","25","1275","2023-01-02"
"64387","2022","COM","2020","627","12","639","2023-01-02"
"64388","2022","COM","2020","114","1","115","2023-01-02"
"64389","2022","COM","2020","369","6","375","2023-01-02"
"64390","2022","COM","2020","157","12","169","2023-01-02"
"64391","2022","COM","2020","300","9","309","2023-01-02"
"64392","2022","COM","2020","81","2","83","2023-01-02"
"64393","2022","COM","2020","4417","103","4520","2023-01-02"
"64394","2022","COM","2020","84","2","86","2023-01-02"
"64395","2022","COM","2020","127","1","128","2023-01-02"
"64396","2022","COM","2020","1131","94","1225","2023-01-02"
"64397","2022","COM","2020","119","6","125","2023-01-02"
"64398","2022","COM","2020","433","9","442","2023-01-02"
"64399","2022","COM","2020","2340","304","2644","2023-01-02"
"64400","2022","COM","2020","1109","45","1154","2023-01-02"
"64401","2022","COM","2020","81","1","82","2023-01-02"
"64403","2022","COM","2020","176","3","179","2023-01-02"
"64404","2022","COM","2020","311","8","319","2023-01-02"
"64405","2022","COM","2020","4353","234","4587","2023-01-02"
"64406","2022","COM","2020","614","16","630","2023-01-02"
"64407","2022","COM","2020","5299","149","5448","2023-01-02"
"64408","2022","COM","2020","62","0","62","2023-01-02"
"64409","2022","COM","2020","826","22","848","2023-01-02"
"64410","2022","COM","2020","5903","172","6075","2023-01-02"
"64411","2022","COM","2020","234","3","237","2023-01-02"
"64412","2022","COM","2020","88","1","89","2023-01-02"
"64413","2022","COM","2020","765","12","777","2023-01-02"
"64414","2022","COM","2020","116","4","120","2023-01-02"
"64415","2022","COM","2020","1523","33","1556","2023-01-02"
"64416","2022","COM","2020","1053","23","1076","2023-01-02"
"64417","2022","COM","2020","3245","219","3464","2023-01-02"
"64418","2022","COM","2020","137","3","140","2023-01-02"
"64419","2022","COM","2020","1596","30","1626","2023-01-02"
"64420","2022","COM","2020","245","5","250","2023-01-02"
"64421","2022","COM","2020","1275","29","1304","2023-01-02"
"64422","2022","COM","2020","10653","656","11309","2023-01-02"
"64423","2022","COM","2020","184","3","187","2023-01-02"
"64424","2022","COM","2020","543","4","547","2023-01-02"
"64425","2022","COM","2020","490","9","499","2023-01-02"
"64426","2022","COM","2020","262","11","273","2023-01-02"
"64427","2022","COM","2020","150","2","152","2023-01-02"
"64428","2022","COM","2020","143","1","144","2023-01-02"
"64429","2022","COM","2020","110","2","112","2023-01-02"
"64430","2022","COM","2020","10466","640","11106","2023-01-02"
"64431","2022","COM","2020","537","9","546","2023-01-02"
"64432","2022","COM","2020","86","1","87","2023-01-02"
"64433","2022","COM","2020","333","19","352","2023-01-02"
"64434","2022","COM","2020","49","0","49","2023-01-02"
"64435","2022","COM","2020","214","10","224","2023-01-02"
"64436","2022","COM","2020","837","18","855","2023-01-02"
"64437","2022","COM","2020","205","7","212","2023-01-02"
"64438","2022","COM","2020","545","15","560","2023-01-02"
"64439","2022","COM","2020","1672","51","1723","2023-01-02"
"64440","2022","COM","2020","389","17","406","2023-01-02"
"64441","2022","COM","2020","261","5","266","2023-01-02"
"64442","2022","COM","2020","330","7","337","2023-01-02"
"64443","2022","COM","2020","898","24","922","2023-01-02"
"64444","2022","COM","2020","468","11","479","2023-01-02"
"64445","2022","COM","2020","75665","1396","77061","2023-01-02"
"64446","2022","COM","2020","159","1","160","2023-01-02"
"64447","2022","COM","2020","140","1","141","2023-01-02"
"64448","2022","COM","2020","1818","50","1868","2023-01-02"
"64449","2022","COM","2020","163","2","165","2023-01-02"
"64450","2022","COM","2020","297","4","301","2023-01-02"
"64451","2022","COM","2020","97","3","100","2023-01-02"
"64452","2022","COM","2020","259","7","266","2023-01-02"
"64453","2022","COM","2020","2921","57","2978","2023-01-02"
"64454","2022","COM","2020","187","2","189","2023-01-02"
"64455","2022","COM","2020","165","3","168","2023-01-02"
"64456","2022","COM","2020","49","3","52","2023-01-02"
"64457","2022","COM","2020","185","5","190","2023-01-02"
"64458","2022","COM","2020","295","8","303","2023-01-02"
"64459","2022","COM","2020","176","2","178","2023-01-02"
"64460","2022","COM","2020","400","7","407","2023-01-02"
"64461","2022","COM","2020","1108","22","1130","2023-01-02"
"64462","2022","COM","2020","491","6","497","2023-01-02"
"64463","2022","COM","2020","653","6","659","2023-01-02"
"64464","2022","COM","2020","82","1","83","2023-01-02"
"64465","2022","COM","2020","228","1","229","2023-01-02"
"64466","2022","COM","2020","270","7","277","2023-01-02"
"64467","2022","COM","2020","855","17","872","2023-01-02"
"64468","2022","COM","2020","121","2","123","2023-01-02"
"64469","2022","COM","2020","308","8","316","2023-01-02"
"64470","2022","COM","2020","640","11","651","2023-01-02"
"64471","2022","COM","2020","358","12","370","2023-01-02"
"64472","2022","COM","2020","855","11","866","2023-01-02"
"64473","2022","COM","2020","360","4","364","2023-01-02"
"64474","2022","COM","2020","157","3","160","2023-01-02"
"64475","2022","COM","2020","187","4","191","2023-01-02"
"64476","2022","COM","2020","421","8","429","2023-01-02"
"64477","2022","COM","2020","1499","33","1532","2023-01-02"
"64478","2022","COM","2020","743","25","768","2023-01-02"
"64479","2022","COM","2020","166","4","170","2023-01-02"
"64480","2022","COM","2020","198","5","203","2023-01-02"
"64481","2022","COM","2020","232","4","236","2023-01-02"
"64482","2022","COM","2020","617","8","625","2023-01-02"
"64483","2022","COM","2020","14282","420","14702","2023-01-02"
"64484","2022","COM","2020","831","18","849","2023-01-02"
"64485","2022","COM","2020","1510","300","1810","2023-01-02"
"64486","2022","COM","2020","64","0","64","2023-01-02"
"64487","2022","COM","2020","201","6","207","2023-01-02"
"64488","2022","COM","2020","446","9","455","2023-01-02"
"64489","2022","COM","2020","341","10","351","2023-01-02"
"64490","2022","COM","2020","541","15","556","2023-01-02"
"64491","2022","COM","2020","199","6","205","2023-01-02"
"64492","2022","COM","2020","291","6","297","2023-01-02"
"64493","2022","COM","2020","1948","75","2023","2023-01-02"
"64494","2022","COM","2020","261","6","267","2023-01-02"
"64495","2022","COM","2020","7102","185","7287","2023-01-02"
"64496","2022","COM","2020","5814","103","5917","2023-01-02"
"64498","2022","COM","2020","393","10","403","2023-01-02"
"64499","2022","COM","2020","4555","129","4684","2023-01-02"
"64500","2022","COM","2020","302","7","309","2023-01-02"
"64501","2022","COM","2020","569","8","577","2023-01-02"
"64502","2022","COM","2020","707","22","729","2023-01-02"
"64503","2022","COM","2020","92","3","95","2023-01-02"
"64504","2022","COM","2020","2705","37","2742","2023-01-02"
"64505","2022","COM","2020","296","13","309","2023-01-02"
"64506","2022","COM","2020","159","2","161","2023-01-02"
"64507","2022","COM","2020","137","3","140","2023-01-02"
"64508","2022","COM","2020","130","3","133","2023-01-02"
"64509","2022","COM","2020","173","4","177","2023-01-02"
"64510","2022","COM","2020","946","19","965","2023-01-02"
"64511","2022","COM","2020","3460","87","3547","2023-01-02"
"64512","2022","COM","2020","267","4","271","2023-01-02"
"64513","2022","COM","2020","1369","98","1467","2023-01-02"
"64514","2022","COM","2020","201","0","201","2023-01-02"
"64515","2022","COM","2020","240","5","245","2023-01-02"
"64516","2022","COM","2020","383","3","386","2023-01-02"
"64517","2022","COM","2020","159","9","168","2023-01-02"
"64518","2022","COM","2020","1126","22","1148","2023-01-02"
"64519","2022","COM","2020","4393","126","4519","2023-01-02"
"64520","2022","COM","2020","827","33","860","2023-01-02"
"64521","2022","COM","2020","561","17","578","2023-01-02"
"64522","2022","COM","2020","544","10","554","2023-01-02"
"64523","2022","COM","2020","778","15","793","2023-01-02"
"64524","2022","COM","2020","418","3","421","2023-01-02"
"64525","2022","COM","2020","804","10","814","2023-01-02"
"64526","2022","COM","2020","1584","19","1603","2023-01-02"
"64527","2022","COM","2020","1523","28","1551","2023-01-02"
"64528","2022","COM","2020","166","8","174","2023-01-02"
"64529","2022","COM","2020","375","10","385","2023-01-02"
"64530","2022","COM","2020","357","7","364","2023-01-02"
"64531","2022","COM","2020","46","0","46","2023-01-02"
"64532","2022","COM","2020","71","1","72","2023-01-02"
"64533","2022","COM","2020","566","10","576","2023-01-02"
"64534","2022","COM","2020","184","3","187","2023-01-02"
"64535","2022","COM","2020","532","6","538","2023-01-02"
"64536","2022","COM","2020","872","16","888","2023-01-02"
"64537","2022","COM","2020","127","4","131","2023-01-02"
"64538","2022","COM","2020","801","16","817","2023-01-02"
"64539","2022","COM","2020","212","5","217","2023-01-02"
"64540","2022","COM","2020","2845","75","2920","2023-01-02"
"64541","2022","COM","2020","308","2","310","2023-01-02"
"64542","2022","COM","2020","67","1","68","2023-01-02"
"64543","2022","COM","2020","276","7","283","2023-01-02"
"64544","2022","COM","2020","76","2","78","2023-01-02"
"64545","2022","COM","2020","10495","161","10656","2023-01-02"
"64546","2022","COM","2020","2340","34","2374","2023-01-02"
"64547","2022","COM","2020","7399","274","7673","2023-01-02"
"64548","2022","COM","2020","164","4","168","2023-01-02"
"64549","2022","COM","2020","1258","20","1278","2023-01-02"
"64550","2022","COM","2020","825","33","858","2023-01-02"
"64551","2022","COM","2020","291","4","295","2023-01-02"
"64552","2022","COM","2020","173","8","181","2023-01-02"
"64554","2022","COM","2020","214","3","217","2023-01-02"
"64555","2022","COM","2020","169","2","171","2023-01-02"
"64556","2022","COM","2020","386","8","394","2023-01-02"
"64557","2022","COM","2020","451","21","472","2023-01-02"
"64558","2022","COM","2020","2836","78","2914","2023-01-02"
"64559","2022","COM","2020","736","17","753","2023-01-02"
"64560","2022","COM","2020","177","0","177","2023-01-02"
"65001","2022","COM","2020","298","7","305","2023-01-02"
"65002","2022","COM","2020","826","10","836","2023-01-02"
"65003","2022","COM","2020","147","1","148","2023-01-02"
"65004","2022","COM","2020","406","10","416","2023-01-02"
"65005","2022","COM","2020","435","11","446","2023-01-02"
"65006","2022","COM","2020","268","8","276","2023-01-02"
"65007","2022","COM","2020","1371","26","1397","2023-01-02"
"65009","2022","COM","2020","171","6","177","2023-01-02"
"65010","2022","COM","2020","222","4","226","2023-01-02"
"65011","2022","COM","2020","131","5","136","2023-01-02"
"65012","2022","COM","2020","78","2","80","2023-01-02"
"65013","2022","COM","2020","57","2","59","2023-01-02"
"65014","2022","COM","2020","40","0","40","2023-01-02"
"65015","2022","COM","2020","101","5","106","2023-01-02"
"65016","2022","COM","2020","184","3","187","2023-01-02"
"65017","2022","COM","2020","249","2","251","2023-01-02"
"65018","2022","COM","2020","82","1","83","2023-01-02"
"65019","2022","COM","2020","572","12","584","2023-01-02"
"65020","2022","COM","2020","264","5","269","2023-01-02"
"65021","2022","COM","2020","389","8","397","2023-01-02"
"65022","2022","COM","2020","114","7","121","2023-01-02"
"65023","2022","COM","2020","12","0","12","2023-01-02"
"65024","2022","COM","2020","103","2","105","2023-01-02"
"65025","2022","COM","2020","2897","172","3069","2023-01-02"
"65026","2022","COM","2020","76","0","76","2023-01-02"
"65028","2022","COM","2020","198","8","206","2023-01-02"
"65029","2022","COM","2020","488","11","499","2023-01-02"
"65031","2022","COM","2020","772","16","788","2023-01-02"
"65032","2022","COM","2020","687","20","707","2023-01-02"
"65033","2022","COM","2020","115","3","118","2023-01-02"
"65034","2022","COM","2020","21","1","22","2023-01-02"
"65035","2022","COM","2020","515","18","533","2023-01-02"
"65036","2022","COM","2020","131","3","134","2023-01-02"
"65037","2022","COM","2020","87","1","88","2023-01-02"
"65038","2022","COM","2020","14","1","15","2023-01-02"
"65039","2022","COM","2020","40","0","40","2023-01-02"
"65040","2022","COM","2020","315","3","318","2023-01-02"
"65041","2022","COM","2020","120","7","127","2023-01-02"
"65042","2022","COM","2020","581","12","593","2023-01-02"
"65043","2022","COM","2020","265","7","272","2023-01-02"
"65044","2022","COM","2020","292","6","298","2023-01-02"
"65045","2022","COM","2020","227","9","236","2023-01-02"
"65046","2022","COM","2020","98","3","101","2023-01-02"
"65047","2022","COM","2020","7932","168","8100","2023-01-02"
"65048","2022","COM","2020","783","16","799","2023-01-02"
"65049","2022","COM","2020","242","3","245","2023-01-02"
"65050","2022","COM","2020","80","2","82","2023-01-02"
"65051","2022","COM","2020","208","4","212","2023-01-02"
"65052","2022","COM","2020","73","0","73","2023-01-02"
"65053","2022","COM","2020","42","1","43","2023-01-02"
"65054","2022","COM","2020","601","11","612","2023-01-02"
"65055","2022","COM","2020","344","12","356","2023-01-02"
"65056","2022","COM","2020","452","13","465","2023-01-02"
"65057","2022","COM","2020","979","20","999","2023-01-02"
"65058","2022","COM","2020","143","1","144","2023-01-02"
"65059","2022","COM","2020","7034","284","7318","2023-01-02"
"65060","2022","COM","2020","63","3","66","2023-01-02"
"65061","2022","COM","2020","48","3","51","2023-01-02"
"65062","2022","COM","2020","3497","75","3572","2023-01-02"
"65063","2022","COM","2020","172","3","175","2023-01-02"
"65064","2022","COM","2020","46","1","47","2023-01-02"
"65065","2022","COM","2020","292","8","300","2023-01-02"
"65066","2022","COM","2020","33","0","33","2023-01-02"
"65067","2022","COM","2020","130","7","137","2023-01-02"
"65068","2022","COM","2020","24","1","25","2023-01-02"
"65069","2022","COM","2020","1230","30","1260","2023-01-02"
"65070","2022","COM","2020","560","18","578","2023-01-02"
"65071","2022","COM","2020","32","0","32","2023-01-02"
"65072","2022","COM","2020","1849","15","1864","2023-01-02"
"65073","2022","COM","2020","359","7","366","2023-01-02"
"65074","2022","COM","2020","108","2","110","2023-01-02"
"65075","2022","COM","2020","137","6","143","2023-01-02"
"65076","2022","COM","2020","61","1","62","2023-01-02"
"65077","2022","COM","2020","423","24","447","2023-01-02"
"65078","2022","COM","2020","402","10","412","2023-01-02"
"65079","2022","COM","2020","195","4","199","2023-01-02"
"65080","2022","COM","2020","546","16","562","2023-01-02"
"65081","2022","COM","2020","136","3","139","2023-01-02"
"65082","2022","COM","2020","49","1","50","2023-01-02"
"65083","2022","COM","2020","724","17","741","2023-01-02"
"65084","2022","COM","2020","286","3","289","2023-01-02"
"65085","2022","COM","2020","107","5","112","2023-01-02"
"65086","2022","COM","2020","149","6","155","2023-01-02"
"65087","2022","COM","2020","169","6","175","2023-01-02"
"65088","2022","COM","2020","48","1","49","2023-01-02"
"65089","2022","COM","2020","84","4","88","2023-01-02"
"65090","2022","COM","2020","77","3","80","2023-01-02"
"65091","2022","COM","2020","59","1","60","2023-01-02"
"65092","2022","COM","2020","226","2","228","2023-01-02"
"65093","2022","COM","2020","210","7","217","2023-01-02"
"65094","2022","COM","2020","128","1","129","2023-01-02"
"65095","2022","COM","2020","328","11","339","2023-01-02"
"65096","2022","COM","2020","68","3","71","2023-01-02"
"65097","2022","COM","2020","191","8","199","2023-01-02"
"65098","2022","COM","2020","334","7","341","2023-01-02"
"65099","2022","COM","2020","139","3","142","2023-01-02"
"65100","2022","COM","2020","5421","122","5543","2023-01-02"
"65101","2022","COM","2020","762","11","773","2023-01-02"
"65102","2022","COM","2020","19","1","20","2023-01-02"
"65103","2022","COM","2020","111","1","112","2023-01-02"
"65104","2022","COM","2020","299","9","308","2023-01-02"
"65105","2022","COM","2020","196","1","197","2023-01-02"
"65106","2022","COM","2020","173","3","176","2023-01-02"
"65107","2022","COM","2020","112","2","114","2023-01-02"
"65108","2022","COM","2020","880","19","899","2023-01-02"
"65109","2022","COM","2020","31","1","32","2023-01-02"
"65110","2022","COM","2020","96","0","96","2023-01-02"
"65111","2022","COM","2020","62","0","62","2023-01-02"
"65112","2022","COM","2020","155","5","160","2023-01-02"
"65113","2022","COM","2020","284","11","295","2023-01-02"
"65114","2022","COM","2020","77","2","79","2023-01-02"
"65115","2022","COM","2020","294","8","302","2023-01-02"
"65116","2022","COM","2020","298","5","303","2023-01-02"
"65117","2022","COM","2020","43","1","44","2023-01-02"
"65118","2022","COM","2020","36","0","36","2023-01-02"
"65119","2022","COM","2020","358","11","369","2023-01-02"
"65120","2022","COM","2020","338","14","352","2023-01-02"
"65121","2022","COM","2020","388","12","400","2023-01-02"
"65123","2022","COM","2020","1304","54","1358","2023-01-02"
"65124","2022","COM","2020","55","3","58","2023-01-02"
"65125","2022","COM","2020","313","7","320","2023-01-02"
"65126","2022","COM","2020","146","5","151","2023-01-02"
"65127","2022","COM","2020","1266","23","1289","2023-01-02"
"65128","2022","COM","2020","140","3","143","2023-01-02"
"65129","2022","COM","2020","794","20","814","2023-01-02"
"65130","2022","COM","2020","625","5","630","2023-01-02"
"65131","2022","COM","2020","244","2","246","2023-01-02"
"65132","2022","COM","2020","45","0","45","2023-01-02"
"65133","2022","COM","2020","234","4","238","2023-01-02"
"65134","2022","COM","2020","14","1","15","2023-01-02"
"65135","2022","COM","2020","82","0","82","2023-01-02"
"65136","2022","COM","2020","32","0","32","2023-01-02"
"65137","2022","COM","2020","96","3","99","2023-01-02"
"65138","2022","COM","2020","870","19","889","2023-01-02"
"65139","2022","COM","2020","53","2","55","2023-01-02"
"65140","2022","COM","2020","31","1","32","2023-01-02"
"65141","2022","COM","2020","60","3","63","2023-01-02"
"65142","2022","COM","2020","211","4","215","2023-01-02"
"65143","2022","COM","2020","110","2","112","2023-01-02"
"65144","2022","COM","2020","87","1","88","2023-01-02"
"65145","2022","COM","2020","48","0","48","2023-01-02"
"65146","2022","COM","2020","312","1","313","2023-01-02"
"65147","2022","COM","2020","612","12","624","2023-01-02"
"65148","2022","COM","2020","134","1","135","2023-01-02"
"65149","2022","COM","2020","163","4","167","2023-01-02"
"65150","2022","COM","2020","495","25","520","2023-01-02"
"65151","2022","COM","2020","148","4","152","2023-01-02"
"65153","2022","COM","2020","123","4","127","2023-01-02"
"65154","2022","COM","2020","55","1","56","2023-01-02"
"65155","2022","COM","2020","52","2","54","2023-01-02"
"65156","2022","COM","2020","214","5","219","2023-01-02"
"65157","2022","COM","2020","20","2","22","2023-01-02"
"65158","2022","COM","2020","80","0","80","2023-01-02"
"65159","2022","COM","2020","354","12","366","2023-01-02"
"65160","2022","COM","2020","121","3","124","2023-01-02"
"65161","2022","COM","2020","282","4","286","2023-01-02"
"65162","2022","COM","2020","33","1","34","2023-01-02"
"65163","2022","COM","2020","40","1","41","2023-01-02"
"65164","2022","COM","2020","103","1","104","2023-01-02"
"65165","2022","COM","2020","180","0","180","2023-01-02"
"65166","2022","COM","2020","50","1","51","2023-01-02"
"65167","2022","COM","2020","25","0","25","2023-01-02"
"65168","2022","COM","2020","411","12","423","2023-01-02"
"65169","2022","COM","2020","92","2","94","2023-01-02"
"65170","2022","COM","2020","76","1","77","2023-01-02"
"65171","2022","COM","2020","43","0","43","2023-01-02"
"65172","2022","COM","2020","38","0","38","2023-01-02"
"65173","2022","COM","2020","190","7","197","2023-01-02"
"65174","2022","COM","2020","104","4","108","2023-01-02"
"65175","2022","COM","2020","39","3","42","2023-01-02"
"65176","2022","COM","2020","82","0","82","2023-01-02"
"65177","2022","COM","2020","167","3","170","2023-01-02"
"65178","2022","COM","2020","56","0","56","2023-01-02"
"65179","2022","COM","2020","27","0","27","2023-01-02"
"65180","2022","COM","2020","14","0","14","2023-01-02"
"65181","2022","COM","2020","167","3","170","2023-01-02"
"65182","2022","COM","2020","121","1","122","2023-01-02"
"65183","2022","COM","2020","698","13","711","2023-01-02"
"65184","2022","COM","2020","172","1","173","2023-01-02"
"65185","2022","COM","2020","443","13","456","2023-01-02"
"65186","2022","COM","2020","35","0","35","2023-01-02"
"65187","2022","COM","2020","98","4","102","2023-01-02"
"65189","2022","COM","2020","276","13","289","2023-01-02"
"65190","2022","COM","2020","71","0","71","2023-01-02"
"65191","2022","COM","2020","122","2","124","2023-01-02"
"65192","2022","COM","2020","340","9","349","2023-01-02"
"65193","2022","COM","2020","92","3","95","2023-01-02"
"65194","2022","COM","2020","95","3","98","2023-01-02"
"65195","2022","COM","2020","141","0","141","2023-01-02"
"65196","2022","COM","2020","91","2","93","2023-01-02"
"65197","2022","COM","2020","154","9","163","2023-01-02"
"65198","2022","COM","2020","1142","27","1169","2023-01-02"
"65199","2022","COM","2020","35","0","35","2023-01-02"
"65200","2022","COM","2020","106","1","107","2023-01-02"
"65201","2022","COM","2020","187","4","191","2023-01-02"
"65202","2022","COM","2020","329","13","342","2023-01-02"
"65203","2022","COM","2020","26","1","27","2023-01-02"
"65204","2022","COM","2020","28","0","28","2023-01-02"
"65205","2022","COM","2020","54","0","54","2023-01-02"
"65206","2022","COM","2020","234","6","240","2023-01-02"
"65207","2022","COM","2020","64","0","64","2023-01-02"
"65208","2022","COM","2020","23","0","23","2023-01-02"
"65209","2022","COM","2020","76","0","76","2023-01-02"
"65210","2022","COM","2020","34","1","35","2023-01-02"
"65211","2022","COM","2020","149","5","154","2023-01-02"
"65212","2022","COM","2020","327","11","338","2023-01-02"
"65213","2022","COM","2020","122","3","125","2023-01-02"
"65214","2022","COM","2020","45","0","45","2023-01-02"
"65215","2022","COM","2020","43","2","45","2023-01-02"
"65216","2022","COM","2020","101","0","101","2023-01-02"
"65217","2022","COM","2020","57","2","59","2023-01-02"
"65218","2022","COM","2020","613","11","624","2023-01-02"
"65219","2022","COM","2020","115","3","118","2023-01-02"
"65220","2022","COM","2020","238","2","240","2023-01-02"
"65221","2022","COM","2020","258","5","263","2023-01-02"
"65222","2022","COM","2020","154","8","162","2023-01-02"
"65223","2022","COM","2020","1194","26","1220","2023-01-02"
"65224","2022","COM","2020","280","6","286","2023-01-02"
"65225","2022","COM","2020","107","1","108","2023-01-02"
"65226","2022","COM","2020","2905","138","3043","2023-01-02"
"65228","2022","COM","2020","121","0","121","2023-01-02"
"65229","2022","COM","2020","48","0","48","2023-01-02"
"65230","2022","COM","2020","256","6","262","2023-01-02"
"65231","2022","COM","2020","199","12","211","2023-01-02"
"65232","2022","COM","2020","65","2","67","2023-01-02"
"65233","2022","COM","2020","312","4","316","2023-01-02"
"65234","2022","COM","2020","96","1","97","2023-01-02"
"65235","2022","COM","2020","4045","96","4141","2023-01-02"
"65236","2022","COM","2020","454","13","467","2023-01-02"
"65237","2022","COM","2020","159","5","164","2023-01-02"
"65238","2022","COM","2020","234","10","244","2023-01-02"
"65239","2022","COM","2020","151","5","156","2023-01-02"
"65240","2022","COM","2020","381","6","387","2023-01-02"
"65241","2022","COM","2020","86","3","89","2023-01-02"
"65242","2022","COM","2020","238","3","241","2023-01-02"
"65243","2022","COM","2020","448","18","466","2023-01-02"
"65244","2022","COM","2020","530","7","537","2023-01-02"
"65245","2022","COM","2020","241","4","245","2023-01-02"
"65247","2022","COM","2020","102","1","103","2023-01-02"
"65248","2022","COM","2020","257","17","274","2023-01-02"
"65249","2022","COM","2020","101","5","106","2023-01-02"
"65250","2022","COM","2020","119","1","120","2023-01-02"
"65251","2022","COM","2020","1874","64","1938","2023-01-02"
"65252","2022","COM","2020","869","14","883","2023-01-02"
"65253","2022","COM","2020","53","0","53","2023-01-02"
"65254","2022","COM","2020","144","4","148","2023-01-02"
"65255","2022","COM","2020","30","0","30","2023-01-02"
"65256","2022","COM","2020","145","2","147","2023-01-02"
"65257","2022","COM","2020","605","9","614","2023-01-02"
"65258","2022","COM","2020","5803","161","5964","2023-01-02"
"65259","2022","COM","2020","181","10","191","2023-01-02"
"65260","2022","COM","2020","92","1","93","2023-01-02"
"65261","2022","COM","2020","47","1","48","2023-01-02"
"65262","2022","COM","2020","389","10","399","2023-01-02"
"65263","2022","COM","2020","94","3","97","2023-01-02"
"65264","2022","COM","2020","309","25","334","2023-01-02"
"65265","2022","COM","2020","329","10","339","2023-01-02"
"65266","2022","COM","2020","37","1","38","2023-01-02"
"65267","2022","COM","2020","522","17","539","2023-01-02"
"65268","2022","COM","2020","225","3","228","2023-01-02"
"65269","2022","COM","2020","166","3","169","2023-01-02"
"65270","2022","COM","2020","201","8","209","2023-01-02"
"65271","2022","COM","2020","357","4","361","2023-01-02"
"65272","2022","COM","2020","77","1","78","2023-01-02"
"65273","2022","COM","2020","199","0","199","2023-01-02"
"65274","2022","COM","2020","139","1","140","2023-01-02"
"65275","2022","COM","2020","76","1","77","2023-01-02"
"65276","2022","COM","2020","119","1","120","2023-01-02"
"65277","2022","COM","2020","91","2","93","2023-01-02"
"65278","2022","COM","2020","31","0","31","2023-01-02"
"65279","2022","COM","2020","215","6","221","2023-01-02"
"65280","2022","COM","2020","434","3","437","2023-01-02"
"65281","2022","COM","2020","250","4","254","2023-01-02"
"65282","2022","COM","2020","295","6","301","2023-01-02"
"65283","2022","COM","2020","48","3","51","2023-01-02"
"65284","2022","COM","2020","1052","28","1080","2023-01-02"
"65285","2022","COM","2020","191","3","194","2023-01-02"
"65286","2022","COM","2020","13247","299","13546","2023-01-02"
"65287","2022","COM","2020","626","12","638","2023-01-02"
"65288","2022","COM","2020","55","1","56","2023-01-02"
"65289","2022","COM","2020","109","2","111","2023-01-02"
"65290","2022","COM","2020","183","1","184","2023-01-02"
"65291","2022","COM","2020","143","4","147","2023-01-02"
"65292","2022","COM","2020","404","3","407","2023-01-02"
"65293","2022","COM","2020","97","2","99","2023-01-02"
"65294","2022","COM","2020","216","3","219","2023-01-02"
"65295","2022","COM","2020","929","15","944","2023-01-02"
"65296","2022","COM","2020","425","13","438","2023-01-02"
"65297","2022","COM","2020","41","5","46","2023-01-02"
"65298","2022","COM","2020","85","0","85","2023-01-02"
"65299","2022","COM","2020","220","4","224","2023-01-02"
"65300","2022","COM","2020","66","3","69","2023-01-02"
"65301","2022","COM","2020","264","4","268","2023-01-02"
"65303","2022","COM","2020","369","4","373","2023-01-02"
"65304","2022","COM","2020","2254","30","2284","2023-01-02"
"65305","2022","COM","2020","98","0","98","2023-01-02"
"65306","2022","COM","2020","233","4","237","2023-01-02"
"65307","2022","COM","2020","338","5","343","2023-01-02"
"65308","2022","COM","2020","105","3","108","2023-01-02"
"65309","2022","COM","2020","15","0","15","2023-01-02"
"65310","2022","COM","2020","235","5","240","2023-01-02"
"65311","2022","COM","2020","99","0","99","2023-01-02"
"65313","2022","COM","2020","737","23","760","2023-01-02"
"65314","2022","COM","2020","208","7","215","2023-01-02"
"65315","2022","COM","2020","414","207","621","2023-01-02"
"65316","2022","COM","2020","105","3","108","2023-01-02"
"65317","2022","COM","2020","35","2","37","2023-01-02"
"65318","2022","COM","2020","231","3","234","2023-01-02"
"65319","2022","COM","2020","134","3","137","2023-01-02"
"65320","2022","COM","2020","838","17","855","2023-01-02"
"65321","2022","COM","2020","141","3","144","2023-01-02"
"65322","2022","COM","2020","251","7","258","2023-01-02"
"65323","2022","COM","2020","84","0","84","2023-01-02"
"65324","2022","COM","2020","214","7","221","2023-01-02"
"65325","2022","COM","2020","44","0","44","2023-01-02"
"65326","2022","COM","2020","83","3","86","2023-01-02"
"65327","2022","COM","2020","170","3","173","2023-01-02"
"65328","2022","COM","2020","95","4","99","2023-01-02"
"65329","2022","COM","2020","208","7","215","2023-01-02"
"65330","2022","COM","2020","224","3","227","2023-01-02"
"65331","2022","COM","2020","3290","100","3390","2023-01-02"
"65332","2022","COM","2020","171","1","172","2023-01-02"
"65333","2022","COM","2020","113","1","114","2023-01-02"
"65334","2022","COM","2020","224","4","228","2023-01-02"
"65335","2022","COM","2020","523","16","539","2023-01-02"
"65336","2022","COM","2020","32","0","32","2023-01-02"
"65337","2022","COM","2020","106","3","109","2023-01-02"
"65338","2022","COM","2020","247","3","250","2023-01-02"
"65339","2022","COM","2020","338","7","345","2023-01-02"
"65340","2022","COM","2020","1953","42","1995","2023-01-02"
"65341","2022","COM","2020","106","2","108","2023-01-02"
"65342","2022","COM","2020","93","2","95","2023-01-02"
"65343","2022","COM","2020","242","5","247","2023-01-02"
"65344","2022","COM","2020","2369","52","2421","2023-01-02"
"65345","2022","COM","2020","56","0","56","2023-01-02"
"65346","2022","COM","2020","150","6","156","2023-01-02"
"65347","2022","COM","2020","45","0","45","2023-01-02"
"65348","2022","COM","2020","45","2","47","2023-01-02"
"65349","2022","COM","2020","12","0","12","2023-01-02"
"65350","2022","COM","2020","1200","41","1241","2023-01-02"
"65351","2022","COM","2020","35","0","35","2023-01-02"
"65352","2022","COM","2020","221","8","229","2023-01-02"
"65353","2022","COM","2020","249","10","259","2023-01-02"
"65354","2022","COM","2020","75","3","78","2023-01-02"
"65355","2022","COM","2020","73","0","73","2023-01-02"
"65356","2022","COM","2020","60","2","62","2023-01-02"
"65357","2022","COM","2020","163","3","166","2023-01-02"
"65358","2022","COM","2020","51","2","53","2023-01-02"
"65359","2022","COM","2020","27","0","27","2023-01-02"
"65360","2022","COM","2020","275","8","283","2023-01-02"
"65361","2022","COM","2020","98","0","98","2023-01-02"
"65362","2022","COM","2020","1119","25","1144","2023-01-02"
"65363","2022","COM","2020","454","9","463","2023-01-02"
"65364","2022","COM","2020","22","2","24","2023-01-02"
"65366","2022","COM","2020","846","25","871","2023-01-02"
"65367","2022","COM","2020","166","3","169","2023-01-02"
"65368","2022","COM","2020","41","2","43","2023-01-02"
"65369","2022","COM","2020","643","23","666","2023-01-02"
"65370","2022","COM","2020","1110","38","1148","2023-01-02"
"65371","2022","COM","2020","239","10","249","2023-01-02"
"65372","2022","COM","2020","649","14","663","2023-01-02"
"65373","2022","COM","2020","163","4","167","2023-01-02"
"65374","2022","COM","2020","233","1","234","2023-01-02"
"65375","2022","COM","2020","1443","25","1468","2023-01-02"
"65376","2022","COM","2020","217","4","221","2023-01-02"
"65377","2022","COM","2020","155","8","163","2023-01-02"
"65378","2022","COM","2020","66","2","68","2023-01-02"
"65379","2022","COM","2020","14","1","15","2023-01-02"
"65380","2022","COM","2020","147","1","148","2023-01-02"
"65381","2022","COM","2020","34","0","34","2023-01-02"
"65382","2022","COM","2020","80","3","83","2023-01-02"
"65383","2022","COM","2020","196","2","198","2023-01-02"
"65384","2022","COM","2020","173","2","175","2023-01-02"
"65385","2022","COM","2020","96","1","97","2023-01-02"
"65386","2022","COM","2020","98","0","98","2023-01-02"
"65387","2022","COM","2020","122","3","125","2023-01-02"
"65388","2022","COM","2020","838","17","855","2023-01-02"
"65389","2022","COM","2020","955","35","990","2023-01-02"
"65390","2022","COM","2020","429","8","437","2023-01-02"
"65391","2022","COM","2020","59","0","59","2023-01-02"
"65392","2022","COM","2020","442","8","450","2023-01-02"
"65393","2022","COM","2020","143","5","148","2023-01-02"
"65394","2022","COM","2020","319","3","322","2023-01-02"
"65395","2022","COM","2020","1157","20","1177","2023-01-02"
"65396","2022","COM","2020","364","8","372","2023-01-02"
"65397","2022","COM","2020","161","4","165","2023-01-02"
"65398","2022","COM","2020","245","2","247","2023-01-02"
"65399","2022","COM","2020","98","2","100","2023-01-02"
"65400","2022","COM","2020","228","7","235","2023-01-02"
"65401","2022","COM","2020","573","24","597","2023-01-02"
"65402","2022","COM","2020","25","0","25","2023-01-02"
"65403","2022","COM","2020","101","2","103","2023-01-02"
"65404","2022","COM","2020","153","3","156","2023-01-02"
"65405","2022","COM","2020","78","1","79","2023-01-02"
"65406","2022","COM","2020","258","5","263","2023-01-02"
"65407","2022","COM","2020","108","2","110","2023-01-02"
"65408","2022","COM","2020","560","19","579","2023-01-02"
"65409","2022","COM","2020","292","3","295","2023-01-02"
"65410","2022","COM","2020","525","14","539","2023-01-02"
"65411","2022","COM","2020","76","6","82","2023-01-02"
"65412","2022","COM","2020","165","3","168","2023-01-02"
"65413","2022","COM","2020","142","4","146","2023-01-02"
"65414","2022","COM","2020","80","4","84","2023-01-02"
"65415","2022","COM","2020","239","1","240","2023-01-02"
"65416","2022","COM","2020","86","2","88","2023-01-02"
"65417","2022","COM","2020","5165","95","5260","2023-01-02"
"65418","2022","COM","2020","292","7","299","2023-01-02"
"65419","2022","COM","2020","68","0","68","2023-01-02"
"65420","2022","COM","2020","76","2","78","2023-01-02"
"65421","2022","COM","2020","50","2","52","2023-01-02"
"65422","2022","COM","2020","338","3","341","2023-01-02"
"65423","2022","COM","2020","133","1","134","2023-01-02"
"65424","2022","COM","2020","118","2","120","2023-01-02"
"65425","2022","COM","2020","449","7","456","2023-01-02"
"65426","2022","COM","2020","131","6","137","2023-01-02"
"65427","2022","COM","2020","285","6","291","2023-01-02"
"65428","2022","COM","2020","62","1","63","2023-01-02"
"65429","2022","COM","2020","205","10","215","2023-01-02"
"65430","2022","COM","2020","44","1","45","2023-01-02"
"65431","2022","COM","2020","96","3","99","2023-01-02"
"65432","2022","COM","2020","177","6","183","2023-01-02"
"65433","2022","COM","2020","3047","40","3087","2023-01-02"
"65435","2022","COM","2020","283","4","287","2023-01-02"
"65436","2022","COM","2020","303","11","314","2023-01-02"
"65437","2022","COM","2020","131","5","136","2023-01-02"
"65438","2022","COM","2020","76","2","78","2023-01-02"
"65439","2022","COM","2020","269","3","272","2023-01-02"
"65440","2022","COM","2020","42925","1019","43944","2023-01-02"
"65441","2022","COM","2020","79","2","81","2023-01-02"
"65442","2022","COM","2020","209","1","210","2023-01-02"
"65443","2022","COM","2020","16","0","16","2023-01-02"
"65444","2022","COM","2020","323","2","325","2023-01-02"
"65445","2022","COM","2020","230","5","235","2023-01-02"
"65446","2022","COM","2020","549","4","553","2023-01-02"
"65447","2022","COM","2020","1164","21","1185","2023-01-02"
"65448","2022","COM","2020","87","4","91","2023-01-02"
"65449","2022","COM","2020","87","5","92","2023-01-02"
"65450","2022","COM","2020","39","1","40","2023-01-02"
"65451","2022","COM","2020","749","14","763","2023-01-02"
"65452","2022","COM","2020","1001","26","1027","2023-01-02"
"65453","2022","COM","2020","75","0","75","2023-01-02"
"65454","2022","COM","2020","105","1","106","2023-01-02"
"65455","2022","COM","2020","436","8","444","2023-01-02"
"65456","2022","COM","2020","285","7","292","2023-01-02"
"65457","2022","COM","2020","83","1","84","2023-01-02"
"65458","2022","COM","2020","33","1","34","2023-01-02"
"65459","2022","COM","2020","103","0","103","2023-01-02"
"65460","2022","COM","2020","4831","270","5101","2023-01-02"
"65461","2022","COM","2020","101","2","103","2023-01-02"
"65462","2022","COM","2020","242","5","247","2023-01-02"
"65463","2022","COM","2020","84","1","85","2023-01-02"
"65464","2022","COM","2020","500","10","510","2023-01-02"
"65465","2022","COM","2020","317","9","326","2023-01-02"
"65466","2022","COM","2020","82","1","83","2023-01-02"
"65467","2022","COM","2020","97","6","103","2023-01-02"
"65468","2022","COM","2020","43","1","44","2023-01-02"
"65469","2022","COM","2020","21","1","22","2023-01-02"
"65470","2022","COM","2020","146","4","150","2023-01-02"
"65471","2022","COM","2020","213","8","221","2023-01-02"
"65472","2022","COM","2020","74","5","79","2023-01-02"
"65473","2022","COM","2020","382","11","393","2023-01-02"
"65474","2022","COM","2020","113","1","114","2023-01-02"
"65475","2022","COM","2020","60","1","61","2023-01-02"
"65476","2022","COM","2020","66","4","70","2023-01-02"
"65477","2022","COM","2020","106","2","108","2023-01-02"
"65478","2022","COM","2020","33","1","34","2023-01-02"
"65479","2022","COM","2020","352","10","362","2023-01-02"
"65481","2022","COM","2020","157","5","162","2023-01-02"
"65482","2022","COM","2020","440","11","451","2023-01-02"
"66001","2022","COM","2020","70","1","71","2023-01-02"
"66002","2022","COM","2020","3654","63","3717","2023-01-02"
"66003","2022","COM","2020","3581","51","3632","2023-01-02"
"66004","2022","COM","2020","546","8","554","2023-01-02"
"66005","2022","COM","2020","557","35","592","2023-01-02"
"66006","2022","COM","2020","166","5","171","2023-01-02"
"66007","2022","COM","2020","127","1","128","2023-01-02"
"66008","2022","COM","2020","10593","251","10844","2023-01-02"
"66009","2022","COM","2020","2784","39","2823","2023-01-02"
"66010","2022","COM","2020","35","0","35","2023-01-02"
"66011","2022","COM","2020","4453","54","4507","2023-01-02"
"66012","2022","COM","2020","3388","69","3457","2023-01-02"
"66013","2022","COM","2020","118","3","121","2023-01-02"
"66014","2022","COM","2020","2669","48","2717","2023-01-02"
"66015","2022","COM","2020","1289","22","1311","2023-01-02"
"66016","2022","COM","2020","4761","78","4839","2023-01-02"
"66017","2022","COM","2020","5894","39","5933","2023-01-02"
"66018","2022","COM","2020","68","0","68","2023-01-02"
"66019","2022","COM","2020","213","4","217","2023-01-02"
"66020","2022","COM","2020","816","29","845","2023-01-02"
"66021","2022","COM","2020","7625","109","7734","2023-01-02"
"66022","2022","COM","2020","58","1","59","2023-01-02"
"66023","2022","COM","2020","957","9","966","2023-01-02"
"66024","2022","COM","2020","5313","57","5370","2023-01-02"
"66025","2022","COM","2020","1203","76","1279","2023-01-02"
"66026","2022","COM","2020","1580","33","1613","2023-01-02"
"66027","2022","COM","2020","695","14","709","2023-01-02"
"66028","2022","COM","2020","10368","212","10580","2023-01-02"
"66029","2022","COM","2020","134","1","135","2023-01-02"
"66030","2022","COM","2020","216","4","220","2023-01-02"
"66032","2022","COM","2020","59","3","62","2023-01-02"
"66033","2022","COM","2020","459","13","472","2023-01-02"
"66034","2022","COM","2020","111","5","116","2023-01-02"
"66035","2022","COM","2020","41","0","41","2023-01-02"
"66036","2022","COM","2020","22","0","22","2023-01-02"
"66037","2022","COM","2020","12653","263","12916","2023-01-02"
"66038","2022","COM","2020","6490","121","6611","2023-01-02"
"66039","2022","COM","2020","131","1","132","2023-01-02"
"66040","2022","COM","2020","41","1","42","2023-01-02"
"66041","2022","COM","2020","958","22","980","2023-01-02"
"66042","2022","COM","2020","276","1","277","2023-01-02"
"66043","2022","COM","2020","139","2","141","2023-01-02"
"66044","2022","COM","2020","289","6","295","2023-01-02"
"66045","2022","COM","2020","761","15","776","2023-01-02"
"66046","2022","COM","2020","593","9","602","2023-01-02"
"66047","2022","COM","2020","18","2","20","2023-01-02"
"66048","2022","COM","2020","1301","15","1316","2023-01-02"
"66049","2022","COM","2020","7753","215","7968","2023-01-02"
"66050","2022","COM","2020","4550","56","4606","2023-01-02"
"66051","2022","COM","2020","270","8","278","2023-01-02"
"66052","2022","COM","2020","359","7","366","2023-01-02"
"66053","2022","COM","2020","2400","29","2429","2023-01-02"
"66054","2022","COM","2020","60","3","63","2023-01-02"
"66055","2022","COM","2020","777","17","794","2023-01-02"
"66056","2022","COM","2020","1040","14","1054","2023-01-02"
"66057","2022","COM","2020","530","4","534","2023-01-02"
"66058","2022","COM","2020","2012","35","2047","2023-01-02"
"66059","2022","COM","2020","2444","35","2479","2023-01-02"
"66060","2022","COM","2020","240","21","261","2023-01-02"
"66061","2022","COM","2020","91","0","91","2023-01-02"
"66062","2022","COM","2020","171","7","178","2023-01-02"
"66063","2022","COM","2020","232","3","235","2023-01-02"
"66064","2022","COM","2020","422","13","435","2023-01-02"
"66065","2022","COM","2020","9402","116","9518","2023-01-02"
"66066","2022","COM","2020","637","22","659","2023-01-02"
"66067","2022","COM","2020","683","13","696","2023-01-02"
"66068","2022","COM","2020","111","2","113","2023-01-02"
"66069","2022","COM","2020","3489","114","3603","2023-01-02"
"66070","2022","COM","2020","183","5","188","2023-01-02"
"66071","2022","COM","2020","2046","18","2064","2023-01-02"
"66072","2022","COM","2020","479","11","490","2023-01-02"
"66073","2022","COM","2020","135","2","137","2023-01-02"
"66074","2022","COM","2020","377","14","391","2023-01-02"
"66075","2022","COM","2020","144","8","152","2023-01-02"
"66076","2022","COM","2020","63","0","63","2023-01-02"
"66077","2022","COM","2020","88","1","89","2023-01-02"
"66078","2022","COM","2020","197","4","201","2023-01-02"
"66079","2022","COM","2020","200","4","204","2023-01-02"
"66080","2022","COM","2020","119","1","120","2023-01-02"
"66081","2022","COM","2020","124","3","127","2023-01-02"
"66082","2022","COM","2020","500","15","515","2023-01-02"
"66083","2022","COM","2020","41","0","41","2023-01-02"
"66084","2022","COM","2020","1313","19","1332","2023-01-02"
"66085","2022","COM","2020","442","9","451","2023-01-02"
"66086","2022","COM","2020","22","0","22","2023-01-02"
"66088","2022","COM","2020","5519","69","5588","2023-01-02"
"66089","2022","COM","2020","349","6","355","2023-01-02"
"66090","2022","COM","2020","43","2","45","2023-01-02"
"66091","2022","COM","2020","56","1","57","2023-01-02"
"66092","2022","COM","2020","91","2","93","2023-01-02"
"66093","2022","COM","2020","2192","29","2221","2023-01-02"
"66094","2022","COM","2020","3210","47","3257","2023-01-02"
"66095","2022","COM","2020","450","12","462","2023-01-02"
"66096","2022","COM","2020","1043","13","1056","2023-01-02"
"66097","2022","COM","2020","139","4","143","2023-01-02"
"66098","2022","COM","2020","218","10","228","2023-01-02"
"66099","2022","COM","2020","320","2","322","2023-01-02"
"66100","2022","COM","2020","166","4","170","2023-01-02"
"66101","2022","COM","2020","2141","45","2186","2023-01-02"
"66102","2022","COM","2020","31","2","33","2023-01-02"
"66103","2022","COM","2020","574","8","582","2023-01-02"
"66104","2022","COM","2020","979","12","991","2023-01-02"
"66105","2022","COM","2020","277","6","283","2023-01-02"
"66106","2022","COM","2020","2665","45","2710","2023-01-02"
"66107","2022","COM","2020","789","12","801","2023-01-02"
"66108","2022","COM","2020","4261","63","4324","2023-01-02"
"66109","2022","COM","2020","246","4","250","2023-01-02"
"66111","2022","COM","2020","153","2","155","2023-01-02"
"66112","2022","COM","2020","251","4","255","2023-01-02"
"66113","2022","COM","2020","177","2","179","2023-01-02"
"66114","2022","COM","2020","1630","36","1666","2023-01-02"
"66115","2022","COM","2020","1250","23","1273","2023-01-02"
"66116","2022","COM","2020","197","3","200","2023-01-02"
"66117","2022","COM","2020","144","8","152","2023-01-02"
"66118","2022","COM","2020","333","7","340","2023-01-02"
"66119","2022","COM","2020","316","5","321","2023-01-02"
"66120","2022","COM","2020","76","1","77","2023-01-02"
"66121","2022","COM","2020","1314","36","1350","2023-01-02"
"66122","2022","COM","2020","59","2","61","2023-01-02"
"66123","2022","COM","2020","153","0","153","2023-01-02"
"66124","2022","COM","2020","1791","173","1964","2023-01-02"
"66125","2022","COM","2020","347","5","352","2023-01-02"
"66126","2022","COM","2020","334","5","339","2023-01-02"
"66127","2022","COM","2020","1189","17","1206","2023-01-02"
"66128","2022","COM","2020","25","0","25","2023-01-02"
"66129","2022","COM","2020","1700","22","1722","2023-01-02"
"66130","2022","COM","2020","1366","75","1441","2023-01-02"
"66132","2022","COM","2020","415","11","426","2023-01-02"
"66133","2022","COM","2020","3092","45","3137","2023-01-02"
"66134","2022","COM","2020","998","10","1008","2023-01-02"
"66136","2022","COM","2020","118032","1415","119447","2023-01-02"
"66137","2022","COM","2020","551","3","554","2023-01-02"
"66138","2022","COM","2020","1585","26","1611","2023-01-02"
"66139","2022","COM","2020","39","0","39","2023-01-02"
"66140","2022","COM","2020","3906","56","3962","2023-01-02"
"66141","2022","COM","2020","10334","102","10436","2023-01-02"
"66142","2022","COM","2020","54","2","56","2023-01-02"
"66143","2022","COM","2020","90","2","92","2023-01-02"
"66144","2022","COM","2020","5316","84","5400","2023-01-02"
"66145","2022","COM","2020","2833","42","2875","2023-01-02"
"66146","2022","COM","2020","115","6","121","2023-01-02"
"66147","2022","COM","2020","106","1","107","2023-01-02"
"66148","2022","COM","2020","3995","75","4070","2023-01-02"
"66149","2022","COM","2020","6081","294","6375","2023-01-02"
"66150","2022","COM","2020","1155","14","1169","2023-01-02"
"66151","2022","COM","2020","78","4","82","2023-01-02"
"66152","2022","COM","2020","105","0","105","2023-01-02"
"66153","2022","COM","2020","47","0","47","2023-01-02"
"66154","2022","COM","2020","61","1","62","2023-01-02"
"66155","2022","COM","2020","80","1","81","2023-01-02"
"66156","2022","COM","2020","91","0","91","2023-01-02"
"66157","2022","COM","2020","23","1","24","2023-01-02"
"66158","2022","COM","2020","156","2","158","2023-01-02"
"66159","2022","COM","2020","62","0","62","2023-01-02"
"66160","2022","COM","2020","1252","21","1273","2023-01-02"
"66161","2022","COM","2020","1354","25","1379","2023-01-02"
"66162","2022","COM","2020","678","2","680","2023-01-02"
"66164","2022","COM","2020","9020","140","9160","2023-01-02"
"66165","2022","COM","2020","636","7","643","2023-01-02"
"66166","2022","COM","2020","397","4","401","2023-01-02"
"66167","2022","COM","2020","1175","30","1205","2023-01-02"
"66168","2022","COM","2020","3411","51","3462","2023-01-02"
"66169","2022","COM","2020","109","1","110","2023-01-02"
"66170","2022","COM","2020","162","2","164","2023-01-02"
"66171","2022","COM","2020","11048","140","11188","2023-01-02"
"66172","2022","COM","2020","11642","163","11805","2023-01-02"
"66173","2022","COM","2020","1205","19","1224","2023-01-02"
"66174","2022","COM","2020","2907","45","2952","2023-01-02"
"66175","2022","COM","2020","2837","27","2864","2023-01-02"
"66176","2022","COM","2020","3209","32","3241","2023-01-02"
"66177","2022","COM","2020","1558","17","1575","2023-01-02"
"66178","2022","COM","2020","2264","49","2313","2023-01-02"
"66179","2022","COM","2020","1036","14","1050","2023-01-02"
"66180","2022","COM","2020","10053","120","10173","2023-01-02"
"66181","2022","COM","2020","122","2","124","2023-01-02"
"66182","2022","COM","2020","4800","67","4867","2023-01-02"
"66183","2022","COM","2020","64","0","64","2023-01-02"
"66184","2022","COM","2020","51","3","54","2023-01-02"
"66185","2022","COM","2020","353","11","364","2023-01-02"
"66186","2022","COM","2020","2784","39","2823","2023-01-02"
"66187","2022","COM","2020","1779","17","1796","2023-01-02"
"66188","2022","COM","2020","262","10","272","2023-01-02"
"66189","2022","COM","2020","5617","83","5700","2023-01-02"
"66190","2022","COM","2020","3616","32","3648","2023-01-02"
"66191","2022","COM","2020","23","1","24","2023-01-02"
"66192","2022","COM","2020","94","3","97","2023-01-02"
"66193","2022","COM","2020","225","5","230","2023-01-02"
"66194","2022","COM","2020","227","3","230","2023-01-02"
"66195","2022","COM","2020","7868","117","7985","2023-01-02"
"66196","2022","COM","2020","3395","51","3446","2023-01-02"
"66197","2022","COM","2020","36","0","36","2023-01-02"
"66198","2022","COM","2020","492","3","495","2023-01-02"
"66199","2022","COM","2020","103","4","107","2023-01-02"
"66201","2022","COM","2020","45","1","46","2023-01-02"
"66202","2022","COM","2020","193","5","198","2023-01-02"
"66203","2022","COM","2020","58","0","58","2023-01-02"
"66204","2022","COM","2020","328","10","338","2023-01-02"
"66205","2022","COM","2020","854","22","876","2023-01-02"
"66206","2022","COM","2020","96","0","96","2023-01-02"
"66207","2022","COM","2020","760","11","771","2023-01-02"
"66208","2022","COM","2020","2170","100","2270","2023-01-02"
"66209","2022","COM","2020","35","0","35","2023-01-02"
"66210","2022","COM","2020","8057","140","8197","2023-01-02"
"66211","2022","COM","2020","180","7","187","2023-01-02"
"66212","2022","COM","2020","3854","70","3924","2023-01-02"
"66213","2022","COM","2020","7255","130","7385","2023-01-02"
"66214","2022","COM","2020","1125","13","1138","2023-01-02"
"66215","2022","COM","2020","161","0","161","2023-01-02"
"66216","2022","COM","2020","76","1","77","2023-01-02"
"66217","2022","COM","2020","2222","25","2247","2023-01-02"
"66218","2022","COM","2020","353","11","364","2023-01-02"
"66219","2022","COM","2020","47","0","47","2023-01-02"
"66220","2022","COM","2020","36","1","37","2023-01-02"
"66221","2022","COM","2020","34","0","34","2023-01-02"
"66222","2022","COM","2020","1447","41","1488","2023-01-02"
"66223","2022","COM","2020","209","6","215","2023-01-02"
"66224","2022","COM","2020","3285","40","3325","2023-01-02"
"66225","2022","COM","2020","1815","62","1877","2023-01-02"
"66226","2022","COM","2020","1356","16","1372","2023-01-02"
"66227","2022","COM","2020","4124","54","4178","2023-01-02"
"66228","2022","COM","2020","1373","23","1396","2023-01-02"
"66230","2022","COM","2020","2146","25","2171","2023-01-02"
"66231","2022","COM","2020","558","6","564","2023-01-02"
"66232","2022","COM","2020","25","0","25","2023-01-02"
"66233","2022","COM","2020","173","5","178","2023-01-02"
"66234","2022","COM","2020","68","0","68","2023-01-02"
"67001","2022","COM","2020","2437","34","2471","2023-01-02"
"67002","2022","COM","2020","396","2","398","2023-01-02"
"67003","2022","COM","2020","451","10","461","2023-01-02"
"67004","2022","COM","2020","1530","28","1558","2023-01-02"
"67005","2022","COM","2020","851","20","871","2023-01-02"
"67006","2022","COM","2020","221","1","222","2023-01-02"
"67008","2022","COM","2020","1398","23","1421","2023-01-02"
"67009","2022","COM","2020","377","13","390","2023-01-02"
"67010","2022","COM","2020","1763","70","1833","2023-01-02"
"67011","2022","COM","2020","989","11","1000","2023-01-02"
"67012","2022","COM","2020","649","18","667","2023-01-02"
"67013","2022","COM","2020","272","3","275","2023-01-02"
"67016","2022","COM","2020","788","11","799","2023-01-02"
"67017","2022","COM","2020","296","5","301","2023-01-02"
"67018","2022","COM","2020","675","9","684","2023-01-02"
"67019","2022","COM","2020","1193","18","1211","2023-01-02"
"67020","2022","COM","2020","827","7","834","2023-01-02"
"67021","2022","COM","2020","7174","191","7365","2023-01-02"
"67022","2022","COM","2020","225","4","229","2023-01-02"
"67023","2022","COM","2020","984","22","1006","2023-01-02"
"67025","2022","COM","2020","1924","21","1945","2023-01-02"
"67026","2022","COM","2020","170","3","173","2023-01-02"
"67027","2022","COM","2020","170","0","170","2023-01-02"
"67028","2022","COM","2020","5820","94","5914","2023-01-02"
"67029","2022","COM","2020","352","4","356","2023-01-02"
"67030","2022","COM","2020","725","7","732","2023-01-02"
"67031","2022","COM","2020","1451","45","1496","2023-01-02"
"67032","2022","COM","2020","203","7","210","2023-01-02"
"67033","2022","COM","2020","606","8","614","2023-01-02"
"67034","2022","COM","2020","2462","40","2502","2023-01-02"
"67035","2022","COM","2020","467","6","473","2023-01-02"
"67036","2022","COM","2020","308","7","315","2023-01-02"
"67037","2022","COM","2020","361","6","367","2023-01-02"
"67038","2022","COM","2020","301","2","303","2023-01-02"
"67039","2022","COM","2020","539","11","550","2023-01-02"
"67040","2022","COM","2020","1044","10","1054","2023-01-02"
"67043","2022","COM","2020","17520","215","17735","2023-01-02"
"67044","2022","COM","2020","256","0","256","2023-01-02"
"67045","2022","COM","2020","3338","59","3397","2023-01-02"
"67046","2022","COM","2020","12606","153","12759","2023-01-02"
"67047","2022","COM","2020","157","3","160","2023-01-02"
"67048","2022","COM","2020","459","15","474","2023-01-02"
"67049","2022","COM","2020","1303","20","1323","2023-01-02"
"67050","2022","COM","2020","32","0","32","2023-01-02"
"67051","2022","COM","2020","310","11","321","2023-01-02"
"67052","2022","COM","2020","2430","65","2495","2023-01-02"
"67053","2022","COM","2020","323","10","333","2023-01-02"
"67054","2022","COM","2020","552","6","558","2023-01-02"
"67055","2022","COM","2020","1381","20","1401","2023-01-02"
"67056","2022","COM","2020","780","11","791","2023-01-02"
"67057","2022","COM","2020","172","6","178","2023-01-02"
"67058","2022","COM","2020","387","4","391","2023-01-02"
"67059","2022","COM","2020","382","7","389","2023-01-02"
"67060","2022","COM","2020","628","10","638","2023-01-02"
"67061","2022","COM","2020","3736","78","3814","2023-01-02"
"67062","2022","COM","2020","333","6","339","2023-01-02"
"67063","2022","COM","2020","650","16","666","2023-01-02"
"67065","2022","COM","2020","1343","14","1357","2023-01-02"
"67066","2022","COM","2020","2609","87","2696","2023-01-02"
"67067","2022","COM","2020","10061","104","10165","2023-01-02"
"67068","2022","COM","2020","282","3","285","2023-01-02"
"67069","2022","COM","2020","505","7","512","2023-01-02"
"67070","2022","COM","2020","277","4","281","2023-01-02"
"67071","2022","COM","2020","470","11","481","2023-01-02"
"67072","2022","COM","2020","660","22","682","2023-01-02"
"67073","2022","COM","2020","4206","87","4293","2023-01-02"
"67074","2022","COM","2020","640","18","658","2023-01-02"
"67075","2022","COM","2020","444","4","448","2023-01-02"
"67076","2022","COM","2020","473","9","482","2023-01-02"
"67077","2022","COM","2020","578","14","592","2023-01-02"
"67078","2022","COM","2020","278","3","281","2023-01-02"
"67079","2022","COM","2020","179","3","182","2023-01-02"
"67080","2022","COM","2020","1811","21","1832","2023-01-02"
"67081","2022","COM","2020","788","12","800","2023-01-02"
"67082","2022","COM","2020","1224","10","1234","2023-01-02"
"67083","2022","COM","2020","763","12","775","2023-01-02"
"67084","2022","COM","2020","2228","41","2269","2023-01-02"
"67085","2022","COM","2020","705","11","716","2023-01-02"
"67086","2022","COM","2020","448","10","458","2023-01-02"
"67087","2022","COM","2020","1441","15","1456","2023-01-02"
"67088","2022","COM","2020","349","7","356","2023-01-02"
"67089","2022","COM","2020","2595","33","2628","2023-01-02"
"67090","2022","COM","2020","672","43","715","2023-01-02"
"67091","2022","COM","2020","340","13","353","2023-01-02"
"67092","2022","COM","2020","633","26","659","2023-01-02"
"67093","2022","COM","2020","347","6","353","2023-01-02"
"67094","2022","COM","2020","251","2","253","2023-01-02"
"67095","2022","COM","2020","1598","34","1632","2023-01-02"
"67096","2022","COM","2020","322","11","333","2023-01-02"
"67097","2022","COM","2020","1210","18","1228","2023-01-02"
"67098","2022","COM","2020","1515","19","1534","2023-01-02"
"67099","2022","COM","2020","280","6","286","2023-01-02"
"67100","2022","COM","2020","354","1","355","2023-01-02"
"67101","2022","COM","2020","2605","32","2637","2023-01-02"
"67102","2022","COM","2020","308","4","312","2023-01-02"
"67103","2022","COM","2020","1039","25","1064","2023-01-02"
"67104","2022","COM","2020","602","14","616","2023-01-02"
"67105","2022","COM","2020","1429","27","1456","2023-01-02"
"67106","2022","COM","2020","5254","47","5301","2023-01-02"
"67107","2022","COM","2020","656","8","664","2023-01-02"
"67108","2022","COM","2020","1723","19","1742","2023-01-02"
"67109","2022","COM","2020","666","9","675","2023-01-02"
"67110","2022","COM","2020","1097","16","1113","2023-01-02"
"67111","2022","COM","2020","422","11","433","2023-01-02"
"67112","2022","COM","2020","2848","29","2877","2023-01-02"
"67113","2022","COM","2020","426","9","435","2023-01-02"
"67115","2022","COM","2020","2287","20","2307","2023-01-02"
"67116","2022","COM","2020","542","31","573","2023-01-02"
"67117","2022","COM","2020","430","3","433","2023-01-02"
"67118","2022","COM","2020","7143","65","7208","2023-01-02"
"67119","2022","COM","2020","1378","17","1395","2023-01-02"
"67120","2022","COM","2020","526","11","537","2023-01-02"
"67121","2022","COM","2020","802","11","813","2023-01-02"
"67122","2022","COM","2020","1335","18","1353","2023-01-02"
"67123","2022","COM","2020","486","4","490","2023-01-02"
"67124","2022","COM","2020","2485","25","2510","2023-01-02"
"67125","2022","COM","2020","2255","76","2331","2023-01-02"
"67126","2022","COM","2020","299","6","305","2023-01-02"
"67127","2022","COM","2020","1443","14","1457","2023-01-02"
"67128","2022","COM","2020","1887","17","1904","2023-01-02"
"67129","2022","COM","2020","595","6","601","2023-01-02"
"67130","2022","COM","2020","10739","111","10850","2023-01-02"
"67131","2022","COM","2020","5645","63","5708","2023-01-02"
"67132","2022","COM","2020","963","11","974","2023-01-02"
"67133","2022","COM","2020","466","12","478","2023-01-02"
"67134","2022","COM","2020","185","3","188","2023-01-02"
"67135","2022","COM","2020","759","5","764","2023-01-02"
"67136","2022","COM","2020","275","5","280","2023-01-02"
"67137","2022","COM","2020","5777","68","5845","2023-01-02"
"67138","2022","COM","2020","580","8","588","2023-01-02"
"67139","2022","COM","2020","483","9","492","2023-01-02"
"67140","2022","COM","2020","772","4","776","2023-01-02"
"67141","2022","COM","2020","594","4","598","2023-01-02"
"67142","2022","COM","2020","288","2","290","2023-01-02"
"67143","2022","COM","2020","636","19","655","2023-01-02"
"67144","2022","COM","2020","342","3","345","2023-01-02"
"67145","2022","COM","2020","270","6","276","2023-01-02"
"67146","2022","COM","2020","613","8","621","2023-01-02"
"67147","2022","COM","2020","495","5","500","2023-01-02"
"67148","2022","COM","2020","161","4","165","2023-01-02"
"67149","2022","COM","2020","421","7","428","2023-01-02"
"67150","2022","COM","2020","1458","24","1482","2023-01-02"
"67151","2022","COM","2020","5164","52","5216","2023-01-02"
"67152","2022","COM","2020","7603","79","7682","2023-01-02"
"67153","2022","COM","2020","392","3","395","2023-01-02"
"67154","2022","COM","2020","3452","56","3508","2023-01-02"
"67155","2022","COM","2020","1266","13","1279","2023-01-02"
"67156","2022","COM","2020","2631","24","2655","2023-01-02"
"67159","2022","COM","2020","204","6","210","2023-01-02"
"67160","2022","COM","2020","1057","28","1085","2023-01-02"
"67161","2022","COM","2020","376","11","387","2023-01-02"
"67162","2022","COM","2020","356","8","364","2023-01-02"
"67163","2022","COM","2020","543","13","556","2023-01-02"
"67164","2022","COM","2020","834","20","854","2023-01-02"
"67165","2022","COM","2020","376","8","384","2023-01-02"
"67166","2022","COM","2020","253","8","261","2023-01-02"
"67167","2022","COM","2020","1226","16","1242","2023-01-02"
"67168","2022","COM","2020","1650","26","1676","2023-01-02"
"67169","2022","COM","2020","2879","35","2914","2023-01-02"
"67172","2022","COM","2020","2266","31","2297","2023-01-02"
"67173","2022","COM","2020","1238","17","1255","2023-01-02"
"67174","2022","COM","2020","1148","21","1169","2023-01-02"
"67176","2022","COM","2020","3758","63","3821","2023-01-02"
"67177","2022","COM","2020","635","10","645","2023-01-02"
"67178","2022","COM","2020","283","4","287","2023-01-02"
"67179","2022","COM","2020","653","8","661","2023-01-02"
"67180","2022","COM","2020","35448","561","36009","2023-01-02"
"67181","2022","COM","2020","274","6","280","2023-01-02"
"67182","2022","COM","2020","1696","25","1721","2023-01-02"
"67183","2022","COM","2020","882","15","897","2023-01-02"
"67184","2022","COM","2020","1901","24","1925","2023-01-02"
"67185","2022","COM","2020","678","9","687","2023-01-02"
"67186","2022","COM","2020","437","6","443","2023-01-02"
"67187","2022","COM","2020","557","8","565","2023-01-02"
"67188","2022","COM","2020","703","11","714","2023-01-02"
"67189","2022","COM","2020","949","29","978","2023-01-02"
"67190","2022","COM","2020","197","2","199","2023-01-02"
"67191","2022","COM","2020","1840","26","1866","2023-01-02"
"67192","2022","COM","2020","946","11","957","2023-01-02"
"67194","2022","COM","2020","4666","71","4737","2023-01-02"
"67195","2022","COM","2020","616","10","626","2023-01-02"
"67196","2022","COM","2020","2638","36","2674","2023-01-02"
"67197","2022","COM","2020","1527","20","1547","2023-01-02"
"67198","2022","COM","2020","113","3","116","2023-01-02"
"67199","2022","COM","2020","80","1","81","2023-01-02"
"67200","2022","COM","2020","1000","7","1007","2023-01-02"
"67201","2022","COM","2020","302","4","306","2023-01-02"
"67202","2022","COM","2020","4045","56","4101","2023-01-02"
"67203","2022","COM","2020","396","3","399","2023-01-02"
"67204","2022","COM","2020","11446","85","11531","2023-01-02"
"67205","2022","COM","2020","4586","51","4637","2023-01-02"
"67206","2022","COM","2020","1137","18","1155","2023-01-02"
"67208","2022","COM","2020","543","7","550","2023-01-02"
"67209","2022","COM","2020","273","2","275","2023-01-02"
"67210","2022","COM","2020","504","12","516","2023-01-02"
"67212","2022","COM","2020","3821","29","3850","2023-01-02"
"67213","2022","COM","2020","624","16","640","2023-01-02"
"67214","2022","COM","2020","997","7","1004","2023-01-02"
"67215","2022","COM","2020","499","3","502","2023-01-02"
"67216","2022","COM","2020","2658","38","2696","2023-01-02"
"67217","2022","COM","2020","376","5","381","2023-01-02"
"67218","2022","COM","2020","27087","584","27671","2023-01-02"
"67220","2022","COM","2020","343","2","345","2023-01-02"
"67221","2022","COM","2020","348","5","353","2023-01-02"
"67222","2022","COM","2020","4029","38","4067","2023-01-02"
"67223","2022","COM","2020","1202","13","1215","2023-01-02"
"67225","2022","COM","2020","113","2","115","2023-01-02"
"67226","2022","COM","2020","2098","23","2121","2023-01-02"
"67227","2022","COM","2020","231","6","237","2023-01-02"
"67228","2022","COM","2020","787","17","804","2023-01-02"
"67229","2022","COM","2020","197","2","199","2023-01-02"
"67230","2022","COM","2020","2463","19","2482","2023-01-02"
"67231","2022","COM","2020","212","2","214","2023-01-02"
"67232","2022","COM","2020","204","6","210","2023-01-02"
"67233","2022","COM","2020","1197","20","1217","2023-01-02"
"67234","2022","COM","2020","1501","29","1530","2023-01-02"
"67235","2022","COM","2020","438","2","440","2023-01-02"
"67236","2022","COM","2020","545","10","555","2023-01-02"
"67237","2022","COM","2020","2503","36","2539","2023-01-02"
"67238","2022","COM","2020","641","6","647","2023-01-02"
"67239","2022","COM","2020","1670","27","1697","2023-01-02"
"67240","2022","COM","2020","712","12","724","2023-01-02"
"67241","2022","COM","2020","147","4","151","2023-01-02"
"67242","2022","COM","2020","535","5","540","2023-01-02"
"67244","2022","COM","2020","154","3","157","2023-01-02"
"67245","2022","COM","2020","199","3","202","2023-01-02"
"67246","2022","COM","2020","1274","18","1292","2023-01-02"
"67247","2022","COM","2020","986","21","1007","2023-01-02"
"67248","2022","COM","2020","1728","26","1754","2023-01-02"
"67249","2022","COM","2020","231","7","238","2023-01-02"
"67250","2022","COM","2020","787","16","803","2023-01-02"
"67252","2022","COM","2020","1076","13","1089","2023-01-02"
"67253","2022","COM","2020","644","9","653","2023-01-02"
"67254","2022","COM","2020","917","16","933","2023-01-02"
"67255","2022","COM","2020","482","9","491","2023-01-02"
"67256","2022","COM","2020","3459","54","3513","2023-01-02"
"67257","2022","COM","2020","703","15","718","2023-01-02"
"67258","2022","COM","2020","191","3","194","2023-01-02"
"67259","2022","COM","2020","912","11","923","2023-01-02"
"67260","2022","COM","2020","319","5","324","2023-01-02"
"67261","2022","COM","2020","2341","27","2368","2023-01-02"
"67263","2022","COM","2020","1551","42","1593","2023-01-02"
"67264","2022","COM","2020","828","12","840","2023-01-02"
"67265","2022","COM","2020","547","9","556","2023-01-02"
"67266","2022","COM","2020","688","8","696","2023-01-02"
"67267","2022","COM","2020","19797","146","19943","2023-01-02"
"67268","2022","COM","2020","2666","30","2696","2023-01-02"
"67269","2022","COM","2020","303","3","306","2023-01-02"
"67270","2022","COM","2020","381","4","385","2023-01-02"
"67271","2022","COM","2020","652","8","660","2023-01-02"
"67272","2022","COM","2020","393","6","399","2023-01-02"
"67273","2022","COM","2020","516","7","523","2023-01-02"
"67274","2022","COM","2020","240","4","244","2023-01-02"
"67275","2022","COM","2020","812","14","826","2023-01-02"
"67276","2022","COM","2020","1893","35","1928","2023-01-02"
"67277","2022","COM","2020","757","11","768","2023-01-02"
"67278","2022","COM","2020","543","12","555","2023-01-02"
"67279","2022","COM","2020","234","5","239","2023-01-02"
"67280","2022","COM","2020","795","18","813","2023-01-02"
"67281","2022","COM","2020","4234","42","4276","2023-01-02"
"67282","2022","COM","2020","4230","64","4294","2023-01-02"
"67283","2022","COM","2020","2712","44","2756","2023-01-02"
"67285","2022","COM","2020","1475","110","1585","2023-01-02"
"67286","2022","COM","2020","1494","19","1513","2023-01-02"
"67287","2022","COM","2020","575","11","586","2023-01-02"
"67288","2022","COM","2020","329","4","333","2023-01-02"
"67289","2022","COM","2020","634","11","645","2023-01-02"
"67290","2022","COM","2020","925","17","942","2023-01-02"
"67291","2022","COM","2020","3376","39","3415","2023-01-02"
"67292","2022","COM","2020","672","11","683","2023-01-02"
"67293","2022","COM","2020","681","12","693","2023-01-02"
"67295","2022","COM","2020","605","23","628","2023-01-02"
"67296","2022","COM","2020","2107","24","2131","2023-01-02"
"67298","2022","COM","2020","566","8","574","2023-01-02"
"67299","2022","COM","2020","896","25","921","2023-01-02"
"67300","2022","COM","2020","9352","126","9478","2023-01-02"
"67301","2022","COM","2020","2241","22","2263","2023-01-02"
"67302","2022","COM","2020","2013","36","2049","2023-01-02"
"67303","2022","COM","2020","680","12","692","2023-01-02"
"67304","2022","COM","2020","588","10","598","2023-01-02"
"67305","2022","COM","2020","1945","21","1966","2023-01-02"
"67306","2022","COM","2020","641","54","695","2023-01-02"
"67307","2022","COM","2020","450","5","455","2023-01-02"
"67308","2022","COM","2020","811","9","820","2023-01-02"
"67309","2022","COM","2020","4911","70","4981","2023-01-02"
"67310","2022","COM","2020","1154","20","1174","2023-01-02"
"67311","2022","COM","2020","2198","29","2227","2023-01-02"
"67312","2022","COM","2020","469","2","471","2023-01-02"
"67313","2022","COM","2020","6083","53","6136","2023-01-02"
"67314","2022","COM","2020","530","8","538","2023-01-02"
"67315","2022","COM","2020","670","14","684","2023-01-02"
"67317","2022","COM","2020","658","17","675","2023-01-02"
"67319","2022","COM","2020","395","3","398","2023-01-02"
"67320","2022","COM","2020","619","12","631","2023-01-02"
"67321","2022","COM","2020","326","8","334","2023-01-02"
"67322","2022","COM","2020","1107","13","1120","2023-01-02"
"67324","2022","COM","2020","4369","69","4438","2023-01-02"
"67325","2022","COM","2020","1395","17","1412","2023-01-02"
"67326","2022","COM","2020","1669","13","1682","2023-01-02"
"67327","2022","COM","2020","955","22","977","2023-01-02"
"67328","2022","COM","2020","883","7","890","2023-01-02"
"67329","2022","COM","2020","1267","22","1289","2023-01-02"
"67330","2022","COM","2020","916","14","930","2023-01-02"
"67331","2022","COM","2020","1365","18","1383","2023-01-02"
"67333","2022","COM","2020","292","5","297","2023-01-02"
"67334","2022","COM","2020","115","1","116","2023-01-02"
"67335","2022","COM","2020","932","14","946","2023-01-02"
"67336","2022","COM","2020","1739","30","1769","2023-01-02"
"67337","2022","COM","2020","455","16","471","2023-01-02"
"67338","2022","COM","2020","1371","23","1394","2023-01-02"
"67339","2022","COM","2020","4192","43","4235","2023-01-02"
"67340","2022","COM","2020","1508","20","1528","2023-01-02"
"67341","2022","COM","2020","404","2","406","2023-01-02"
"67342","2022","COM","2020","1763","29","1792","2023-01-02"
"67343","2022","COM","2020","5459","57","5516","2023-01-02"
"67344","2022","COM","2020","315","4","319","2023-01-02"
"67345","2022","COM","2020","3650","28","3678","2023-01-02"
"67346","2022","COM","2020","552","11","563","2023-01-02"
"67347","2022","COM","2020","1713","21","1734","2023-01-02"
"67348","2022","COM","2020","12015","456","12471","2023-01-02"
"67349","2022","COM","2020","524","6","530","2023-01-02"
"67350","2022","COM","2020","2438","27","2465","2023-01-02"
"67351","2022","COM","2020","1673","42","1715","2023-01-02"
"67352","2022","COM","2020","397","8","405","2023-01-02"
"67353","2022","COM","2020","232","3","235","2023-01-02"
"67354","2022","COM","2020","523","9","532","2023-01-02"
"67355","2022","COM","2020","1125","28","1153","2023-01-02"
"67356","2022","COM","2020","2506","32","2538","2023-01-02"
"67358","2022","COM","2020","805","13","818","2023-01-02"
"67359","2022","COM","2020","1309","23","1332","2023-01-02"
"67360","2022","COM","2020","1086","14","1100","2023-01-02"
"67361","2022","COM","2020","501","7","508","2023-01-02"
"67362","2022","COM","2020","603","12","615","2023-01-02"
"67363","2022","COM","2020","811","17","828","2023-01-02"
"67364","2022","COM","2020","924","16","940","2023-01-02"
"67365","2022","COM","2020","12985","133","13118","2023-01-02"
"67366","2022","COM","2020","795","19","814","2023-01-02"
"67367","2022","COM","2020","1311","32","1343","2023-01-02"
"67368","2022","COM","2020","1552","32","1584","2023-01-02"
"67369","2022","COM","2020","255","1","256","2023-01-02"
"67370","2022","COM","2020","665","12","677","2023-01-02"
"67371","2022","COM","2020","623","3","626","2023-01-02"
"67372","2022","COM","2020","5012","63","5075","2023-01-02"
"67373","2022","COM","2020","322","4","326","2023-01-02"
"67375","2022","COM","2020","1304","17","1321","2023-01-02"
"67377","2022","COM","2020","999","11","1010","2023-01-02"
"67378","2022","COM","2020","4475","48","4523","2023-01-02"
"67379","2022","COM","2020","898","16","914","2023-01-02"
"67380","2022","COM","2020","204","4","208","2023-01-02"
"67381","2022","COM","2020","361","5","366","2023-01-02"
"67382","2022","COM","2020","772","17","789","2023-01-02"
"67383","2022","COM","2020","197","5","202","2023-01-02"
"67384","2022","COM","2020","309","7","316","2023-01-02"
"67385","2022","COM","2020","241","2","243","2023-01-02"
"67386","2022","COM","2020","208","2","210","2023-01-02"
"67387","2022","COM","2020","300","9","309","2023-01-02"
"67388","2022","COM","2020","5416","78","5494","2023-01-02"
"67389","2022","COM","2020","4389","42","4431","2023-01-02"
"67391","2022","COM","2020","450","6","456","2023-01-02"
"67392","2022","COM","2020","846","13","859","2023-01-02"
"67394","2022","COM","2020","276","6","282","2023-01-02"
"67395","2022","COM","2020","398","10","408","2023-01-02"
"67396","2022","COM","2020","202","1","203","2023-01-02"
"67397","2022","COM","2020","2651","31","2682","2023-01-02"
"67398","2022","COM","2020","364","2","366","2023-01-02"
"67400","2022","COM","2020","1119","19","1138","2023-01-02"
"67401","2022","COM","2020","309","9","318","2023-01-02"
"67403","2022","COM","2020","459","10","469","2023-01-02"
"67404","2022","COM","2020","910","16","926","2023-01-02"
"67405","2022","COM","2020","2283","51","2334","2023-01-02"
"67406","2022","COM","2020","351","3","354","2023-01-02"
"67407","2022","COM","2020","1598","13","1611","2023-01-02"
"67408","2022","COM","2020","1192","17","1209","2023-01-02"
"67409","2022","COM","2020","1014","8","1022","2023-01-02"
"67410","2022","COM","2020","652","14","666","2023-01-02"
"67411","2022","COM","2020","5312","115","5427","2023-01-02"
"67412","2022","COM","2020","1019","9","1028","2023-01-02"
"67413","2022","COM","2020","505","13","518","2023-01-02"
"67414","2022","COM","2020","1529","22","1551","2023-01-02"
"67415","2022","COM","2020","471","2","473","2023-01-02"
"67416","2022","COM","2020","468","10","478","2023-01-02"
"67417","2022","COM","2020","296","9","305","2023-01-02"
"67418","2022","COM","2020","1953","31","1984","2023-01-02"
"67420","2022","COM","2020","1241","15","1256","2023-01-02"
"67421","2022","COM","2020","824","11","835","2023-01-02"
"67422","2022","COM","2020","588","10","598","2023-01-02"
"67423","2022","COM","2020","597","7","604","2023-01-02"
"67424","2022","COM","2020","250","0","250","2023-01-02"
"67425","2022","COM","2020","535","13","548","2023-01-02"
"67426","2022","COM","2020","364","1","365","2023-01-02"
"67427","2022","COM","2020","338","14","352","2023-01-02"
"67428","2022","COM","2020","498","7","505","2023-01-02"
"67429","2022","COM","2020","617","10","627","2023-01-02"
"67430","2022","COM","2020","752","25","777","2023-01-02"
"67432","2022","COM","2020","586","10","596","2023-01-02"
"67433","2022","COM","2020","1389","10","1399","2023-01-02"
"67434","2022","COM","2020","2791","45","2836","2023-01-02"
"67435","2022","COM","2020","831","21","852","2023-01-02"
"67436","2022","COM","2020","497","12","509","2023-01-02"
"67437","2022","COM","2020","11303","299","11602","2023-01-02"
"67438","2022","COM","2020","810","13","823","2023-01-02"
"67440","2022","COM","2020","557","12","569","2023-01-02"
"67441","2022","COM","2020","335","5","340","2023-01-02"
"67442","2022","COM","2020","1243","61","1304","2023-01-02"
"67443","2022","COM","2020","853","20","873","2023-01-02"
"67444","2022","COM","2020","118","3","121","2023-01-02"
"67445","2022","COM","2020","3185","59","3244","2023-01-02"
"67446","2022","COM","2020","424","11","435","2023-01-02"
"67447","2022","COM","2020","33993","213","34206","2023-01-02"
"67448","2022","COM","2020","2132","48","2180","2023-01-02"
"67449","2022","COM","2020","2271","22","2293","2023-01-02"
"67450","2022","COM","2020","715","16","731","2023-01-02"
"67451","2022","COM","2020","1383","32","1415","2023-01-02"
"67452","2022","COM","2020","1783","33","1816","2023-01-02"
"67453","2022","COM","2020","620","8","628","2023-01-02"
"67454","2022","COM","2020","386","7","393","2023-01-02"
"67455","2022","COM","2020","694","11","705","2023-01-02"
"67456","2022","COM","2020","438","16","454","2023-01-02"
"67458","2022","COM","2020","4983","62","5045","2023-01-02"
"67459","2022","COM","2020","747","17","764","2023-01-02"
"67460","2022","COM","2020","1754","21","1775","2023-01-02"
"67461","2022","COM","2020","329","14","343","2023-01-02"
"67462","2022","COM","2020","19279","251","19530","2023-01-02"
"67463","2022","COM","2020","3150","35","3185","2023-01-02"
"67464","2022","COM","2020","945","13","958","2023-01-02"
"67465","2022","COM","2020","2319","26","2345","2023-01-02"
"67466","2022","COM","2020","507","9","516","2023-01-02"
"67467","2022","COM","2020","381","7","388","2023-01-02"
"67468","2022","COM","2020","619","16","635","2023-01-02"
"67470","2022","COM","2020","97","1","98","2023-01-02"
"67471","2022","COM","2020","8057","63","8120","2023-01-02"
"67472","2022","COM","2020","4796","54","4850","2023-01-02"
"67473","2022","COM","2020","956","18","974","2023-01-02"
"67474","2022","COM","2020","3169","37","3206","2023-01-02"
"67475","2022","COM","2020","234","4","238","2023-01-02"
"67476","2022","COM","2020","749","5","754","2023-01-02"
"67477","2022","COM","2020","614","11","625","2023-01-02"
"67478","2022","COM","2020","1934","29","1963","2023-01-02"
"67479","2022","COM","2020","602","11","613","2023-01-02"
"67480","2022","COM","2020","1806","26","1832","2023-01-02"
"67481","2022","COM","2020","1081","14","1095","2023-01-02"
"67482","2022","COM","2020","290576","2962","293538","2023-01-02"
"67483","2022","COM","2020","224","4","228","2023-01-02"
"67484","2022","COM","2020","484","10","494","2023-01-02"
"67485","2022","COM","2020","1662","27","1689","2023-01-02"
"67486","2022","COM","2020","1837","20","1857","2023-01-02"
"67487","2022","COM","2020","1715","26","1741","2023-01-02"
"67488","2022","COM","2020","184","4","188","2023-01-02"
"67489","2022","COM","2020","828","17","845","2023-01-02"
"67490","2022","COM","2020","598","17","615","2023-01-02"
"67491","2022","COM","2020","250","1","251","2023-01-02"
"67492","2022","COM","2020","651","17","668","2023-01-02"
"67493","2022","COM","2020","436","10","446","2023-01-02"
"67494","2022","COM","2020","583","11","594","2023-01-02"
"67495","2022","COM","2020","4386","101","4487","2023-01-02"
"67497","2022","COM","2020","684","14","698","2023-01-02"
"67498","2022","COM","2020","707","7","714","2023-01-02"
"67499","2022","COM","2020","316","14","330","2023-01-02"
"67500","2022","COM","2020","1452","37","1489","2023-01-02"
"67501","2022","COM","2020","561","4","565","2023-01-02"
"67502","2022","COM","2020","209","1","210","2023-01-02"
"67503","2022","COM","2020","160","2","162","2023-01-02"
"67504","2022","COM","2020","1383","10","1393","2023-01-02"
"67505","2022","COM","2020","401","13","414","2023-01-02"
"67506","2022","COM","2020","6010","70","6080","2023-01-02"
"67507","2022","COM","2020","1786","32","1818","2023-01-02"
"67508","2022","COM","2020","420","18","438","2023-01-02"
"67509","2022","COM","2020","350","3","353","2023-01-02"
"67510","2022","COM","2020","603","4","607","2023-01-02"
"67511","2022","COM","2020","935","251","1186","2023-01-02"
"67513","2022","COM","2020","126","1","127","2023-01-02"
"67514","2022","COM","2020","638","9","647","2023-01-02"
"67515","2022","COM","2020","562","9","571","2023-01-02"
"67516","2022","COM","2020","670","7","677","2023-01-02"
"67517","2022","COM","2020","654","11","665","2023-01-02"
"67519","2022","COM","2020","5909","113","6022","2023-01-02"
"67520","2022","COM","2020","5755","66","5821","2023-01-02"
"67521","2022","COM","2020","459","3","462","2023-01-02"
"67522","2022","COM","2020","548","8","556","2023-01-02"
"67523","2022","COM","2020","2738","36","2774","2023-01-02"
"67524","2022","COM","2020","521","8","529","2023-01-02"
"67525","2022","COM","2020","1653","24","1677","2023-01-02"
"67526","2022","COM","2020","1599","17","1616","2023-01-02"
"67527","2022","COM","2020","349","7","356","2023-01-02"
"67528","2022","COM","2020","548","13","561","2023-01-02"
"67529","2022","COM","2020","3419","34","3453","2023-01-02"
"67530","2022","COM","2020","383","6","389","2023-01-02"
"67531","2022","COM","2020","284","6","290","2023-01-02"
"67532","2022","COM","2020","1081","17","1098","2023-01-02"
"67534","2022","COM","2020","735","3","738","2023-01-02"
"67535","2022","COM","2020","1055","21","1076","2023-01-02"
"67536","2022","COM","2020","163","1","164","2023-01-02"
"67537","2022","COM","2020","449","6","455","2023-01-02"
"67538","2022","COM","2020","1581","24","1605","2023-01-02"
"67539","2022","COM","2020","2339","39","2378","2023-01-02"
"67540","2022","COM","2020","864","12","876","2023-01-02"
"67541","2022","COM","2020","532","2","534","2023-01-02"
"67542","2022","COM","2020","516","4","520","2023-01-02"
"67543","2022","COM","2020","2077","29","2106","2023-01-02"
"67544","2022","COM","2020","7492","217","7709","2023-01-02"
"67545","2022","COM","2020","501","6","507","2023-01-02"
"67546","2022","COM","2020","691","5","696","2023-01-02"
"67547","2022","COM","2020","2067","30","2097","2023-01-02"
"67548","2022","COM","2020","873","14","887","2023-01-02"
"67550","2022","COM","2020","1716","24","1740","2023-01-02"
"67551","2022","COM","2020","4171","55","4226","2023-01-02"
"67552","2022","COM","2020","350","10","360","2023-01-02"
"67553","2022","COM","2020","317","4","321","2023-01-02"
"67554","2022","COM","2020","967","13","980","2023-01-02"
"67555","2022","COM","2020","248","3","251","2023-01-02"
"67556","2022","COM","2020","210","3","213","2023-01-02"
"67557","2022","COM","2020","807","12","819","2023-01-02"
"67558","2022","COM","2020","737","13","750","2023-01-02"
"67559","2022","COM","2020","253","2","255","2023-01-02"
"68001","2022","COM","2020","1125","11","1136","2023-01-02"
"68002","2022","COM","2020","390","4","394","2023-01-02"
"68004","2022","COM","2020","5658","129","5787","2023-01-02"
"68005","2022","COM","2020","1705","33","1738","2023-01-02"
"68006","2022","COM","2020","1208","29","1237","2023-01-02"
"68007","2022","COM","2020","2192","73","2265","2023-01-02"
"68008","2022","COM","2020","580","12","592","2023-01-02"
"68009","2022","COM","2020","864","11","875","2023-01-02"
"68010","2022","COM","2020","1127","22","1149","2023-01-02"
"68011","2022","COM","2020","1302","26","1328","2023-01-02"
"68012","2022","COM","2020","1767","44","1811","2023-01-02"
"68013","2022","COM","2020","989","23","1012","2023-01-02"
"68014","2022","COM","2020","363","10","373","2023-01-02"
"68015","2022","COM","2020","2636","49","2685","2023-01-02"
"68016","2022","COM","2020","970","14","984","2023-01-02"
"68017","2022","COM","2020","812","17","829","2023-01-02"
"68018","2022","COM","2020","749","17","766","2023-01-02"
"68019","2022","COM","2020","562","9","571","2023-01-02"
"68020","2022","COM","2020","1605","32","1637","2023-01-02"
"68021","2022","COM","2020","4062","87","4149","2023-01-02"
"68022","2022","COM","2020","1580","21","1601","2023-01-02"
"68023","2022","COM","2020","938","22","960","2023-01-02"
"68024","2022","COM","2020","148","5","153","2023-01-02"
"68025","2022","COM","2020","245","3","248","2023-01-02"
"68026","2022","COM","2020","1373","23","1396","2023-01-02"
"68027","2022","COM","2020","341","11","352","2023-01-02"
"68028","2022","COM","2020","2072","48","2120","2023-01-02"
"68029","2022","COM","2020","1103","32","1135","2023-01-02"
"68030","2022","COM","2020","413","12","425","2023-01-02"
"68032","2022","COM","2020","1204","37","1241","2023-01-02"
"68033","2022","COM","2020","448","8","456","2023-01-02"
"68034","2022","COM","2020","310","15","325","2023-01-02"
"68035","2022","COM","2020","325","7","332","2023-01-02"
"68036","2022","COM","2020","2510","55","2565","2023-01-02"
"68037","2022","COM","2020","478","9","487","2023-01-02"
"68038","2022","COM","2020","1134","25","1159","2023-01-02"
"68039","2022","COM","2020","543","14","557","2023-01-02"
"68040","2022","COM","2020","2002","37","2039","2023-01-02"
"68041","2022","COM","2020","1986","26","2012","2023-01-02"
"68042","2022","COM","2020","4777","121","4898","2023-01-02"
"68043","2022","COM","2020","4119","55","4174","2023-01-02"
"68044","2022","COM","2020","745","20","765","2023-01-02"
"68045","2022","COM","2020","552","16","568","2023-01-02"
"68046","2022","COM","2020","415","9","424","2023-01-02"
"68049","2022","COM","2020","429","15","444","2023-01-02"
"68050","2022","COM","2020","405","14","419","2023-01-02"
"68051","2022","COM","2020","819","14","833","2023-01-02"
"68052","2022","COM","2020","186","3","189","2023-01-02"
"68054","2022","COM","2020","421","8","429","2023-01-02"
"68055","2022","COM","2020","1048","34","1082","2023-01-02"
"68056","2022","COM","2020","8168","129","8297","2023-01-02"
"68057","2022","COM","2020","267","9","276","2023-01-02"
"68058","2022","COM","2020","3277","49","3326","2023-01-02"
"68059","2022","COM","2020","1928","43","1971","2023-01-02"
"68060","2022","COM","2020","1744","46","1790","2023-01-02"
"68061","2022","COM","2020","1066","17","1083","2023-01-02"
"68062","2022","COM","2020","2082","90","2172","2023-01-02"
"68063","2022","COM","2020","11559","210","11769","2023-01-02"
"68064","2022","COM","2020","978","9","987","2023-01-02"
"68065","2022","COM","2020","690","12","702","2023-01-02"
"68066","2022","COM","2020","68294","1104","69398","2023-01-02"
"68067","2022","COM","2020","350","2","352","2023-01-02"
"68068","2022","COM","2020","2266","39","2305","2023-01-02"
"68069","2022","COM","2020","1477","20","1497","2023-01-02"
"68071","2022","COM","2020","284","6","290","2023-01-02"
"68072","2022","COM","2020","1422","53","1475","2023-01-02"
"68073","2022","COM","2020","475","11","486","2023-01-02"
"68074","2022","COM","2020","552","7","559","2023-01-02"
"68075","2022","COM","2020","829","16","845","2023-01-02"
"68076","2022","COM","2020","1009","12","1021","2023-01-02"
"68077","2022","COM","2020","378","10","388","2023-01-02"
"68078","2022","COM","2020","1722","41","1763","2023-01-02"
"68079","2022","COM","2020","256","0","256","2023-01-02"
"68080","2022","COM","2020","307","3","310","2023-01-02"
"68081","2022","COM","2020","579","10","589","2023-01-02"
"68082","2022","COM","2020","7475","70","7545","2023-01-02"
"68083","2022","COM","2020","368","8","376","2023-01-02"
"68084","2022","COM","2020","1476","46","1522","2023-01-02"
"68085","2022","COM","2020","381","6","387","2023-01-02"
"68086","2022","COM","2020","208","3","211","2023-01-02"
"68087","2022","COM","2020","460","11","471","2023-01-02"
"68088","2022","COM","2020","999","16","1015","2023-01-02"
"68089","2022","COM","2020","1599","26","1625","2023-01-02"
"68090","2022","COM","2020","820","13","833","2023-01-02"
"68091","2022","COM","2020","2282","46","2328","2023-01-02"
"68092","2022","COM","2020","399","6","405","2023-01-02"
"68093","2022","COM","2020","1415","35","1450","2023-01-02"
"68094","2022","COM","2020","928","19","947","2023-01-02"
"68095","2022","COM","2020","1162","40","1202","2023-01-02"
"68096","2022","COM","2020","370","5","375","2023-01-02"
"68097","2022","COM","2020","1310","33","1343","2023-01-02"
"68098","2022","COM","2020","656","7","663","2023-01-02"
"68099","2022","COM","2020","831","18","849","2023-01-02"
"68100","2022","COM","2020","340","14","354","2023-01-02"
"68101","2022","COM","2020","816","23","839","2023-01-02"
"68102","2022","COM","2020","438","10","448","2023-01-02"
"68103","2022","COM","2020","505","12","517","2023-01-02"
"68104","2022","COM","2020","309","5","314","2023-01-02"
"68105","2022","COM","2020","261","14","275","2023-01-02"
"68106","2022","COM","2020","276","6","282","2023-01-02"
"68107","2022","COM","2020","382","8","390","2023-01-02"
"68109","2022","COM","2020","691","14","705","2023-01-02"
"68110","2022","COM","2020","794","18","812","2023-01-02"
"68111","2022","COM","2020","859","26","885","2023-01-02"
"68112","2022","COM","2020","10988","293","11281","2023-01-02"
"68113","2022","COM","2020","1432","28","1460","2023-01-02"
"68114","2022","COM","2020","144","1","145","2023-01-02"
"68115","2022","COM","2020","1312","29","1341","2023-01-02"
"68116","2022","COM","2020","725","22","747","2023-01-02"
"68117","2022","COM","2020","880","16","896","2023-01-02"
"68118","2022","COM","2020","5052","90","5142","2023-01-02"
"68119","2022","COM","2020","753","16","769","2023-01-02"
"68120","2022","COM","2020","1275","28","1303","2023-01-02"
"68121","2022","COM","2020","719","15","734","2023-01-02"
"68122","2022","COM","2020","646","10","656","2023-01-02"
"68123","2022","COM","2020","809","12","821","2023-01-02"
"68124","2022","COM","2020","378","10","388","2023-01-02"
"68125","2022","COM","2020","529","9","538","2023-01-02"
"68126","2022","COM","2020","3362","73","3435","2023-01-02"
"68127","2022","COM","2020","666","14","680","2023-01-02"
"68128","2022","COM","2020","659","9","668","2023-01-02"
"68129","2022","COM","2020","1333","50","1383","2023-01-02"
"68130","2022","COM","2020","1047","22","1069","2023-01-02"
"68131","2022","COM","2020","164","1","165","2023-01-02"
"68132","2022","COM","2020","728","17","745","2023-01-02"
"68134","2022","COM","2020","1870","28","1898","2023-01-02"
"68135","2022","COM","2020","2804","57","2861","2023-01-02"
"68136","2022","COM","2020","332","12","344","2023-01-02"
"68137","2022","COM","2020","616","11","627","2023-01-02"
"68138","2022","COM","2020","2120","50","2170","2023-01-02"
"68139","2022","COM","2020","1477","22","1499","2023-01-02"
"68140","2022","COM","2020","1313","15","1328","2023-01-02"
"68141","2022","COM","2020","2179","55","2234","2023-01-02"
"68142","2022","COM","2020","375","13","388","2023-01-02"
"68143","2022","COM","2020","1843","60","1903","2023-01-02"
"68144","2022","COM","2020","1348","26","1374","2023-01-02"
"68145","2022","COM","2020","6244","121","6365","2023-01-02"
"68146","2022","COM","2020","2405","23","2428","2023-01-02"
"68147","2022","COM","2020","587","15","602","2023-01-02"
"68148","2022","COM","2020","359","18","377","2023-01-02"
"68149","2022","COM","2020","7283","96","7379","2023-01-02"
"68150","2022","COM","2020","509","15","524","2023-01-02"
"68151","2022","COM","2020","1049","11","1060","2023-01-02"
"68152","2022","COM","2020","2464","65","2529","2023-01-02"
"68153","2022","COM","2020","727","13","740","2023-01-02"
"68154","2022","COM","2020","14380","205","14585","2023-01-02"
"68155","2022","COM","2020","4680","75","4755","2023-01-02"
"68156","2022","COM","2020","3449","57","3506","2023-01-02"
"68157","2022","COM","2020","1349","39","1388","2023-01-02"
"68158","2022","COM","2020","500","15","515","2023-01-02"
"68159","2022","COM","2020","917","25","942","2023-01-02"
"68160","2022","COM","2020","584","24","608","2023-01-02"
"68161","2022","COM","2020","538","23","561","2023-01-02"
"68162","2022","COM","2020","4412","93","4505","2023-01-02"
"68163","2022","COM","2020","5617","104","5721","2023-01-02"
"68165","2022","COM","2020","239","10","249","2023-01-02"
"68166","2022","COM","2020","13230","161","13391","2023-01-02"
"68167","2022","COM","2020","728","21","749","2023-01-02"
"68168","2022","COM","2020","373","7","380","2023-01-02"
"68169","2022","COM","2020","504","10","514","2023-01-02"
"68170","2022","COM","2020","580","24","604","2023-01-02"
"68171","2022","COM","2020","937","12","949","2023-01-02"
"68172","2022","COM","2020","1820","30","1850","2023-01-02"
"68173","2022","COM","2020","2111","76","2187","2023-01-02"
"68174","2022","COM","2020","1646","27","1673","2023-01-02"
"68175","2022","COM","2020","1851","39","1890","2023-01-02"
"68176","2022","COM","2020","327","7","334","2023-01-02"
"68177","2022","COM","2020","1479","38","1517","2023-01-02"
"68178","2022","COM","2020","951","14","965","2023-01-02"
"68179","2022","COM","2020","915","15","930","2023-01-02"
"68180","2022","COM","2020","918","29","947","2023-01-02"
"68181","2022","COM","2020","250","4","254","2023-01-02"
"68182","2022","COM","2020","1246","28","1274","2023-01-02"
"68183","2022","COM","2020","179","4","183","2023-01-02"
"68184","2022","COM","2020","299","5","304","2023-01-02"
"68185","2022","COM","2020","1664","30","1694","2023-01-02"
"68186","2022","COM","2020","310","8","318","2023-01-02"
"68187","2022","COM","2020","339","9","348","2023-01-02"
"68188","2022","COM","2020","584","16","600","2023-01-02"
"68189","2022","COM","2020","874","27","901","2023-01-02"
"68190","2022","COM","2020","33","0","33","2023-01-02"
"68191","2022","COM","2020","751","22","773","2023-01-02"
"68192","2022","COM","2020","431","7","438","2023-01-02"
"68193","2022","COM","2020","758","9","767","2023-01-02"
"68194","2022","COM","2020","286","5","291","2023-01-02"
"68195","2022","COM","2020","6237","102","6339","2023-01-02"
"68196","2022","COM","2020","295","8","303","2023-01-02"
"68197","2022","COM","2020","495","10","505","2023-01-02"
"68198","2022","COM","2020","290","8","298","2023-01-02"
"68199","2022","COM","2020","501","2","503","2023-01-02"
"68200","2022","COM","2020","536","12","548","2023-01-02"
"68201","2022","COM","2020","3682","77","3759","2023-01-02"
"68202","2022","COM","2020","196","4","200","2023-01-02"
"68203","2022","COM","2020","1275","27","1302","2023-01-02"
"68204","2022","COM","2020","1042","15","1057","2023-01-02"
"68205","2022","COM","2020","2005","21","2026","2023-01-02"
"68207","2022","COM","2020","701","14","715","2023-01-02"
"68208","2022","COM","2020","590","12","602","2023-01-02"
"68209","2022","COM","2020","842","16","858","2023-01-02"
"68210","2022","COM","2020","332","4","336","2023-01-02"
"68211","2022","COM","2020","384","8","392","2023-01-02"
"68212","2022","COM","2020","516","12","528","2023-01-02"
"68213","2022","COM","2020","339","9","348","2023-01-02"
"68214","2022","COM","2020","375","8","383","2023-01-02"
"68215","2022","COM","2020","911","7","918","2023-01-02"
"68216","2022","COM","2020","411","6","417","2023-01-02"
"68217","2022","COM","2020","1622","21","1643","2023-01-02"
"68218","2022","COM","2020","3648","72","3720","2023-01-02"
"68219","2022","COM","2020","878","24","902","2023-01-02"
"68221","2022","COM","2020","929","20","949","2023-01-02"
"68222","2022","COM","2020","1076","20","1096","2023-01-02"
"68223","2022","COM","2020","795","17","812","2023-01-02"
"68224","2022","COM","2020","108038","1247","109285","2023-01-02"
"68225","2022","COM","2020","1577","28","1605","2023-01-02"
"68226","2022","COM","2020","4711","83","4794","2023-01-02"
"68227","2022","COM","2020","1284","28","1312","2023-01-02"
"68228","2022","COM","2020","459","12","471","2023-01-02"
"68229","2022","COM","2020","164","3","167","2023-01-02"
"68230","2022","COM","2020","583","7","590","2023-01-02"
"68231","2022","COM","2020","1955","15","1970","2023-01-02"
"68232","2022","COM","2020","495","7","502","2023-01-02"
"68234","2022","COM","2020","738","11","749","2023-01-02"
"68235","2022","COM","2020","1148","16","1164","2023-01-02"
"68237","2022","COM","2020","557","15","572","2023-01-02"
"68238","2022","COM","2020","953","26","979","2023-01-02"
"68239","2022","COM","2020","391","13","404","2023-01-02"
"68240","2022","COM","2020","1269","18","1287","2023-01-02"
"68241","2022","COM","2020","686","10","696","2023-01-02"
"68242","2022","COM","2020","1266","25","1291","2023-01-02"
"68243","2022","COM","2020","139","1","140","2023-01-02"
"68244","2022","COM","2020","378","6","384","2023-01-02"
"68245","2022","COM","2020","405","15","420","2023-01-02"
"68246","2022","COM","2020","1025","13","1038","2023-01-02"
"68247","2022","COM","2020","1256","14","1270","2023-01-02"
"68248","2022","COM","2020","674","20","694","2023-01-02"
"68249","2022","COM","2020","3461","66","3527","2023-01-02"
"68250","2022","COM","2020","1042","18","1060","2023-01-02"
"68251","2022","COM","2020","842","22","864","2023-01-02"
"68252","2022","COM","2020","1660","29","1689","2023-01-02"
"68253","2022","COM","2020","1985","33","2018","2023-01-02"
"68254","2022","COM","2020","826","18","844","2023-01-02"
"68255","2022","COM","2020","1350","42","1392","2023-01-02"
"68256","2022","COM","2020","10054","131","10185","2023-01-02"
"68257","2022","COM","2020","957","24","981","2023-01-02"
"68258","2022","COM","2020","3097","79","3176","2023-01-02"
"68259","2022","COM","2020","504","11","515","2023-01-02"
"68260","2022","COM","2020","1121","25","1146","2023-01-02"
"68261","2022","COM","2020","228","6","234","2023-01-02"
"68262","2022","COM","2020","796","17","813","2023-01-02"
"68263","2022","COM","2020","630","13","643","2023-01-02"
"68264","2022","COM","2020","627","19","646","2023-01-02"
"68265","2022","COM","2020","800","24","824","2023-01-02"
"68266","2022","COM","2020","2006","29","2035","2023-01-02"
"68267","2022","COM","2020","1986","25","2011","2023-01-02"
"68268","2022","COM","2020","701","10","711","2023-01-02"
"68269","2022","COM","2020","4670","177","4847","2023-01-02"
"68270","2022","COM","2020","3680","59","3739","2023-01-02"
"68271","2022","COM","2020","12258","304","12562","2023-01-02"
"68273","2022","COM","2020","626","41","667","2023-01-02"
"68274","2022","COM","2020","195","2","197","2023-01-02"
"68275","2022","COM","2020","437","11","448","2023-01-02"
"68276","2022","COM","2020","194","4","198","2023-01-02"
"68277","2022","COM","2020","1061","22","1083","2023-01-02"
"68278","2022","COM","2020","14020","225","14245","2023-01-02"
"68279","2022","COM","2020","910","30","940","2023-01-02"
"68280","2022","COM","2020","381","6","387","2023-01-02"
"68281","2022","COM","2020","465","13","478","2023-01-02"
"68282","2022","COM","2020","280","5","285","2023-01-02"
"68283","2022","COM","2020","776","14","790","2023-01-02"
"68284","2022","COM","2020","686","11","697","2023-01-02"
"68285","2022","COM","2020","367","8","375","2023-01-02"
"68286","2022","COM","2020","2371","49","2420","2023-01-02"
"68287","2022","COM","2020","4187","229","4416","2023-01-02"
"68288","2022","COM","2020","406","4","410","2023-01-02"
"68289","2022","COM","2020","2384","37","2421","2023-01-02"
"68290","2022","COM","2020","902","19","921","2023-01-02"
"68291","2022","COM","2020","1049","26","1075","2023-01-02"
"68292","2022","COM","2020","2217","38","2255","2023-01-02"
"68293","2022","COM","2020","81","1","82","2023-01-02"
"68294","2022","COM","2020","1857","30","1887","2023-01-02"
"68295","2022","COM","2020","3024","67","3091","2023-01-02"
"68296","2022","COM","2020","980","14","994","2023-01-02"
"68297","2022","COM","2020","22835","287","23122","2023-01-02"
"68298","2022","COM","2020","5054","128","5182","2023-01-02"
"68299","2022","COM","2020","310","0","310","2023-01-02"
"68300","2022","COM","2020","5487","124","5611","2023-01-02"
"68301","2022","COM","2020","1271","24","1295","2023-01-02"
"68302","2022","COM","2020","744","30","774","2023-01-02"
"68303","2022","COM","2020","226","7","233","2023-01-02"
"68304","2022","COM","2020","1564","39","1603","2023-01-02"
"68305","2022","COM","2020","1391","28","1419","2023-01-02"
"68306","2022","COM","2020","503","7","510","2023-01-02"
"68307","2022","COM","2020","498","10","508","2023-01-02"
"68308","2022","COM","2020","327","4","331","2023-01-02"
"68309","2022","COM","2020","3994","63","4057","2023-01-02"
"68311","2022","COM","2020","600","12","612","2023-01-02"
"68312","2022","COM","2020","317","6","323","2023-01-02"
"68313","2022","COM","2020","774","11","785","2023-01-02"
"68315","2022","COM","2020","7033","143","7176","2023-01-02"
"68316","2022","COM","2020","728","21","749","2023-01-02"
"68317","2022","COM","2020","1096","20","1116","2023-01-02"
"68318","2022","COM","2020","2379","53","2432","2023-01-02"
"68320","2022","COM","2020","1398","47","1445","2023-01-02"
"68321","2022","COM","2020","4053","35","4088","2023-01-02"
"68322","2022","COM","2020","1350","29","1379","2023-01-02"
"68323","2022","COM","2020","830","24","854","2023-01-02"
"68324","2022","COM","2020","631","19","650","2023-01-02"
"68325","2022","COM","2020","761","9","770","2023-01-02"
"68326","2022","COM","2020","151","5","156","2023-01-02"
"68327","2022","COM","2020","345","8","353","2023-01-02"
"68328","2022","COM","2020","196","6","202","2023-01-02"
"68329","2022","COM","2020","1341","31","1372","2023-01-02"
"68330","2022","COM","2020","341","6","347","2023-01-02"
"68331","2022","COM","2020","1955","58","2013","2023-01-02"
"68332","2022","COM","2020","953","13","966","2023-01-02"
"68333","2022","COM","2020","293","6","299","2023-01-02"
"68334","2022","COM","2020","7784","148","7932","2023-01-02"
"68335","2022","COM","2020","469","6","475","2023-01-02"
"68336","2022","COM","2020","455","8","463","2023-01-02"
"68337","2022","COM","2020","619","11","630","2023-01-02"
"68338","2022","COM","2020","3820","82","3902","2023-01-02"
"68340","2022","COM","2020","369","16","385","2023-01-02"
"68341","2022","COM","2020","989","30","1019","2023-01-02"
"68342","2022","COM","2020","1650","42","1692","2023-01-02"
"68343","2022","COM","2020","2422","33","2455","2023-01-02"
"68344","2022","COM","2020","439","10","449","2023-01-02"
"68345","2022","COM","2020","778","27","805","2023-01-02"
"68347","2022","COM","2020","676","13","689","2023-01-02"
"68348","2022","COM","2020","2836","37","2873","2023-01-02"
"68349","2022","COM","2020","4486","95","4581","2023-01-02"
"68350","2022","COM","2020","473","15","488","2023-01-02"
"68351","2022","COM","2020","634","13","647","2023-01-02"
"68352","2022","COM","2020","2691","29","2720","2023-01-02"
"68353","2022","COM","2020","487","17","504","2023-01-02"
"68354","2022","COM","2020","918","36","954","2023-01-02"
"68355","2022","COM","2020","1544","28","1572","2023-01-02"
"68356","2022","COM","2020","883","20","903","2023-01-02"
"68357","2022","COM","2020","513","16","529","2023-01-02"
"68358","2022","COM","2020","475","11","486","2023-01-02"
"68359","2022","COM","2020","1678","59","1737","2023-01-02"
"68360","2022","COM","2020","673","4","677","2023-01-02"
"68361","2022","COM","2020","319","4","323","2023-01-02"
"68362","2022","COM","2020","774","15","789","2023-01-02"
"68363","2022","COM","2020","609","12","621","2023-01-02"
"68364","2022","COM","2020","998","23","1021","2023-01-02"
"68365","2022","COM","2020","1775","65","1840","2023-01-02"
"68366","2022","COM","2020","697","30","727","2023-01-02"
"68367","2022","COM","2020","1195","21","1216","2023-01-02"
"68368","2022","COM","2020","1231","36","1267","2023-01-02"
"68370","2022","COM","2020","163","2","165","2023-01-02"
"68371","2022","COM","2020","307","9","316","2023-01-02"
"68372","2022","COM","2020","1777","39","1816","2023-01-02"
"68373","2022","COM","2020","296","12","308","2023-01-02"
"68374","2022","COM","2020","7933","324","8257","2023-01-02"
"68375","2022","COM","2020","10358","142","10500","2023-01-02"
"68376","2022","COM","2020","15065","101","15166","2023-01-02"
"68377","2022","COM","2020","796","19","815","2023-01-02"
"68378","2022","COM","2020","373","4","377","2023-01-02"
"68379","2022","COM","2020","1099","21","1120","2023-01-02"
"68380","2022","COM","2020","440","10","450","2023-01-02"
"68381","2022","COM","2020","789","9","798","2023-01-02"
"68382","2022","COM","2020","391","4","395","2023-01-02"
"68383","2022","COM","2020","319","8","327","2023-01-02"
"68384","2022","COM","2020","2524","61","2585","2023-01-02"
"68385","2022","COM","2020","832","24","856","2023-01-02"
"68386","2022","COM","2020","1053","22","1075","2023-01-02"
"69001","2022","COM","2020","393","4","397","2023-01-02"
"69002","2022","COM","2020","244","1","245","2023-01-02"
"69003","2022","COM","2020","2982","43","3025","2023-01-02"
"69004","2022","COM","2020","766","23","789","2023-01-02"
"69005","2022","COM","2020","589","10","599","2023-01-02"
"69006","2022","COM","2020","4906","112","5018","2023-01-02"
"69007","2022","COM","2020","2743","44","2787","2023-01-02"
"69008","2022","COM","2020","675","15","690","2023-01-02"
"69009","2022","COM","2020","7754","153","7907","2023-01-02"
"69010","2022","COM","2020","6437","154","6591","2023-01-02"
"69012","2022","COM","2020","606","15","621","2023-01-02"
"69013","2022","COM","2020","4063","85","4148","2023-01-02"
"69014","2022","COM","2020","1122","19","1141","2023-01-02"
"69016","2022","COM","2020","121","4","125","2023-01-02"
"69017","2022","COM","2020","745","20","765","2023-01-02"
"69018","2022","COM","2020","2144","32","2176","2023-01-02"
"69019","2022","COM","2020","13336","280","13616","2023-01-02"
"69020","2022","COM","2020","693","10","703","2023-01-02"
"69021","2022","COM","2020","2346","78","2424","2023-01-02"
"69022","2022","COM","2020","549","15","564","2023-01-02"
"69023","2022","COM","2020","1646","26","1672","2023-01-02"
"69024","2022","COM","2020","4157","101","4258","2023-01-02"
"69026","2022","COM","2020","542","7","549","2023-01-02"
"69027","2022","COM","2020","12403","169","12572","2023-01-02"
"69028","2022","COM","2020","6589","113","6702","2023-01-02"
"69029","2022","COM","2020","42442","377","42819","2023-01-02"
"69030","2022","COM","2020","819","14","833","2023-01-02"
"69031","2022","COM","2020","1374","104","1478","2023-01-02"
"69032","2022","COM","2020","2005","37","2042","2023-01-02"
"69033","2022","COM","2020","2879","73","2952","2023-01-02"
"69034","2022","COM","2020","43355","574","43929","2023-01-02"
"69035","2022","COM","2020","379","7","386","2023-01-02"
"69036","2022","COM","2020","1135","23","1158","2023-01-02"
"69037","2022","COM","2020","830","12","842","2023-01-02"
"69038","2022","COM","2020","924","23","947","2023-01-02"
"69039","2022","COM","2020","697","9","706","2023-01-02"
"69040","2022","COM","2020","5749","44","5793","2023-01-02"
"69042","2022","COM","2020","570","15","585","2023-01-02"
"69043","2022","COM","2020","8887","178","9065","2023-01-02"
"69044","2022","COM","2020","5237","148","5385","2023-01-02"
"69045","2022","COM","2020","1253","67","1320","2023-01-02"
"69046","2022","COM","2020","4585","138","4723","2023-01-02"
"69047","2022","COM","2020","1047","21","1068","2023-01-02"
"69049","2022","COM","2020","2833","65","2898","2023-01-02"
"69050","2022","COM","2020","2114","42","2156","2023-01-02"
"69051","2022","COM","2020","1200","34","1234","2023-01-02"
"69052","2022","COM","2020","4153","117","4270","2023-01-02"
"69053","2022","COM","2020","542","13","555","2023-01-02"
"69054","2022","COM","2020","354","2","356","2023-01-02"
"69055","2022","COM","2020","1505","28","1533","2023-01-02"
"69056","2022","COM","2020","2080","89","2169","2023-01-02"
"69057","2022","COM","2020","583","13","596","2023-01-02"
"69058","2022","COM","2020","380","11","391","2023-01-02"
"69059","2022","COM","2020","1550","29","1579","2023-01-02"
"69060","2022","COM","2020","570","82","652","2023-01-02"
"69061","2022","COM","2020","1199","34","1233","2023-01-02"
"69062","2022","COM","2020","782","24","806","2023-01-02"
"69063","2022","COM","2020","4448","91","4539","2023-01-02"
"69064","2022","COM","2020","3949","82","4031","2023-01-02"
"69065","2022","COM","2020","977","15","992","2023-01-02"
"69066","2022","COM","2020","4366","91","4457","2023-01-02"
"69067","2022","COM","2020","1169","23","1192","2023-01-02"
"69068","2022","COM","2020","2455","44","2499","2023-01-02"
"69069","2022","COM","2020","11453","204","11657","2023-01-02"
"69070","2022","COM","2020","1296","24","1320","2023-01-02"
"69071","2022","COM","2020","1182","26","1208","2023-01-02"
"69072","2022","COM","2020","8829","630","9459","2023-01-02"
"69074","2022","COM","2020","1568","39","1607","2023-01-02"
"69075","2022","COM","2020","191","2","193","2023-01-02"
"69076","2022","COM","2020","2551","99","2650","2023-01-02"
"69077","2022","COM","2020","1035","16","1051","2023-01-02"
"69078","2022","COM","2020","839","16","855","2023-01-02"
"69080","2022","COM","2020","1914","15","1929","2023-01-02"
"69081","2022","COM","2020","18789","353","19142","2023-01-02"
"69082","2022","COM","2020","277","8","285","2023-01-02"
"69083","2022","COM","2020","1159","40","1199","2023-01-02"
"69084","2022","COM","2020","1300","24","1324","2023-01-02"
"69085","2022","COM","2020","1491","42","1533","2023-01-02"
"69086","2022","COM","2020","2272","63","2335","2023-01-02"
"69087","2022","COM","2020","3015","73","3088","2023-01-02"
"69088","2022","COM","2020","7065","94","7159","2023-01-02"
"69089","2022","COM","2020","14821","225","15046","2023-01-02"
"69090","2022","COM","2020","841","22","863","2023-01-02"
"69091","2022","COM","2020","20672","126","20798","2023-01-02"
"69092","2022","COM","2020","7495","348","7843","2023-01-02"
"69093","2022","COM","2020","1185","20","1205","2023-01-02"
"69094","2022","COM","2020","6029","115","6144","2023-01-02"
"69095","2022","COM","2020","824","16","840","2023-01-02"
"69096","2022","COM","2020","9739","75","9814","2023-01-02"
"69097","2022","COM","2020","773","19","792","2023-01-02"
"69098","2022","COM","2020","496","9","505","2023-01-02"
"69099","2022","COM","2020","1436","24","1460","2023-01-02"
"69100","2022","COM","2020","8805","119","8924","2023-01-02"
"69102","2022","COM","2020","756","10","766","2023-01-02"
"69103","2022","COM","2020","886","18","904","2023-01-02"
"69104","2022","COM","2020","454","5","459","2023-01-02"
"69105","2022","COM","2020","1007","36","1043","2023-01-02"
"69106","2022","COM","2020","1209","24","1233","2023-01-02"
"69107","2022","COM","2020","1049","64","1113","2023-01-02"
"69108","2022","COM","2020","1043","21","1064","2023-01-02"
"69109","2022","COM","2020","851","26","877","2023-01-02"
"69110","2022","COM","2020","1848","34","1882","2023-01-02"
"69111","2022","COM","2020","681","18","699","2023-01-02"
"69112","2022","COM","2020","6510","157","6667","2023-01-02"
"69113","2022","COM","2020","900","27","927","2023-01-02"
"69115","2022","COM","2020","4830","93","4923","2023-01-02"
"69116","2022","COM","2020","3742","108","3850","2023-01-02"
"69117","2022","COM","2020","3157","73","3230","2023-01-02"
"69118","2022","COM","2020","2660","34","2694","2023-01-02"
"69119","2022","COM","2020","977","8","985","2023-01-02"
"69120","2022","COM","2020","596","16","612","2023-01-02"
"69121","2022","COM","2020","2880","44","2924","2023-01-02"
"69122","2022","COM","2020","1969","54","2023","2023-01-02"
"69123","2022","COM","2020","522228","6405","528633","2023-01-02"
"69124","2022","COM","2020","457","10","467","2023-01-02"
"69125","2022","COM","2020","880","16","896","2023-01-02"
"69126","2022","COM","2020","805","21","826","2023-01-02"
"69127","2022","COM","2020","3495","63","3558","2023-01-02"
"69130","2022","COM","2020","232","2","234","2023-01-02"
"69131","2022","COM","2020","3523","88","3611","2023-01-02"
"69132","2022","COM","2020","843","14","857","2023-01-02"
"69133","2022","COM","2020","4313","79","4392","2023-01-02"
"69134","2022","COM","2020","230","10","240","2023-01-02"
"69135","2022","COM","2020","1914","53","1967","2023-01-02"
"69136","2022","COM","2020","3180","56","3236","2023-01-02"
"69137","2022","COM","2020","534","6","540","2023-01-02"
"69138","2022","COM","2020","445","8","453","2023-01-02"
"69139","2022","COM","2020","1379","65","1444","2023-01-02"
"69140","2022","COM","2020","2086","54","2140","2023-01-02"
"69141","2022","COM","2020","6238","175","6413","2023-01-02"
"69142","2022","COM","2020","6617","73","6690","2023-01-02"
"69143","2022","COM","2020","7635","65","7700","2023-01-02"
"69145","2022","COM","2020","932","26","958","2023-01-02"
"69148","2022","COM","2020","2549","71","2620","2023-01-02"
"69149","2022","COM","2020","26994","269","27263","2023-01-02"
"69151","2022","COM","2020","1492","31","1523","2023-01-02"
"69152","2022","COM","2020","10508","47","10555","2023-01-02"
"69153","2022","COM","2020","1400","28","1428","2023-01-02"
"69154","2022","COM","2020","2868","53","2921","2023-01-02"
"69155","2022","COM","2020","1131","29","1160","2023-01-02"
"69156","2022","COM","2020","2685","81","2766","2023-01-02"
"69157","2022","COM","2020","5280","124","5404","2023-01-02"
"69159","2022","COM","2020","3951","93","4044","2023-01-02"
"69160","2022","COM","2020","1047","20","1067","2023-01-02"
"69161","2022","COM","2020","485","11","496","2023-01-02"
"69162","2022","COM","2020","1354","35","1389","2023-01-02"
"69163","2022","COM","2020","3502","51","3553","2023-01-02"
"69164","2022","COM","2020","323","10","333","2023-01-02"
"69165","2022","COM","2020","1137","19","1156","2023-01-02"
"69166","2022","COM","2020","334","1","335","2023-01-02"
"69167","2022","COM","2020","588","10","598","2023-01-02"
"69168","2022","COM","2020","1540","40","1580","2023-01-02"
"69169","2022","COM","2020","645","24","669","2023-01-02"
"69170","2022","COM","2020","1160","19","1179","2023-01-02"
"69171","2022","COM","2020","2434","31","2465","2023-01-02"
"69172","2022","COM","2020","766","27","793","2023-01-02"
"69173","2022","COM","2020","1002","24","1026","2023-01-02"
"69174","2022","COM","2020","612","11","623","2023-01-02"
"69175","2022","COM","2020","1988","54","2042","2023-01-02"
"69176","2022","COM","2020","4613","83","4696","2023-01-02"
"69177","2022","COM","2020","2083","44","2127","2023-01-02"
"69178","2022","COM","2020","806","18","824","2023-01-02"
"69179","2022","COM","2020","4074","76","4150","2023-01-02"
"69180","2022","COM","2020","283","9","292","2023-01-02"
"69181","2022","COM","2020","229","1","230","2023-01-02"
"69182","2022","COM","2020","361","4","365","2023-01-02"
"69183","2022","COM","2020","316","2","318","2023-01-02"
"69184","2022","COM","2020","997","21","1018","2023-01-02"
"69186","2022","COM","2020","207","4","211","2023-01-02"
"69187","2022","COM","2020","653","20","673","2023-01-02"
"69188","2022","COM","2020","907","9","916","2023-01-02"
"69189","2022","COM","2020","1986","31","2017","2023-01-02"
"69190","2022","COM","2020","2065","88","2153","2023-01-02"
"69191","2022","COM","2020","5686","145","5831","2023-01-02"
"69192","2022","COM","2020","153","7","160","2023-01-02"
"69193","2022","COM","2020","1272","33","1305","2023-01-02"
"69194","2022","COM","2020","7124","181","7305","2023-01-02"
"69196","2022","COM","2020","609","13","622","2023-01-02"
"69197","2022","COM","2020","2212","48","2260","2023-01-02"
"69198","2022","COM","2020","764","11","775","2023-01-02"
"69199","2022","COM","2020","19500","56","19556","2023-01-02"
"69200","2022","COM","2020","1494","20","1514","2023-01-02"
"69201","2022","COM","2020","1287","22","1309","2023-01-02"
"69202","2022","COM","2020","22077","375","22452","2023-01-02"
"69203","2022","COM","2020","1000","17","1017","2023-01-02"
"69204","2022","COM","2020","20971","468","21439","2023-01-02"
"69205","2022","COM","2020","5229","95","5324","2023-01-02"
"69206","2022","COM","2020","4403","94","4497","2023-01-02"
"69207","2022","COM","2020","2981","49","3030","2023-01-02"
"69208","2022","COM","2020","2247","62","2309","2023-01-02"
"69209","2022","COM","2020","556","13","569","2023-01-02"
"69212","2022","COM","2020","476","11","487","2023-01-02"
"69214","2022","COM","2020","1196","24","1220","2023-01-02"
"69215","2022","COM","2020","897","21","918","2023-01-02"
"69216","2022","COM","2020","570","9","579","2023-01-02"
"69217","2022","COM","2020","748","21","769","2023-01-02"
"69218","2022","COM","2020","1042","17","1059","2023-01-02"
"69219","2022","COM","2020","2129","61","2190","2023-01-02"
"69220","2022","COM","2020","1798","112","1910","2023-01-02"
"69225","2022","COM","2020","539","14","553","2023-01-02"
"69227","2022","COM","2020","3860","182","4042","2023-01-02"
"69228","2022","COM","2020","4223","71","4294","2023-01-02"
"69229","2022","COM","2020","792","16","808","2023-01-02"
"69230","2022","COM","2020","314","6","320","2023-01-02"
"69231","2022","COM","2020","2576","60","2636","2023-01-02"
"69233","2022","COM","2020","1235","46","1281","2023-01-02"
"69234","2022","COM","2020","1619","69","1688","2023-01-02"
"69235","2022","COM","2020","1972","106","2078","2023-01-02"
"69236","2022","COM","2020","596","6","602","2023-01-02"
"69238","2022","COM","2020","3704","93","3797","2023-01-02"
"69239","2022","COM","2020","1190","32","1222","2023-01-02"
"69240","2022","COM","2020","612","5","617","2023-01-02"
"69241","2022","COM","2020","2637","62","2699","2023-01-02"
"69242","2022","COM","2020","903","12","915","2023-01-02"
"69243","2022","COM","2020","10572","261","10833","2023-01-02"
"69244","2022","COM","2020","22475","320","22795","2023-01-02"
"69245","2022","COM","2020","712","25","737","2023-01-02"
"69246","2022","COM","2020","1324","37","1361","2023-01-02"
"69248","2022","COM","2020","5944","117","6061","2023-01-02"
"69249","2022","COM","2020","3111","64","3175","2023-01-02"
"69250","2022","COM","2020","4249","101","4350","2023-01-02"
"69252","2022","COM","2020","746","9","755","2023-01-02"
"69253","2022","COM","2020","646","10","656","2023-01-02"
"69254","2022","COM","2020","973","12","985","2023-01-02"
"69255","2022","COM","2020","6082","111","6193","2023-01-02"
"69256","2022","COM","2020","51761","229","51990","2023-01-02"
"69257","2022","COM","2020","1108","26","1134","2023-01-02"
"69258","2022","COM","2020","320","5","325","2023-01-02"
"69259","2022","COM","2020","66765","252","67017","2023-01-02"
"69260","2022","COM","2020","5105","57","5162","2023-01-02"
"69261","2022","COM","2020","103","1","104","2023-01-02"
"69263","2022","COM","2020","880","17","897","2023-01-02"
"69264","2022","COM","2020","36009","410","36419","2023-01-02"
"69265","2022","COM","2020","803","32","835","2023-01-02"
"69266","2022","COM","2020","154781","1077","155858","2023-01-02"
"69267","2022","COM","2020","2129","114","2243","2023-01-02"
"69268","2022","COM","2020","3402","93","3495","2023-01-02"
"69269","2022","COM","2020","980","24","1004","2023-01-02"
"69270","2022","COM","2020","4411","71","4482","2023-01-02"
"69271","2022","COM","2020","10844","140","10984","2023-01-02"
"69272","2022","COM","2020","4455","89","4544","2023-01-02"
"69273","2022","COM","2020","11161","80","11241","2023-01-02"
"69275","2022","COM","2020","28913","150","29063","2023-01-02"
"69276","2022","COM","2020","9926","50","9976","2023-01-02"
"69277","2022","COM","2020","13195","250","13445","2023-01-02"
"69278","2022","COM","2020","5519","107","5626","2023-01-02"
"69279","2022","COM","2020","6083","75","6158","2023-01-02"
"69280","2022","COM","2020","1537","13","1550","2023-01-02"
"69281","2022","COM","2020","1947","29","1976","2023-01-02"
"69282","2022","COM","2020","35134","334","35468","2023-01-02"
"69283","2022","COM","2020","13684","152","13836","2023-01-02"
"69284","2022","COM","2020","3205","116","3321","2023-01-02"
"69285","2022","COM","2020","4190","38","4228","2023-01-02"
"69286","2022","COM","2020","30887","323","31210","2023-01-02"
"69287","2022","COM","2020","6876","107","6983","2023-01-02"
"69288","2022","COM","2020","5609","68","5677","2023-01-02"
"69289","2022","COM","2020","4616","82","4698","2023-01-02"
"69290","2022","COM","2020","48318","294","48612","2023-01-02"
"69291","2022","COM","2020","5850","56","5906","2023-01-02"
"69292","2022","COM","2020","6678","60","6738","2023-01-02"
"69293","2022","COM","2020","2409","47","2456","2023-01-02"
"69294","2022","COM","2020","2906","39","2945","2023-01-02"
"69295","2022","COM","2020","1823","9","1832","2023-01-02"
"69296","2022","COM","2020","3034","45","3079","2023-01-02"
"69297","2022","COM","2020","5511","73","5584","2023-01-02"
"69298","2022","COM","2020","3204","28","3232","2023-01-02"
"69299","2022","COM","2020","2744","43","2787","2023-01-02"
"69381","2022","ARM","2020","29303","805","30108","2023-01-02"
"69382","2022","ARM","2020","30318","312","30630","2023-01-02"
"69383","2022","ARM","2020","101838","951","102789","2023-01-02"
"69384","2022","ARM","2020","35683","411","36094","2023-01-02"
"69385","2022","ARM","2020","49546","1060","50606","2023-01-02"
"69386","2022","ARM","2020","52621","827","53448","2023-01-02"
"69387","2022","ARM","2020","84310","478","84788","2023-01-02"
"69388","2022","ARM","2020","85980","1016","86996","2023-01-02"
"69389","2022","ARM","2020","52629","545","53174","2023-01-02"
"70001","2022","COM","2020","350","7","357","2023-01-02"
"70002","2022","COM","2020","212","2","214","2023-01-02"
"70003","2022","COM","2020","69","2","71","2023-01-02"
"70004","2022","COM","2020","310","1","311","2023-01-02"
"70005","2022","COM","2020","130","2","132","2023-01-02"
"70006","2022","COM","2020","1488","101","1589","2023-01-02"
"70007","2022","COM","2020","305","6","311","2023-01-02"
"70008","2022","COM","2020","148","2","150","2023-01-02"
"70009","2022","COM","2020","99","1","100","2023-01-02"
"70010","2022","COM","2020","101","0","101","2023-01-02"
"70011","2022","COM","2020","313","3","316","2023-01-02"
"70012","2022","COM","2020","660","6","666","2023-01-02"
"70013","2022","COM","2020","66","0","66","2023-01-02"
"70014","2022","COM","2020","415","5","420","2023-01-02"
"70015","2022","COM","2020","271","5","276","2023-01-02"
"70016","2022","COM","2020","163","2","165","2023-01-02"
"70017","2022","COM","2020","240","4","244","2023-01-02"
"70018","2022","COM","2020","516","4","520","2023-01-02"
"70019","2022","COM","2020","142","4","146","2023-01-02"
"70020","2022","COM","2020","244","2","246","2023-01-02"
"70021","2022","COM","2020","187","4","191","2023-01-02"
"70022","2022","COM","2020","148","3","151","2023-01-02"
"70023","2022","COM","2020","142","2","144","2023-01-02"
"70024","2022","COM","2020","439","15","454","2023-01-02"
"70025","2022","COM","2020","241","3","244","2023-01-02"
"70026","2022","COM","2020","2492","45","2537","2023-01-02"
"70027","2022","COM","2020","71","1","72","2023-01-02"
"70028","2022","COM","2020","142","3","145","2023-01-02"
"70029","2022","COM","2020","235","2","237","2023-01-02"
"70030","2022","COM","2020","47","1","48","2023-01-02"
"70031","2022","COM","2020","639","15","654","2023-01-02"
"70032","2022","COM","2020","45","0","45","2023-01-02"
"70035","2022","COM","2020","175","4","179","2023-01-02"
"70036","2022","COM","2020","155","2","157","2023-01-02"
"70037","2022","COM","2020","259","20","279","2023-01-02"
"70038","2022","COM","2020","312","8","320","2023-01-02"
"70039","2022","COM","2020","365","4","369","2023-01-02"
"70040","2022","COM","2020","241","3","244","2023-01-02"
"70041","2022","COM","2020","385","8","393","2023-01-02"
"70042","2022","COM","2020","99","1","100","2023-01-02"
"70043","2022","COM","2020","236","3","239","2023-01-02"
"70044","2022","COM","2020","403","12","415","2023-01-02"
"70045","2022","COM","2020","420","6","426","2023-01-02"
"70046","2022","COM","2020","365","11","376","2023-01-02"
"70047","2022","COM","2020","109","2","111","2023-01-02"
"70048","2022","COM","2020","136","2","138","2023-01-02"
"70049","2022","COM","2020","98","2","100","2023-01-02"
"70050","2022","COM","2020","98","0","98","2023-01-02"
"70051","2022","COM","2020","33","0","33","2023-01-02"
"70052","2022","COM","2020","119","3","122","2023-01-02"
"70053","2022","COM","2020","76","1","77","2023-01-02"
"70054","2022","COM","2020","239","4","243","2023-01-02"
"70055","2022","COM","2020","494","7","501","2023-01-02"
"70056","2022","COM","2020","317","1","318","2023-01-02"
"70057","2022","COM","2020","152","3","155","2023-01-02"
"70058","2022","COM","2020","929","14","943","2023-01-02"
"70059","2022","COM","2020","472","8","480","2023-01-02"
"70060","2022","COM","2020","288","3","291","2023-01-02"
"70061","2022","COM","2020","86","0","86","2023-01-02"
"70062","2022","COM","2020","144","5","149","2023-01-02"
"70063","2022","COM","2020","209","3","212","2023-01-02"
"70064","2022","COM","2020","145","1","146","2023-01-02"
"70065","2022","COM","2020","74","1","75","2023-01-02"
"70066","2022","COM","2020","181","4","185","2023-01-02"
"70067","2022","COM","2020","122","0","122","2023-01-02"
"70069","2022","COM","2020","44","0","44","2023-01-02"
"70070","2022","COM","2020","27","0","27","2023-01-02"
"70071","2022","COM","2020","58","1","59","2023-01-02"
"70072","2022","COM","2020","84","2","86","2023-01-02"
"70074","2022","COM","2020","241","2","243","2023-01-02"
"70075","2022","COM","2020","198","3","201","2023-01-02"
"70076","2022","COM","2020","373","8","381","2023-01-02"
"70077","2022","COM","2020","220","4","224","2023-01-02"
"70078","2022","COM","2020","93","2","95","2023-01-02"
"70079","2022","COM","2020","514","13","527","2023-01-02"
"70080","2022","COM","2020","237","4","241","2023-01-02"
"70081","2022","COM","2020","307","6","313","2023-01-02"
"70082","2022","COM","2020","124","2","126","2023-01-02"
"70083","2022","COM","2020","404","7","411","2023-01-02"
"70084","2022","COM","2020","649","11","660","2023-01-02"
"70085","2022","COM","2020","692","13","705","2023-01-02"
"70086","2022","COM","2020","75","0","75","2023-01-02"
"70087","2022","COM","2020","150","2","152","2023-01-02"
"70088","2022","COM","2020","114","2","116","2023-01-02"
"70089","2022","COM","2020","46","0","46","2023-01-02"
"70090","2022","COM","2020","62","2","64","2023-01-02"
"70091","2022","COM","2020","46","1","47","2023-01-02"
"70092","2022","COM","2020","179","3","182","2023-01-02"
"70093","2022","COM","2020","652","8","660","2023-01-02"
"70094","2022","COM","2020","304","4","308","2023-01-02"
"70095","2022","COM","2020","635","16","651","2023-01-02"
"70096","2022","COM","2020","633","17","650","2023-01-02"
"70097","2022","COM","2020","237","6","243","2023-01-02"
"70098","2022","COM","2020","207","3","210","2023-01-02"
"70099","2022","COM","2020","77","1","78","2023-01-02"
"70100","2022","COM","2020","127","0","127","2023-01-02"
"70101","2022","COM","2020","505","5","510","2023-01-02"
"70102","2022","COM","2020","278","9","287","2023-01-02"
"70103","2022","COM","2020","204","7","211","2023-01-02"
"70104","2022","COM","2020","586","15","601","2023-01-02"
"70105","2022","COM","2020","138","1","139","2023-01-02"
"70106","2022","COM","2020","109","2","111","2023-01-02"
"70107","2022","COM","2020","443","4","447","2023-01-02"
"70109","2022","COM","2020","307","2","309","2023-01-02"
"70111","2022","COM","2020","277","3","280","2023-01-02"
"70112","2022","COM","2020","172","6","178","2023-01-02"
"70113","2022","COM","2020","132","3","135","2023-01-02"
"70114","2022","COM","2020","204","2","206","2023-01-02"
"70115","2022","COM","2020","237","4","241","2023-01-02"
"70116","2022","COM","2020","615","12","627","2023-01-02"
"70117","2022","COM","2020","1243","31","1274","2023-01-02"
"70118","2022","COM","2020","196","2","198","2023-01-02"
"70119","2022","COM","2020","354","11","365","2023-01-02"
"70120","2022","COM","2020","3717","73","3790","2023-01-02"
"70121","2022","COM","2020","851","29","880","2023-01-02"
"70122","2022","COM","2020","1634","32","1666","2023-01-02"
"70124","2022","COM","2020","87","1","88","2023-01-02"
"70125","2022","COM","2020","176","6","182","2023-01-02"
"70126","2022","COM","2020","195","6","201","2023-01-02"
"70127","2022","COM","2020","106","5","111","2023-01-02"
"70128","2022","COM","2020","390","3","393","2023-01-02"
"70129","2022","COM","2020","157","4","161","2023-01-02"
"70130","2022","COM","2020","309","8","317","2023-01-02"
"70132","2022","COM","2020","704","67","771","2023-01-02"
"70133","2022","COM","2020","234","7","241","2023-01-02"
"70134","2022","COM","2020","205","2","207","2023-01-02"
"70135","2022","COM","2020","33","1","34","2023-01-02"
"70136","2022","COM","2020","493","9","502","2023-01-02"
"70137","2022","COM","2020","220","3","223","2023-01-02"
"70138","2022","COM","2020","124","3","127","2023-01-02"
"70140","2022","COM","2020","69","1","70","2023-01-02"
"70141","2022","COM","2020","118","5","123","2023-01-02"
"70142","2022","COM","2020","191","2","193","2023-01-02"
"70143","2022","COM","2020","125","6","131","2023-01-02"
"70144","2022","COM","2020","33","1","34","2023-01-02"
"70145","2022","COM","2020","491","11","502","2023-01-02"
"70146","2022","COM","2020","167","4","171","2023-01-02"
"70147","2022","COM","2020","222","4","226","2023-01-02"
"70148","2022","COM","2020","86","1","87","2023-01-02"
"70149","2022","COM","2020","695","18","713","2023-01-02"
"70150","2022","COM","2020","324","2","326","2023-01-02"
"70151","2022","COM","2020","35","0","35","2023-01-02"
"70152","2022","COM","2020","475","39","514","2023-01-02"
"70153","2022","COM","2020","97","1","98","2023-01-02"
"70154","2022","COM","2020","367","6","373","2023-01-02"
"70155","2022","COM","2020","792","15","807","2023-01-02"
"70156","2022","COM","2020","111","1","112","2023-01-02"
"70157","2022","COM","2020","352","10","362","2023-01-02"
"70158","2022","COM","2020","105","1","106","2023-01-02"
"70159","2022","COM","2020","90","0","90","2023-01-02"
"70160","2022","COM","2020","312","19","331","2023-01-02"
"70162","2022","COM","2020","464","13","477","2023-01-02"
"70163","2022","COM","2020","439","8","447","2023-01-02"
"70164","2022","COM","2020","82","1","83","2023-01-02"
"70165","2022","COM","2020","544","42","586","2023-01-02"
"70166","2022","COM","2020","150","5","155","2023-01-02"
"70167","2022","COM","2020","350","13","363","2023-01-02"
"70168","2022","COM","2020","603","9","612","2023-01-02"
"70169","2022","COM","2020","221","5","226","2023-01-02"
"70170","2022","COM","2020","119","1","120","2023-01-02"
"70171","2022","COM","2020","1257","28","1285","2023-01-02"
"70172","2022","COM","2020","109","2","111","2023-01-02"
"70174","2022","COM","2020","143","2","145","2023-01-02"
"70175","2022","COM","2020","135","3","138","2023-01-02"
"70176","2022","COM","2020","183","0","183","2023-01-02"
"70177","2022","COM","2020","596","15","611","2023-01-02"
"70178","2022","COM","2020","526","9","535","2023-01-02"
"70179","2022","COM","2020","166","4","170","2023-01-02"
"70180","2022","COM","2020","442","8","450","2023-01-02"
"70181","2022","COM","2020","134","0","134","2023-01-02"
"70182","2022","COM","2020","135","1","136","2023-01-02"
"70183","2022","COM","2020","60","0","60","2023-01-02"
"70184","2022","COM","2020","719","21","740","2023-01-02"
"70185","2022","COM","2020","186","0","186","2023-01-02"
"70186","2022","COM","2020","72","1","73","2023-01-02"
"70187","2022","COM","2020","258","1","259","2023-01-02"
"70188","2022","COM","2020","52","1","53","2023-01-02"
"70189","2022","COM","2020","251","4","255","2023-01-02"
"70190","2022","COM","2020","185","3","188","2023-01-02"
"70192","2022","COM","2020","206","4","210","2023-01-02"
"70193","2022","COM","2020","231","2","233","2023-01-02"
"70194","2022","COM","2020","132","4","136","2023-01-02"
"70195","2022","COM","2020","273","4","277","2023-01-02"
"70196","2022","COM","2020","246","8","254","2023-01-02"
"70197","2022","COM","2020","792","17","809","2023-01-02"
"70198","2022","COM","2020","1234","24","1258","2023-01-02"
"70199","2022","COM","2020","120","0","120","2023-01-02"
"70200","2022","COM","2020","42","1","43","2023-01-02"
"70201","2022","COM","2020","203","5","208","2023-01-02"
"70202","2022","COM","2020","271","7","278","2023-01-02"
"70203","2022","COM","2020","153","2","155","2023-01-02"
"70204","2022","COM","2020","151","4","155","2023-01-02"
"70205","2022","COM","2020","201","2","203","2023-01-02"
"70206","2022","COM","2020","564","7","571","2023-01-02"
"70207","2022","COM","2020","3235","68","3303","2023-01-02"
"70208","2022","COM","2020","290","5","295","2023-01-02"
"70210","2022","COM","2020","152","5","157","2023-01-02"
"70211","2022","COM","2020","64","2","66","2023-01-02"
"70213","2022","COM","2020","220","6","226","2023-01-02"
"70214","2022","COM","2020","122","3","125","2023-01-02"
"70215","2022","COM","2020","242","11","253","2023-01-02"
"70216","2022","COM","2020","445","24","469","2023-01-02"
"70217","2022","COM","2020","97","1","98","2023-01-02"
"70218","2022","COM","2020","132","5","137","2023-01-02"
"70219","2022","COM","2020","734","15","749","2023-01-02"
"70220","2022","COM","2020","404","7","411","2023-01-02"
"70221","2022","COM","2020","288","4","292","2023-01-02"
"70222","2022","COM","2020","85","0","85","2023-01-02"
"70224","2022","COM","2020","684","14","698","2023-01-02"
"70225","2022","COM","2020","100","2","102","2023-01-02"
"70226","2022","COM","2020","311","3","314","2023-01-02"
"70227","2022","COM","2020","467","13","480","2023-01-02"
"70228","2022","COM","2020","980","16","996","2023-01-02"
"70229","2022","COM","2020","259","6","265","2023-01-02"
"70230","2022","COM","2020","96","5","101","2023-01-02"
"70231","2022","COM","2020","36","0","36","2023-01-02"
"70232","2022","COM","2020","130","5","135","2023-01-02"
"70233","2022","COM","2020","134","2","136","2023-01-02"
"70234","2022","COM","2020","222","10","232","2023-01-02"
"70235","2022","COM","2020","139","4","143","2023-01-02"
"70236","2022","COM","2020","463","8","471","2023-01-02"
"70237","2022","COM","2020","101","1","102","2023-01-02"
"70238","2022","COM","2020","134","6","140","2023-01-02"
"70239","2022","COM","2020","200","5","205","2023-01-02"
"70240","2022","COM","2020","1328","23","1351","2023-01-02"
"70242","2022","COM","2020","131","0","131","2023-01-02"
"70243","2022","COM","2020","340","11","351","2023-01-02"
"70244","2022","COM","2020","115","2","117","2023-01-02"
"70245","2022","COM","2020","3784","131","3915","2023-01-02"
"70247","2022","COM","2020","210","3","213","2023-01-02"
"70248","2022","COM","2020","1379","35","1414","2023-01-02"
"70249","2022","COM","2020","118","3","121","2023-01-02"
"70250","2022","COM","2020","473","5","478","2023-01-02"
"70251","2022","COM","2020","100","1","101","2023-01-02"
"70252","2022","COM","2020","181","3","184","2023-01-02"
"70253","2022","COM","2020","296","28","324","2023-01-02"
"70254","2022","COM","2020","259","8","267","2023-01-02"
"70255","2022","COM","2020","495","11","506","2023-01-02"
"70256","2022","COM","2020","709","12","721","2023-01-02"
"70257","2022","COM","2020","747","13","760","2023-01-02"
"70258","2022","COM","2020","1987","45","2032","2023-01-02"
"70259","2022","COM","2020","368","6","374","2023-01-02"
"70260","2022","COM","2020","684","20","704","2023-01-02"
"70261","2022","COM","2020","1358","32","1390","2023-01-02"
"70262","2022","COM","2020","158","4","162","2023-01-02"
"70263","2022","COM","2020","247","2","249","2023-01-02"
"70264","2022","COM","2020","45","0","45","2023-01-02"
"70265","2022","COM","2020","148","5","153","2023-01-02"
"70267","2022","COM","2020","488","7","495","2023-01-02"
"70268","2022","COM","2020","214","4","218","2023-01-02"
"70269","2022","COM","2020","34","1","35","2023-01-02"
"70271","2022","COM","2020","367","9","376","2023-01-02"
"70272","2022","COM","2020","180","11","191","2023-01-02"
"70273","2022","COM","2020","68","1","69","2023-01-02"
"70274","2022","COM","2020","49","0","49","2023-01-02"
"70275","2022","COM","2020","388","7","395","2023-01-02"
"70276","2022","COM","2020","184","5","189","2023-01-02"
"70277","2022","COM","2020","381","6","387","2023-01-02"
"70278","2022","COM","2020","213","4","217","2023-01-02"
"70279","2022","COM","2020","5560","420","5980","2023-01-02"
"70280","2022","COM","2020","928","35","963","2023-01-02"
"70282","2022","COM","2020","1006","20","1026","2023-01-02"
"70283","2022","COM","2020","446","6","452","2023-01-02"
"70284","2022","COM","2020","263","1","264","2023-01-02"
"70285","2022","COM","2020","10592","270","10862","2023-01-02"
"70286","2022","COM","2020","125","4","129","2023-01-02"
"70287","2022","COM","2020","46","0","46","2023-01-02"
"70288","2022","COM","2020","118","1","119","2023-01-02"
"70289","2022","COM","2020","211","2","213","2023-01-02"
"70290","2022","COM","2020","197","6","203","2023-01-02"
"70291","2022","COM","2020","117","3","120","2023-01-02"
"70292","2022","COM","2020","1543","32","1575","2023-01-02"
"70293","2022","COM","2020","74","2","76","2023-01-02"
"70294","2022","COM","2020","357","4","361","2023-01-02"
"70295","2022","COM","2020","221","5","226","2023-01-02"
"70296","2022","COM","2020","270","2","272","2023-01-02"
"70297","2022","COM","2020","60","0","60","2023-01-02"
"70298","2022","COM","2020","119","0","119","2023-01-02"
"70299","2022","COM","2020","318","5","323","2023-01-02"
"70301","2022","COM","2020","53","0","53","2023-01-02"
"70302","2022","COM","2020","76","1","77","2023-01-02"
"70303","2022","COM","2020","156","1","157","2023-01-02"
"70304","2022","COM","2020","118","1","119","2023-01-02"
"70305","2022","COM","2020","101","2","103","2023-01-02"
"70306","2022","COM","2020","469","13","482","2023-01-02"
"70307","2022","COM","2020","121","6","127","2023-01-02"
"70308","2022","COM","2020","213","5","218","2023-01-02"
"70309","2022","COM","2020","453","10","463","2023-01-02"
"70310","2022","COM","2020","7960","183","8143","2023-01-02"
"70311","2022","COM","2020","6644","259","6903","2023-01-02"
"70312","2022","COM","2020","785","22","807","2023-01-02"
"70313","2022","COM","2020","411","8","419","2023-01-02"
"70314","2022","COM","2020","167","6","173","2023-01-02"
"70315","2022","COM","2020","408","11","419","2023-01-02"
"70316","2022","COM","2020","85","4","89","2023-01-02"
"70317","2022","COM","2020","143","4","147","2023-01-02"
"70318","2022","COM","2020","438","10","448","2023-01-02"
"70319","2022","COM","2020","131","3","134","2023-01-02"
"70320","2022","COM","2020","96","3","99","2023-01-02"
"70321","2022","COM","2020","1375","27","1402","2023-01-02"
"70322","2022","COM","2020","284","6","290","2023-01-02"
"70323","2022","COM","2020","196","1","197","2023-01-02"
"70324","2022","COM","2020","634","16","650","2023-01-02"
"70325","2022","COM","2020","356","7","363","2023-01-02"
"70326","2022","COM","2020","307","3","310","2023-01-02"
"70327","2022","COM","2020","134","3","137","2023-01-02"
"70328","2022","COM","2020","326","5","331","2023-01-02"
"70329","2022","COM","2020","63","1","64","2023-01-02"
"70330","2022","COM","2020","309","8","317","2023-01-02"
"70331","2022","COM","2020","444","7","451","2023-01-02"
"70332","2022","COM","2020","58","1","59","2023-01-02"
"70334","2022","COM","2020","1522","25","1547","2023-01-02"
"70335","2022","COM","2020","59","2","61","2023-01-02"
"70336","2022","COM","2020","135","3","138","2023-01-02"
"70337","2022","COM","2020","58","1","59","2023-01-02"
"70338","2022","COM","2020","223","7","230","2023-01-02"
"70339","2022","COM","2020","1678","33","1711","2023-01-02"
"70340","2022","COM","2020","214","27","241","2023-01-02"
"70341","2022","COM","2020","300","3","303","2023-01-02"
"70342","2022","COM","2020","134","3","137","2023-01-02"
"70343","2022","COM","2020","282","5","287","2023-01-02"
"70344","2022","COM","2020","340","9","349","2023-01-02"
"70347","2022","COM","2020","365","8","373","2023-01-02"
"70348","2022","COM","2020","618","12","630","2023-01-02"
"70349","2022","COM","2020","234","3","237","2023-01-02"
"70350","2022","COM","2020","65","0","65","2023-01-02"
"70351","2022","COM","2020","227","3","230","2023-01-02"
"70352","2022","COM","2020","38","0","38","2023-01-02"
"70353","2022","COM","2020","503","9","512","2023-01-02"
"70355","2022","COM","2020","311","4","315","2023-01-02"
"70356","2022","COM","2020","281","6","287","2023-01-02"
"70357","2022","COM","2020","544","86","630","2023-01-02"
"70358","2022","COM","2020","269","4","273","2023-01-02"
"70359","2022","COM","2020","54","2","56","2023-01-02"
"70360","2022","COM","2020","75","1","76","2023-01-02"
"70361","2022","COM","2020","155","5","160","2023-01-02"
"70362","2022","COM","2020","128","4","132","2023-01-02"
"70363","2022","COM","2020","637","15","652","2023-01-02"
"70364","2022","COM","2020","119","1","120","2023-01-02"
"70366","2022","COM","2020","122","0","122","2023-01-02"
"70367","2022","COM","2020","186","4","190","2023-01-02"
"70368","2022","COM","2020","131","3","134","2023-01-02"
"70369","2022","COM","2020","48","1","49","2023-01-02"
"70371","2022","COM","2020","200","1","201","2023-01-02"
"70372","2022","COM","2020","150","4","154","2023-01-02"
"70373","2022","COM","2020","287","4","291","2023-01-02"
"70374","2022","COM","2020","92","2","94","2023-01-02"
"70376","2022","COM","2020","452","10","462","2023-01-02"
"70378","2022","COM","2020","1605","48","1653","2023-01-02"
"70380","2022","COM","2020","163","4","167","2023-01-02"
"70381","2022","COM","2020","348","10","358","2023-01-02"
"70383","2022","COM","2020","425","4","429","2023-01-02"
"70384","2022","COM","2020","224","3","227","2023-01-02"
"70385","2022","COM","2020","323","7","330","2023-01-02"
"70386","2022","COM","2020","172","3","175","2023-01-02"
"70387","2022","COM","2020","653","10","663","2023-01-02"
"70388","2022","COM","2020","1973","73","2046","2023-01-02"
"70389","2022","COM","2020","58","1","59","2023-01-02"
"70390","2022","COM","2020","498","11","509","2023-01-02"
"70392","2022","COM","2020","34","2","36","2023-01-02"
"70393","2022","COM","2020","431","2","433","2023-01-02"
"70394","2022","COM","2020","60","2","62","2023-01-02"
"70395","2022","COM","2020","51","0","51","2023-01-02"
"70396","2022","COM","2020","41","2","43","2023-01-02"
"70397","2022","COM","2020","82","0","82","2023-01-02"
"70398","2022","COM","2020","67","0","67","2023-01-02"
"70399","2022","COM","2020","207","7","214","2023-01-02"
"70400","2022","COM","2020","111","2","113","2023-01-02"
"70401","2022","COM","2020","138","1","139","2023-01-02"
"70402","2022","COM","2020","368","11","379","2023-01-02"
"70403","2022","COM","2020","243","3","246","2023-01-02"
"70404","2022","COM","2020","563","15","578","2023-01-02"
"70405","2022","COM","2020","196","4","200","2023-01-02"
"70406","2022","COM","2020","74","1","75","2023-01-02"
"70407","2022","COM","2020","275","4","279","2023-01-02"
"70408","2022","COM","2020","1072","20","1092","2023-01-02"
"70409","2022","COM","2020","114","2","116","2023-01-02"
"70410","2022","COM","2020","710","9","719","2023-01-02"
"70411","2022","COM","2020","38","0","38","2023-01-02"
"70412","2022","COM","2020","72","0","72","2023-01-02"
"70413","2022","COM","2020","1872","35","1907","2023-01-02"
"70414","2022","COM","2020","955","14","969","2023-01-02"
"70415","2022","COM","2020","620","10","630","2023-01-02"
"70416","2022","COM","2020","200","4","204","2023-01-02"
"70417","2022","COM","2020","297","3","300","2023-01-02"
"70418","2022","COM","2020","519","5","524","2023-01-02"
"70419","2022","COM","2020","110","2","112","2023-01-02"
"70420","2022","COM","2020","62","0","62","2023-01-02"
"70421","2022","COM","2020","2952","54","3006","2023-01-02"
"70422","2022","COM","2020","145","1","146","2023-01-02"
"70423","2022","COM","2020","116","3","119","2023-01-02"
"70425","2022","COM","2020","147","6","153","2023-01-02"
"70426","2022","COM","2020","246","7","253","2023-01-02"
"70427","2022","COM","2020","331","9","340","2023-01-02"
"70428","2022","COM","2020","1452","49","1501","2023-01-02"
"70429","2022","COM","2020","544","14","558","2023-01-02"
"70430","2022","COM","2020","67","0","67","2023-01-02"
"70431","2022","COM","2020","252","3","255","2023-01-02"
"70432","2022","COM","2020","325","7","332","2023-01-02"
"70433","2022","COM","2020","1401","39","1440","2023-01-02"
"70435","2022","COM","2020","837","26","863","2023-01-02"
"70436","2022","COM","2020","113","0","113","2023-01-02"
"70437","2022","COM","2020","16","0","16","2023-01-02"
"70438","2022","COM","2020","215","3","218","2023-01-02"
"70439","2022","COM","2020","363","7","370","2023-01-02"
"70440","2022","COM","2020","34","2","36","2023-01-02"
"70441","2022","COM","2020","251","3","254","2023-01-02"
"70442","2022","COM","2020","111","1","112","2023-01-02"
"70443","2022","COM","2020","90","1","91","2023-01-02"
"70444","2022","COM","2020","167","1","168","2023-01-02"
"70445","2022","COM","2020","117","1","118","2023-01-02"
"70446","2022","COM","2020","617","8","625","2023-01-02"
"70447","2022","COM","2020","2395","76","2471","2023-01-02"
"70448","2022","COM","2020","152","2","154","2023-01-02"
"70449","2022","COM","2020","62","0","62","2023-01-02"
"70450","2022","COM","2020","41","0","41","2023-01-02"
"70451","2022","COM","2020","2747","39","2786","2023-01-02"
"70452","2022","COM","2020","255","3","258","2023-01-02"
"70453","2022","COM","2020","80","0","80","2023-01-02"
"70454","2022","COM","2020","50","2","52","2023-01-02"
"70455","2022","COM","2020","1480","25","1505","2023-01-02"
"70456","2022","COM","2020","148","5","153","2023-01-02"
"70457","2022","COM","2020","106","3","109","2023-01-02"
"70459","2022","COM","2020","1100","22","1122","2023-01-02"
"70460","2022","COM","2020","427","11","438","2023-01-02"
"70461","2022","COM","2020","113","2","115","2023-01-02"
"70462","2022","COM","2020","80","2","82","2023-01-02"
"70463","2022","COM","2020","146","1","147","2023-01-02"
"70464","2022","COM","2020","1355","23","1378","2023-01-02"
"70466","2022","COM","2020","127","3","130","2023-01-02"
"70467","2022","COM","2020","3046","46","3092","2023-01-02"
"70468","2022","COM","2020","90","1","91","2023-01-02"
"70469","2022","COM","2020","211","3","214","2023-01-02"
"70470","2022","COM","2020","158","2","160","2023-01-02"
"70471","2022","COM","2020","24","1","25","2023-01-02"
"70472","2022","COM","2020","442","4","446","2023-01-02"
"70473","2022","COM","2020","1936","31","1967","2023-01-02"
"70474","2022","COM","2020","125","2","127","2023-01-02"
"70476","2022","COM","2020","69","0","69","2023-01-02"
"70477","2022","COM","2020","779","13","792","2023-01-02"
"70478","2022","COM","2020","880","15","895","2023-01-02"
"70479","2022","COM","2020","96","4","100","2023-01-02"
"70480","2022","COM","2020","142","4","146","2023-01-02"
"70481","2022","COM","2020","202","4","206","2023-01-02"
"70482","2022","COM","2020","1533","23","1556","2023-01-02"
"70483","2022","COM","2020","138","4","142","2023-01-02"
"70484","2022","COM","2020","182","3","185","2023-01-02"
"70485","2022","COM","2020","202","4","206","2023-01-02"
"70486","2022","COM","2020","110","3","113","2023-01-02"
"70487","2022","COM","2020","291","3","294","2023-01-02"
"70488","2022","COM","2020","192","1","193","2023-01-02"
"70489","2022","COM","2020","773","8","781","2023-01-02"
"70490","2022","COM","2020","124","1","125","2023-01-02"
"70491","2022","COM","2020","476","15","491","2023-01-02"
"70492","2022","COM","2020","583","10","593","2023-01-02"
"70493","2022","COM","2020","462","10","472","2023-01-02"
"70494","2022","COM","2020","349","6","355","2023-01-02"
"70496","2022","COM","2020","24","1","25","2023-01-02"
"70498","2022","COM","2020","453","15","468","2023-01-02"
"70499","2022","COM","2020","102","2","104","2023-01-02"
"70500","2022","COM","2020","166","9","175","2023-01-02"
"70501","2022","COM","2020","103","1","104","2023-01-02"
"70502","2022","COM","2020","84","0","84","2023-01-02"
"70503","2022","COM","2020","161","2","163","2023-01-02"
"70504","2022","COM","2020","358","12","370","2023-01-02"
"70505","2022","COM","2020","159","7","166","2023-01-02"
"70506","2022","COM","2020","390","13","403","2023-01-02"
"70507","2022","COM","2020","259","6","265","2023-01-02"
"70509","2022","COM","2020","115","0","115","2023-01-02"
"70510","2022","COM","2020","127","3","130","2023-01-02"
"70511","2022","COM","2020","229","3","232","2023-01-02"
"70512","2022","COM","2020","219","3","222","2023-01-02"
"70513","2022","COM","2020","2420","54","2474","2023-01-02"
"70514","2022","COM","2020","658","11","669","2023-01-02"
"70515","2022","COM","2020","66","1","67","2023-01-02"
"70516","2022","COM","2020","240","3","243","2023-01-02"
"70517","2022","COM","2020","395","18","413","2023-01-02"
"70518","2022","COM","2020","97","2","99","2023-01-02"
"70519","2022","COM","2020","108","0","108","2023-01-02"
"70520","2022","COM","2020","119","3","122","2023-01-02"
"70521","2022","COM","2020","186","5","191","2023-01-02"
"70522","2022","COM","2020","158","3","161","2023-01-02"
"70523","2022","COM","2020","199","3","202","2023-01-02"
"70524","2022","COM","2020","113","3","116","2023-01-02"
"70525","2022","COM","2020","213","3","216","2023-01-02"
"70526","2022","COM","2020","620","12","632","2023-01-02"
"70527","2022","COM","2020","77","1","78","2023-01-02"
"70528","2022","COM","2020","486","9","495","2023-01-02"
"70529","2022","COM","2020","381","18","399","2023-01-02"
"70530","2022","COM","2020","117","0","117","2023-01-02"
"70531","2022","COM","2020","102","1","103","2023-01-02"
"70532","2022","COM","2020","524","6","530","2023-01-02"
"70533","2022","COM","2020","118","1","119","2023-01-02"
"70534","2022","COM","2020","124","1","125","2023-01-02"
"70535","2022","COM","2020","151","0","151","2023-01-02"
"70536","2022","COM","2020","132","2","134","2023-01-02"
"70537","2022","COM","2020","296","6","302","2023-01-02"
"70538","2022","COM","2020","84","1","85","2023-01-02"
"70539","2022","COM","2020","454","12","466","2023-01-02"
"70540","2022","COM","2020","80","4","84","2023-01-02"
"70541","2022","COM","2020","201","3","204","2023-01-02"
"70542","2022","COM","2020","207","5","212","2023-01-02"
"70544","2022","COM","2020","113","5","118","2023-01-02"
"70545","2022","COM","2020","130","1","131","2023-01-02"
"70546","2022","COM","2020","214","22","236","2023-01-02"
"70547","2022","COM","2020","167","3","170","2023-01-02"
"70548","2022","COM","2020","138","1","139","2023-01-02"
"70549","2022","COM","2020","78","1","79","2023-01-02"
"70550","2022","COM","2020","14866","760","15626","2023-01-02"
"70552","2022","COM","2020","210","7","217","2023-01-02"
"70553","2022","COM","2020","115","2","117","2023-01-02"
"70554","2022","COM","2020","190","1","191","2023-01-02"
"70555","2022","COM","2020","168","1","169","2023-01-02"
"70557","2022","COM","2020","129","4","133","2023-01-02"
"70558","2022","COM","2020","146","2","148","2023-01-02"
"70559","2022","COM","2020","194","4","198","2023-01-02"
"70560","2022","COM","2020","166","2","168","2023-01-02"
"70561","2022","COM","2020","1409","105","1514","2023-01-02"
"70562","2022","COM","2020","155","3","158","2023-01-02"
"70563","2022","COM","2020","529","13","542","2023-01-02"
"70564","2022","COM","2020","314","16","330","2023-01-02"
"70565","2022","COM","2020","52","2","54","2023-01-02"
"70566","2022","COM","2020","200","5","205","2023-01-02"
"70567","2022","COM","2020","132","9","141","2023-01-02"
"70568","2022","COM","2020","56","4","60","2023-01-02"
"70569","2022","COM","2020","63","0","63","2023-01-02"
"70571","2022","COM","2020","39","3","42","2023-01-02"
"70572","2022","COM","2020","291","4","295","2023-01-02"
"70573","2022","COM","2020","115","1","116","2023-01-02"
"70574","2022","COM","2020","56","0","56","2023-01-02"
"70575","2022","COM","2020","849","16","865","2023-01-02"
"70576","2022","COM","2020","154","1","155","2023-01-02"
"70577","2022","COM","2020","381","9","390","2023-01-02"
"70578","2022","COM","2020","177","2","179","2023-01-02"
"70579","2022","COM","2020","425","16","441","2023-01-02"
"70580","2022","COM","2020","155","5","160","2023-01-02"
"70581","2022","COM","2020","709","15","724","2023-01-02"
"70582","2022","COM","2020","78","0","78","2023-01-02"
"70583","2022","COM","2020","131","1","132","2023-01-02"
"71001","2022","COM","2020","808","14","822","2023-01-02"
"71002","2022","COM","2020","1241","20","1261","2023-01-02"
"71003","2022","COM","2020","800","19","819","2023-01-02"
"71004","2022","COM","2020","1163","24","1187","2023-01-02"
"71005","2022","COM","2020","249","10","259","2023-01-02"
"71006","2022","COM","2020","190","5","195","2023-01-02"
"71007","2022","COM","2020","167","4","171","2023-01-02"
"71008","2022","COM","2020","150","5","155","2023-01-02"
"71009","2022","COM","2020","714","13","727","2023-01-02"
"71010","2022","COM","2020","869","10","879","2023-01-02"
"71011","2022","COM","2020","432","82","514","2023-01-02"
"71012","2022","COM","2020","335","14","349","2023-01-02"
"71013","2022","COM","2020","282","5","287","2023-01-02"
"71014","2022","COM","2020","13205","1010","14215","2023-01-02"
"71015","2022","COM","2020","901","26","927","2023-01-02"
"71016","2022","COM","2020","1083","27","1110","2023-01-02"
"71017","2022","COM","2020","95","4","99","2023-01-02"
"71018","2022","COM","2020","546","10","556","2023-01-02"
"71019","2022","COM","2020","140","7","147","2023-01-02"
"71020","2022","COM","2020","98","2","100","2023-01-02"
"71021","2022","COM","2020","289","20","309","2023-01-02"
"71022","2022","COM","2020","624","9","633","2023-01-02"
"71023","2022","COM","2020","965","26","991","2023-01-02"
"71024","2022","COM","2020","504","13","517","2023-01-02"
"71025","2022","COM","2020","359","7","366","2023-01-02"
"71026","2022","COM","2020","332","13","345","2023-01-02"
"71027","2022","COM","2020","730","7","737","2023-01-02"
"71028","2022","COM","2020","104","3","107","2023-01-02"
"71029","2022","COM","2020","294","3","297","2023-01-02"
"71030","2022","COM","2020","201","4","205","2023-01-02"
"71031","2022","COM","2020","59","1","60","2023-01-02"
"71032","2022","COM","2020","697","14","711","2023-01-02"
"71033","2022","COM","2020","869","19","888","2023-01-02"
"71034","2022","COM","2020","334","6","340","2023-01-02"
"71035","2022","COM","2020","204","3","207","2023-01-02"
"71036","2022","COM","2020","70","0","70","2023-01-02"
"71037","2022","COM","2020","83","6","89","2023-01-02"
"71038","2022","COM","2020","469","13","482","2023-01-02"
"71039","2022","COM","2020","181","1","182","2023-01-02"
"71040","2022","COM","2020","6044","133","6177","2023-01-02"
"71041","2022","COM","2020","189","2","191","2023-01-02"
"71042","2022","COM","2020","312","6","318","2023-01-02"
"71043","2022","COM","2020","84","3","87","2023-01-02"
"71044","2022","COM","2020","290","6","296","2023-01-02"
"71045","2022","COM","2020","178","5","183","2023-01-02"
"71046","2022","COM","2020","93","0","93","2023-01-02"
"71047","2022","COM","2020","4684","72","4756","2023-01-02"
"71048","2022","COM","2020","175","2","177","2023-01-02"
"71050","2022","COM","2020","349","7","356","2023-01-02"
"71051","2022","COM","2020","127","7","134","2023-01-02"
"71052","2022","COM","2020","729","9","738","2023-01-02"
"71054","2022","COM","2020","696","14","710","2023-01-02"
"71056","2022","COM","2020","2350","35","2385","2023-01-02"
"71057","2022","COM","2020","125","3","128","2023-01-02"
"71058","2022","COM","2020","186","11","197","2023-01-02"
"71059","2022","COM","2020","3535","61","3596","2023-01-02"
"71060","2022","COM","2020","228","2","230","2023-01-02"
"71061","2022","COM","2020","466","14","480","2023-01-02"
"71062","2022","COM","2020","291","8","299","2023-01-02"
"71063","2022","COM","2020","749","13","762","2023-01-02"
"71064","2022","COM","2020","980","25","1005","2023-01-02"
"71065","2022","COM","2020","274","4","278","2023-01-02"
"71066","2022","COM","2020","117","3","120","2023-01-02"
"71067","2022","COM","2020","122","2","124","2023-01-02"
"71068","2022","COM","2020","56","2","58","2023-01-02"
"71069","2022","COM","2020","584","27","611","2023-01-02"
"71070","2022","COM","2020","2147","66","2213","2023-01-02"
"71071","2022","COM","2020","264","7","271","2023-01-02"
"71072","2022","COM","2020","145","2","147","2023-01-02"
"71073","2022","COM","2020","5516","80","5596","2023-01-02"
"71074","2022","COM","2020","557","18","575","2023-01-02"
"71075","2022","COM","2020","631","17","648","2023-01-02"
"71076","2022","COM","2020","45094","1473","46567","2023-01-02"
"71077","2022","COM","2020","499","14","513","2023-01-02"
"71078","2022","COM","2020","147","3","150","2023-01-02"
"71079","2022","COM","2020","470","11","481","2023-01-02"
"71080","2022","COM","2020","92","0","92","2023-01-02"
"71081","2022","COM","2020","2594","53","2647","2023-01-02"
"71082","2022","COM","2020","224","4","228","2023-01-02"
"71084","2022","COM","2020","529","14","543","2023-01-02"
"71085","2022","COM","2020","223","2","225","2023-01-02"
"71086","2022","COM","2020","468","9","477","2023-01-02"
"71087","2022","COM","2020","164","1","165","2023-01-02"
"71088","2022","COM","2020","225","10","235","2023-01-02"
"71089","2022","COM","2020","235","2","237","2023-01-02"
"71090","2022","COM","2020","4126","83","4209","2023-01-02"
"71091","2022","COM","2020","192","2","194","2023-01-02"
"71092","2022","COM","2020","498","12","510","2023-01-02"
"71093","2022","COM","2020","647","16","663","2023-01-02"
"71094","2022","COM","2020","139","2","141","2023-01-02"
"71095","2022","COM","2020","432","9","441","2023-01-02"
"71096","2022","COM","2020","191","1","192","2023-01-02"
"71097","2022","COM","2020","481","12","493","2023-01-02"
"71098","2022","COM","2020","250","4","254","2023-01-02"
"71099","2022","COM","2020","323","7","330","2023-01-02"
"71100","2022","COM","2020","205","0","205","2023-01-02"
"71101","2022","COM","2020","453","6","459","2023-01-02"
"71102","2022","COM","2020","684","24","708","2023-01-02"
"71103","2022","COM","2020","276","6","282","2023-01-02"
"71104","2022","COM","2020","188","8","196","2023-01-02"
"71105","2022","COM","2020","7925","290","8215","2023-01-02"
"71106","2022","COM","2020","2849","384","3233","2023-01-02"
"71107","2022","COM","2020","332","8","340","2023-01-02"
"71108","2022","COM","2020","170","4","174","2023-01-02"
"71109","2022","COM","2020","357","6","363","2023-01-02"
"71110","2022","COM","2020","556","10","566","2023-01-02"
"71111","2022","COM","2020","299","9","308","2023-01-02"
"71112","2022","COM","2020","233","7","240","2023-01-02"
"71113","2022","COM","2020","93","0","93","2023-01-02"
"71115","2022","COM","2020","87","4","91","2023-01-02"
"71116","2022","COM","2020","171","2","173","2023-01-02"
"71117","2022","COM","2020","1095","30","1125","2023-01-02"
"71118","2022","COM","2020","6148","142","6290","2023-01-02"
"71119","2022","COM","2020","1125","23","1148","2023-01-02"
"71120","2022","COM","2020","3688","71","3759","2023-01-02"
"71121","2022","COM","2020","323","3","326","2023-01-02"
"71122","2022","COM","2020","558","15","573","2023-01-02"
"71123","2022","COM","2020","370","4","374","2023-01-02"
"71124","2022","COM","2020","202","7","209","2023-01-02"
"71125","2022","COM","2020","20","0","20","2023-01-02"
"71126","2022","COM","2020","591","18","609","2023-01-02"
"71127","2022","COM","2020","53","4","57","2023-01-02"
"71128","2022","COM","2020","86","5","91","2023-01-02"
"71129","2022","COM","2020","268","6","274","2023-01-02"
"71130","2022","COM","2020","229","6","235","2023-01-02"
"71131","2022","COM","2020","866","12","878","2023-01-02"
"71132","2022","COM","2020","2252","27","2279","2023-01-02"
"71133","2022","COM","2020","1639","60","1699","2023-01-02"
"71134","2022","COM","2020","657","11","668","2023-01-02"
"71135","2022","COM","2020","873","21","894","2023-01-02"
"71136","2022","COM","2020","275","8","283","2023-01-02"
"71137","2022","COM","2020","4931","245","5176","2023-01-02"
"71139","2022","COM","2020","146","6","152","2023-01-02"
"71140","2022","COM","2020","46","2","48","2023-01-02"
"71141","2022","COM","2020","314","5","319","2023-01-02"
"71142","2022","COM","2020","247","4","251","2023-01-02"
"71143","2022","COM","2020","459","9","468","2023-01-02"
"71144","2022","COM","2020","192","4","196","2023-01-02"
"71145","2022","COM","2020","567","5","572","2023-01-02"
"71146","2022","COM","2020","245","4","249","2023-01-02"
"71147","2022","COM","2020","251","6","257","2023-01-02"
"71148","2022","COM","2020","847","18","865","2023-01-02"
"71149","2022","COM","2020","1285","27","1312","2023-01-02"
"71150","2022","COM","2020","3140","87","3227","2023-01-02"
"71151","2022","COM","2020","79","4","83","2023-01-02"
"71152","2022","COM","2020","175","9","184","2023-01-02"
"71153","2022","COM","2020","21057","262","21319","2023-01-02"
"71154","2022","COM","2020","2460","60","2520","2023-01-02"
"71155","2022","COM","2020","516","15","531","2023-01-02"
"71156","2022","COM","2020","261","66","327","2023-01-02"
"71157","2022","COM","2020","1825","30","1855","2023-01-02"
"71158","2022","COM","2020","1588","40","1628","2023-01-02"
"71159","2022","COM","2020","201","8","209","2023-01-02"
"71160","2022","COM","2020","306","8","314","2023-01-02"
"71161","2022","COM","2020","325","6","331","2023-01-02"
"71162","2022","COM","2020","1135","23","1158","2023-01-02"
"71163","2022","COM","2020","90","1","91","2023-01-02"
"71164","2022","COM","2020","133","2","135","2023-01-02"
"71165","2022","COM","2020","374","8","382","2023-01-02"
"71166","2022","COM","2020","109","4","113","2023-01-02"
"71167","2022","COM","2020","549","19","568","2023-01-02"
"71168","2022","COM","2020","174","1","175","2023-01-02"
"71169","2022","COM","2020","705","107","812","2023-01-02"
"71170","2022","COM","2020","1782","38","1820","2023-01-02"
"71171","2022","COM","2020","304","5","309","2023-01-02"
"71172","2022","COM","2020","88","1","89","2023-01-02"
"71173","2022","COM","2020","317","5","322","2023-01-02"
"71174","2022","COM","2020","170","4","174","2023-01-02"
"71175","2022","COM","2020","354","6","360","2023-01-02"
"71176","2022","COM","2020","7616","238","7854","2023-01-02"
"71177","2022","COM","2020","806","9","815","2023-01-02"
"71178","2022","COM","2020","883","29","912","2023-01-02"
"71179","2022","COM","2020","82","1","83","2023-01-02"
"71181","2022","COM","2020","161","2","163","2023-01-02"
"71182","2022","COM","2020","1458","52","1510","2023-01-02"
"71183","2022","COM","2020","153","4","157","2023-01-02"
"71184","2022","COM","2020","628","8","636","2023-01-02"
"71185","2022","COM","2020","328","14","342","2023-01-02"
"71186","2022","COM","2020","259","4","263","2023-01-02"
"71187","2022","COM","2020","1595","31","1626","2023-01-02"
"71188","2022","COM","2020","61","1","62","2023-01-02"
"71189","2022","COM","2020","1634","49","1683","2023-01-02"
"71190","2022","COM","2020","2145","30","2175","2023-01-02"
"71191","2022","COM","2020","475","6","481","2023-01-02"
"71192","2022","COM","2020","1803","148","1951","2023-01-02"
"71193","2022","COM","2020","476","10","486","2023-01-02"
"71194","2022","COM","2020","801","17","818","2023-01-02"
"71195","2022","COM","2020","220","1","221","2023-01-02"
"71196","2022","COM","2020","629","9","638","2023-01-02"
"71198","2022","COM","2020","411","7","418","2023-01-02"
"71199","2022","COM","2020","174","8","182","2023-01-02"
"71200","2022","COM","2020","707","17","724","2023-01-02"
"71201","2022","COM","2020","194","8","202","2023-01-02"
"71202","2022","COM","2020","1853","362","2215","2023-01-02"
"71203","2022","COM","2020","53","1","54","2023-01-02"
"71204","2022","COM","2020","1478","41","1519","2023-01-02"
"71205","2022","COM","2020","666","9","675","2023-01-02"
"71206","2022","COM","2020","237","4","241","2023-01-02"
"71207","2022","COM","2020","288","10","298","2023-01-02"
"71208","2022","COM","2020","208","4","212","2023-01-02"
"71209","2022","COM","2020","726","14","740","2023-01-02"
"71210","2022","COM","2020","370","18","388","2023-01-02"
"71212","2022","COM","2020","1394","31","1425","2023-01-02"
"71213","2022","COM","2020","567","17","584","2023-01-02"
"71214","2022","COM","2020","421","11","432","2023-01-02"
"71215","2022","COM","2020","2590","73","2663","2023-01-02"
"71216","2022","COM","2020","195","5","200","2023-01-02"
"71217","2022","COM","2020","125","5","130","2023-01-02"
"71218","2022","COM","2020","577","20","597","2023-01-02"
"71219","2022","COM","2020","542","15","557","2023-01-02"
"71220","2022","COM","2020","472","3","475","2023-01-02"
"71221","2022","COM","2020","3678","160","3838","2023-01-02"
"71222","2022","COM","2020","897","26","923","2023-01-02"
"71223","2022","COM","2020","565","8","573","2023-01-02"
"71224","2022","COM","2020","85","7","92","2023-01-02"
"71225","2022","COM","2020","548","15","563","2023-01-02"
"71226","2022","COM","2020","28","0","28","2023-01-02"
"71227","2022","COM","2020","502","8","510","2023-01-02"
"71228","2022","COM","2020","215","3","218","2023-01-02"
"71229","2022","COM","2020","228","1","229","2023-01-02"
"71230","2022","COM","2020","6685","177","6862","2023-01-02"
"71231","2022","COM","2020","619","8","627","2023-01-02"
"71232","2022","COM","2020","204","14","218","2023-01-02"
"71233","2022","COM","2020","304","7","311","2023-01-02"
"71234","2022","COM","2020","347","5","352","2023-01-02"
"71235","2022","COM","2020","1935","107","2042","2023-01-02"
"71236","2022","COM","2020","877","21","898","2023-01-02"
"71237","2022","COM","2020","529","5","534","2023-01-02"
"71238","2022","COM","2020","990","18","1008","2023-01-02"
"71239","2022","COM","2020","688","11","699","2023-01-02"
"71240","2022","COM","2020","396","14","410","2023-01-02"
"71241","2022","COM","2020","485","17","502","2023-01-02"
"71242","2022","COM","2020","515","10","525","2023-01-02"
"71243","2022","COM","2020","368","6","374","2023-01-02"
"71244","2022","COM","2020","444","2","446","2023-01-02"
"71245","2022","COM","2020","325","4","329","2023-01-02"
"71246","2022","COM","2020","245","3","248","2023-01-02"
"71247","2022","COM","2020","367","10","377","2023-01-02"
"71248","2022","COM","2020","701","15","716","2023-01-02"
"71249","2022","COM","2020","981","37","1018","2023-01-02"
"71250","2022","COM","2020","1091","49","1140","2023-01-02"
"71251","2022","COM","2020","596","13","609","2023-01-02"
"71252","2022","COM","2020","364","13","377","2023-01-02"
"71253","2022","COM","2020","933","25","958","2023-01-02"
"71254","2022","COM","2020","156","1","157","2023-01-02"
"71255","2022","COM","2020","176","2","178","2023-01-02"
"71256","2022","COM","2020","547","13","560","2023-01-02"
"71257","2022","COM","2020","658","12","670","2023-01-02"
"71258","2022","COM","2020","500","16","516","2023-01-02"
"71259","2022","COM","2020","369","6","375","2023-01-02"
"71261","2022","COM","2020","671","16","687","2023-01-02"
"71262","2022","COM","2020","155","3","158","2023-01-02"
"71263","2022","COM","2020","6451","224","6675","2023-01-02"
"71264","2022","COM","2020","324","9","333","2023-01-02"
"71266","2022","COM","2020","314","4","318","2023-01-02"
"71267","2022","COM","2020","855","84","939","2023-01-02"
"71268","2022","COM","2020","350","10","360","2023-01-02"
"71269","2022","COM","2020","2012","28","2040","2023-01-02"
"71270","2022","COM","2020","34414","723","35137","2023-01-02"
"71271","2022","COM","2020","146","5","151","2023-01-02"
"71272","2022","COM","2020","197","9","206","2023-01-02"
"71273","2022","COM","2020","284","6","290","2023-01-02"
"71274","2022","COM","2020","387","10","397","2023-01-02"
"71275","2022","COM","2020","1723","31","1754","2023-01-02"
"71276","2022","COM","2020","129","5","134","2023-01-02"
"71277","2022","COM","2020","666","16","682","2023-01-02"
"71278","2022","COM","2020","162","5","167","2023-01-02"
"71279","2022","COM","2020","619","22","641","2023-01-02"
"71280","2022","COM","2020","85","2","87","2023-01-02"
"71281","2022","COM","2020","307","14","321","2023-01-02"
"71282","2022","COM","2020","1256","21","1277","2023-01-02"
"71283","2022","COM","2020","527","7","534","2023-01-02"
"71284","2022","COM","2020","137","5","142","2023-01-02"
"71285","2022","COM","2020","407","7","414","2023-01-02"
"71286","2022","COM","2020","270","4","274","2023-01-02"
"71287","2022","COM","2020","314","5","319","2023-01-02"
"71289","2022","COM","2020","1156","20","1176","2023-01-02"
"71290","2022","COM","2020","374","75","449","2023-01-02"
"71291","2022","COM","2020","956","23","979","2023-01-02"
"71292","2022","COM","2020","1316","45","1361","2023-01-02"
"71293","2022","COM","2020","409","10","419","2023-01-02"
"71294","2022","COM","2020","1231","137","1368","2023-01-02"
"71295","2022","COM","2020","1502","25","1527","2023-01-02"
"71296","2022","COM","2020","741","19","760","2023-01-02"
"71297","2022","COM","2020","751","22","773","2023-01-02"
"71299","2022","COM","2020","311","6","317","2023-01-02"
"71300","2022","COM","2020","626","8","634","2023-01-02"
"71301","2022","COM","2020","166","2","168","2023-01-02"
"71302","2022","COM","2020","215","9","224","2023-01-02"
"71303","2022","COM","2020","491","6","497","2023-01-02"
"71305","2022","COM","2020","841","15","856","2023-01-02"
"71306","2022","COM","2020","17239","249","17488","2023-01-02"
"71307","2022","COM","2020","289","7","296","2023-01-02"
"71308","2022","COM","2020","31","1","32","2023-01-02"
"71309","2022","COM","2020","1905","60","1965","2023-01-02"
"71310","2022","COM","2020","4992","83","5075","2023-01-02"
"71311","2022","COM","2020","250","6","256","2023-01-02"
"71312","2022","COM","2020","255","1","256","2023-01-02"
"71313","2022","COM","2020","384","15","399","2023-01-02"
"71314","2022","COM","2020","204","0","204","2023-01-02"
"71315","2022","COM","2020","184","2","186","2023-01-02"
"71316","2022","COM","2020","379","7","386","2023-01-02"
"71317","2022","COM","2020","186","3","189","2023-01-02"
"71318","2022","COM","2020","1103","19","1122","2023-01-02"
"71319","2022","COM","2020","768","16","784","2023-01-02"
"71320","2022","COM","2020","315","3","318","2023-01-02"
"71321","2022","COM","2020","191","4","195","2023-01-02"
"71322","2022","COM","2020","50","1","51","2023-01-02"
"71323","2022","COM","2020","136","0","136","2023-01-02"
"71324","2022","COM","2020","584","22","606","2023-01-02"
"71325","2022","COM","2020","1204","37","1241","2023-01-02"
"71326","2022","COM","2020","411","6","417","2023-01-02"
"71327","2022","COM","2020","339","7","346","2023-01-02"
"71328","2022","COM","2020","631","12","643","2023-01-02"
"71329","2022","COM","2020","406","9","415","2023-01-02"
"71330","2022","COM","2020","750","12","762","2023-01-02"
"71331","2022","COM","2020","111","4","115","2023-01-02"
"71332","2022","COM","2020","464","5","469","2023-01-02"
"71333","2022","COM","2020","1226","38","1264","2023-01-02"
"71334","2022","COM","2020","378","9","387","2023-01-02"
"71335","2022","COM","2020","65","0","65","2023-01-02"
"71336","2022","COM","2020","3102","78","3180","2023-01-02"
"71337","2022","COM","2020","306","8","314","2023-01-02"
"71338","2022","COM","2020","218","2","220","2023-01-02"
"71339","2022","COM","2020","384","8","392","2023-01-02"
"71340","2022","COM","2020","1471","26","1497","2023-01-02"
"71341","2022","COM","2020","268","2","270","2023-01-02"
"71342","2022","COM","2020","9218","394","9612","2023-01-02"
"71343","2022","COM","2020","308","8","316","2023-01-02"
"71344","2022","COM","2020","67","2","69","2023-01-02"
"71345","2022","COM","2020","670","19","689","2023-01-02"
"71346","2022","COM","2020","1557","24","1581","2023-01-02"
"71347","2022","COM","2020","556","14","570","2023-01-02"
"71348","2022","COM","2020","134","3","137","2023-01-02"
"71349","2022","COM","2020","51","1","52","2023-01-02"
"71350","2022","COM","2020","859","30","889","2023-01-02"
"71351","2022","COM","2020","1942","29","1971","2023-01-02"
"71352","2022","COM","2020","86","3","89","2023-01-02"
"71353","2022","COM","2020","535","10","545","2023-01-02"
"71354","2022","COM","2020","565","21","586","2023-01-02"
"71355","2022","COM","2020","278","7","285","2023-01-02"
"71356","2022","COM","2020","969","17","986","2023-01-02"
"71357","2022","COM","2020","218","0","218","2023-01-02"
"71358","2022","COM","2020","102","3","105","2023-01-02"
"71359","2022","COM","2020","577","10","587","2023-01-02"
"71360","2022","COM","2020","1900","46","1946","2023-01-02"
"71361","2022","COM","2020","56","5","61","2023-01-02"
"71362","2022","COM","2020","347","5","352","2023-01-02"
"71363","2022","COM","2020","83","5","88","2023-01-02"
"71364","2022","COM","2020","175","0","175","2023-01-02"
"71365","2022","COM","2020","604","7","611","2023-01-02"
"71366","2022","COM","2020","377","7","384","2023-01-02"
"71367","2022","COM","2020","369","5","374","2023-01-02"
"71368","2022","COM","2020","298","16","314","2023-01-02"
"71369","2022","COM","2020","423","14","437","2023-01-02"
"71370","2022","COM","2020","623","13","636","2023-01-02"
"71371","2022","COM","2020","1573","42","1615","2023-01-02"
"71372","2022","COM","2020","2017","44","2061","2023-01-02"
"71373","2022","COM","2020","1721","22","1743","2023-01-02"
"71374","2022","COM","2020","160","2","162","2023-01-02"
"71376","2022","COM","2020","278","8","286","2023-01-02"
"71377","2022","COM","2020","131","1","132","2023-01-02"
"71378","2022","COM","2020","1551","35","1586","2023-01-02"
"71379","2022","COM","2020","1231","23","1254","2023-01-02"
"71380","2022","COM","2020","793","14","807","2023-01-02"
"71381","2022","COM","2020","73","0","73","2023-01-02"
"71382","2022","COM","2020","696","15","711","2023-01-02"
"71383","2022","COM","2020","543","6","549","2023-01-02"
"71384","2022","COM","2020","512","13","525","2023-01-02"
"71385","2022","COM","2020","564","22","586","2023-01-02"
"71386","2022","COM","2020","105","1","106","2023-01-02"
"71387","2022","COM","2020","248","8","256","2023-01-02"
"71388","2022","COM","2020","469","20","489","2023-01-02"
"71389","2022","COM","2020","275","6","281","2023-01-02"
"71390","2022","COM","2020","1094","21","1115","2023-01-02"
"71391","2022","COM","2020","553","17","570","2023-01-02"
"71392","2022","COM","2020","490","9","499","2023-01-02"
"71393","2022","COM","2020","494","18","512","2023-01-02"
"71394","2022","COM","2020","762","20","782","2023-01-02"
"71395","2022","COM","2020","210","2","212","2023-01-02"
"71396","2022","COM","2020","487","5","492","2023-01-02"
"71397","2022","COM","2020","281","8","289","2023-01-02"
"71398","2022","COM","2020","1040","31","1071","2023-01-02"
"71399","2022","COM","2020","532","15","547","2023-01-02"
"71400","2022","COM","2020","132","3","135","2023-01-02"
"71401","2022","COM","2020","638","13","651","2023-01-02"
"71402","2022","COM","2020","760","25","785","2023-01-02"
"71403","2022","COM","2020","265","11","276","2023-01-02"
"71404","2022","COM","2020","904","21","925","2023-01-02"
"71405","2022","COM","2020","193","5","198","2023-01-02"
"71406","2022","COM","2020","124","9","133","2023-01-02"
"71407","2022","COM","2020","218","4","222","2023-01-02"
"71408","2022","COM","2020","432","9","441","2023-01-02"
"71409","2022","COM","2020","312","8","320","2023-01-02"
"71410","2022","COM","2020","791","14","805","2023-01-02"
"71411","2022","COM","2020","153","8","161","2023-01-02"
"71412","2022","COM","2020","1207","25","1232","2023-01-02"
"71413","2022","COM","2020","805","9","814","2023-01-02"
"71414","2022","COM","2020","440","16","456","2023-01-02"
"71415","2022","COM","2020","140","3","143","2023-01-02"
"71416","2022","COM","2020","584","6","590","2023-01-02"
"71417","2022","COM","2020","1053","6","1059","2023-01-02"
"71419","2022","COM","2020","1890","41","1931","2023-01-02"
"71420","2022","COM","2020","2313","51","2364","2023-01-02"
"71421","2022","COM","2020","186","7","193","2023-01-02"
"71422","2022","COM","2020","272","12","284","2023-01-02"
"71423","2022","COM","2020","431","5","436","2023-01-02"
"71424","2022","COM","2020","216","3","219","2023-01-02"
"71425","2022","COM","2020","278","10","288","2023-01-02"
"71426","2022","COM","2020","530","9","539","2023-01-02"
"71427","2022","COM","2020","51","1","52","2023-01-02"
"71428","2022","COM","2020","763","26","789","2023-01-02"
"71430","2022","COM","2020","389","16","405","2023-01-02"
"71431","2022","COM","2020","379","13","392","2023-01-02"
"71433","2022","COM","2020","489","14","503","2023-01-02"
"71434","2022","COM","2020","343","10","353","2023-01-02"
"71435","2022","COM","2020","242","8","250","2023-01-02"
"71436","2022","COM","2020","997","20","1017","2023-01-02"
"71437","2022","COM","2020","322","11","333","2023-01-02"
"71438","2022","COM","2020","525","19","544","2023-01-02"
"71439","2022","COM","2020","760","21","781","2023-01-02"
"71440","2022","COM","2020","373","9","382","2023-01-02"
"71441","2022","COM","2020","281","4","285","2023-01-02"
"71442","2022","COM","2020","1600","18","1618","2023-01-02"
"71443","2022","COM","2020","1644","56","1700","2023-01-02"
"71444","2022","COM","2020","1207","28","1235","2023-01-02"
"71445","2022","COM","2020","6188","147","6335","2023-01-02"
"71446","2022","COM","2020","190","5","195","2023-01-02"
"71447","2022","COM","2020","272","14","286","2023-01-02"
"71448","2022","COM","2020","1387","34","1421","2023-01-02"
"71449","2022","COM","2020","135","7","142","2023-01-02"
"71450","2022","COM","2020","101","4","105","2023-01-02"
"71451","2022","COM","2020","93","0","93","2023-01-02"
"71452","2022","COM","2020","102","1","103","2023-01-02"
"71453","2022","COM","2020","245","11","256","2023-01-02"
"71454","2022","COM","2020","180","8","188","2023-01-02"
"71455","2022","COM","2020","156","1","157","2023-01-02"
"71456","2022","COM","2020","1912","68","1980","2023-01-02"
"71457","2022","COM","2020","119","2","121","2023-01-02"
"71458","2022","COM","2020","61","0","61","2023-01-02"
"71459","2022","COM","2020","340","18","358","2023-01-02"
"71460","2022","COM","2020","482","23","505","2023-01-02"
"71461","2022","COM","2020","62","1","63","2023-01-02"
"71462","2022","COM","2020","522","11","533","2023-01-02"
"71463","2022","COM","2020","570","11","581","2023-01-02"
"71464","2022","COM","2020","180","3","183","2023-01-02"
"71465","2022","COM","2020","275","7","282","2023-01-02"
"71466","2022","COM","2020","120","4","124","2023-01-02"
"71468","2022","COM","2020","848","14","862","2023-01-02"
"71469","2022","COM","2020","368","12","380","2023-01-02"
"71470","2022","COM","2020","349","14","363","2023-01-02"
"71471","2022","COM","2020","95","2","97","2023-01-02"
"71472","2022","COM","2020","206","7","213","2023-01-02"
"71473","2022","COM","2020","149","1","150","2023-01-02"
"71474","2022","COM","2020","147","4","151","2023-01-02"
"71475","2022","COM","2020","6605","158","6763","2023-01-02"
"71477","2022","COM","2020","489","9","498","2023-01-02"
"71478","2022","COM","2020","83","1","84","2023-01-02"
"71479","2022","COM","2020","1736","35","1771","2023-01-02"
"71480","2022","COM","2020","599","13","612","2023-01-02"
"71481","2022","COM","2020","1132","20","1152","2023-01-02"
"71482","2022","COM","2020","837","11","848","2023-01-02"
"71483","2022","COM","2020","418","12","430","2023-01-02"
"71484","2022","COM","2020","1256","29","1285","2023-01-02"
"71485","2022","COM","2020","257","14","271","2023-01-02"
"71486","2022","COM","2020","8541","163","8704","2023-01-02"
"71487","2022","COM","2020","160","4","164","2023-01-02"
"71488","2022","COM","2020","102","4","106","2023-01-02"
"71489","2022","COM","2020","576","9","585","2023-01-02"
"71490","2022","COM","2020","1013","17","1030","2023-01-02"
"71491","2022","COM","2020","1153","23","1176","2023-01-02"
"71492","2022","COM","2020","127","2","129","2023-01-02"
"71493","2022","COM","2020","345","8","353","2023-01-02"
"71494","2022","COM","2020","516","14","530","2023-01-02"
"71495","2022","COM","2020","873","11","884","2023-01-02"
"71496","2022","COM","2020","140","5","145","2023-01-02"
"71497","2022","COM","2020","2181","54","2235","2023-01-02"
"71498","2022","COM","2020","132","6","138","2023-01-02"
"71499","2022","COM","2020","4325","75","4400","2023-01-02"
"71500","2022","COM","2020","90","3","93","2023-01-02"
"71501","2022","COM","2020","143","3","146","2023-01-02"
"71502","2022","COM","2020","1586","45","1631","2023-01-02"
"71503","2022","COM","2020","128","3","131","2023-01-02"
"71504","2022","COM","2020","81","1","82","2023-01-02"
"71505","2022","COM","2020","77","1","78","2023-01-02"
"71506","2022","COM","2020","1132","17","1149","2023-01-02"
"71507","2022","COM","2020","171","1","172","2023-01-02"
"71508","2022","COM","2020","399","9","408","2023-01-02"
"71509","2022","COM","2020","474","6","480","2023-01-02"
"71510","2022","COM","2020","610","19","629","2023-01-02"
"71512","2022","COM","2020","2943","66","3009","2023-01-02"
"71513","2022","COM","2020","1128","37","1165","2023-01-02"
"71514","2022","COM","2020","424","5","429","2023-01-02"
"71515","2022","COM","2020","102","3","105","2023-01-02"
"71516","2022","COM","2020","603","9","612","2023-01-02"
"71517","2022","COM","2020","237","5","242","2023-01-02"
"71518","2022","COM","2020","271","9","280","2023-01-02"
"71519","2022","COM","2020","188","4","192","2023-01-02"
"71520","2022","COM","2020","1263","21","1284","2023-01-02"
"71521","2022","COM","2020","106","4","110","2023-01-02"
"71522","2022","COM","2020","1737","17","1754","2023-01-02"
"71523","2022","COM","2020","1184","11","1195","2023-01-02"
"71524","2022","COM","2020","176","7","183","2023-01-02"
"71525","2022","COM","2020","577","10","587","2023-01-02"
"71526","2022","COM","2020","364","7","371","2023-01-02"
"71527","2022","COM","2020","201","5","206","2023-01-02"
"71528","2022","COM","2020","1990","45","2035","2023-01-02"
"71529","2022","COM","2020","263","5","268","2023-01-02"
"71530","2022","COM","2020","490","3","493","2023-01-02"
"71531","2022","COM","2020","212","1","213","2023-01-02"
"71532","2022","COM","2020","194","3","197","2023-01-02"
"71533","2022","COM","2020","525","18","543","2023-01-02"
"71534","2022","COM","2020","111","5","116","2023-01-02"
"71535","2022","COM","2020","509","11","520","2023-01-02"
"71537","2022","COM","2020","128","0","128","2023-01-02"
"71538","2022","COM","2020","430","12","442","2023-01-02"
"71539","2022","COM","2020","79","1","80","2023-01-02"
"71540","2022","COM","2020","2810","37","2847","2023-01-02"
"71541","2022","COM","2020","375","4","379","2023-01-02"
"71542","2022","COM","2020","1472","26","1498","2023-01-02"
"71543","2022","COM","2020","5552","280","5832","2023-01-02"
"71544","2022","COM","2020","187","2","189","2023-01-02"
"71545","2022","COM","2020","1062","18","1080","2023-01-02"
"71546","2022","COM","2020","407","7","414","2023-01-02"
"71547","2022","COM","2020","252","7","259","2023-01-02"
"71548","2022","COM","2020","245","2","247","2023-01-02"
"71549","2022","COM","2020","208","6","214","2023-01-02"
"71550","2022","COM","2020","819","14","833","2023-01-02"
"71551","2022","COM","2020","89","5","94","2023-01-02"
"71552","2022","COM","2020","519","12","531","2023-01-02"
"71553","2022","COM","2020","276","5","281","2023-01-02"
"71554","2022","COM","2020","112","3","115","2023-01-02"
"71555","2022","COM","2020","2331","49","2380","2023-01-02"
"71556","2022","COM","2020","569","7","576","2023-01-02"
"71557","2022","COM","2020","713","20","733","2023-01-02"
"71558","2022","COM","2020","1131","25","1156","2023-01-02"
"71559","2022","COM","2020","533","13","546","2023-01-02"
"71561","2022","COM","2020","227","10","237","2023-01-02"
"71562","2022","COM","2020","209","33","242","2023-01-02"
"71563","2022","COM","2020","72","1","73","2023-01-02"
"71564","2022","COM","2020","745","19","764","2023-01-02"
"71565","2022","COM","2020","563","12","575","2023-01-02"
"71566","2022","COM","2020","977","9","986","2023-01-02"
"71567","2022","COM","2020","255","7","262","2023-01-02"
"71568","2022","COM","2020","58","0","58","2023-01-02"
"71570","2022","COM","2020","510","11","521","2023-01-02"
"71571","2022","COM","2020","438","14","452","2023-01-02"
"71572","2022","COM","2020","234","0","234","2023-01-02"
"71573","2022","COM","2020","192","4","196","2023-01-02"
"71574","2022","COM","2020","814","27","841","2023-01-02"
"71576","2022","COM","2020","279","5","284","2023-01-02"
"71577","2022","COM","2020","223","4","227","2023-01-02"
"71578","2022","COM","2020","309","10","319","2023-01-02"
"71579","2022","COM","2020","169","2","171","2023-01-02"
"71580","2022","COM","2020","429","14","443","2023-01-02"
"71581","2022","COM","2020","251","5","256","2023-01-02"
"71582","2022","COM","2020","651","19","670","2023-01-02"
"71583","2022","COM","2020","732","24","756","2023-01-02"
"71584","2022","COM","2020","1201","29","1230","2023-01-02"
"71585","2022","COM","2020","1369","73","1442","2023-01-02"
"71586","2022","COM","2020","259","4","263","2023-01-02"
"71588","2022","COM","2020","1099","38","1137","2023-01-02"
"71589","2022","COM","2020","418","8","426","2023-01-02"
"71590","2022","COM","2020","644","23","667","2023-01-02"
"71591","2022","COM","2020","512","8","520","2023-01-02"
"72001","2022","COM","2020","1692","32","1724","2023-01-02"
"72002","2022","COM","2020","199","5","204","2023-01-02"
"72003","2022","COM","2020","11108","99","11207","2023-01-02"
"72004","2022","COM","2020","580","8","588","2023-01-02"
"72005","2022","COM","2020","942","22","964","2023-01-02"
"72006","2022","COM","2020","1882","232","2114","2023-01-02"
"72007","2022","COM","2020","500","11","511","2023-01-02"
"72008","2022","COM","2020","5520","127","5647","2023-01-02"
"72009","2022","COM","2020","358","8","366","2023-01-02"
"72010","2022","COM","2020","379","9","388","2023-01-02"
"72011","2022","COM","2020","902","17","919","2023-01-02"
"72012","2022","COM","2020","486","10","496","2023-01-02"
"72013","2022","COM","2020","2108","26","2134","2023-01-02"
"72015","2022","COM","2020","112","0","112","2023-01-02"
"72016","2022","COM","2020","1484","36","1520","2023-01-02"
"72017","2022","COM","2020","233","3","236","2023-01-02"
"72018","2022","COM","2020","85","1","86","2023-01-02"
"72019","2022","COM","2020","363","9","372","2023-01-02"
"72020","2022","COM","2020","694","17","711","2023-01-02"
"72021","2022","COM","2020","579","7","586","2023-01-02"
"72022","2022","COM","2020","1214","27","1241","2023-01-02"
"72023","2022","COM","2020","2260","30","2290","2023-01-02"
"72024","2022","COM","2020","3651","60","3711","2023-01-02"
"72025","2022","COM","2020","1975","47","2022","2023-01-02"
"72026","2022","COM","2020","1507","16","1523","2023-01-02"
"72027","2022","COM","2020","328","2","330","2023-01-02"
"72028","2022","COM","2020","481","8","489","2023-01-02"
"72029","2022","COM","2020","1979","28","2007","2023-01-02"
"72031","2022","COM","2020","529","3","532","2023-01-02"
"72032","2022","COM","2020","335","10","345","2023-01-02"
"72034","2022","COM","2020","438","12","450","2023-01-02"
"72035","2022","COM","2020","2069","46","2115","2023-01-02"
"72036","2022","COM","2020","307","4","311","2023-01-02"
"72037","2022","COM","2020","123","1","124","2023-01-02"
"72038","2022","COM","2020","547","1","548","2023-01-02"
"72039","2022","COM","2020","3749","57","3806","2023-01-02"
"72040","2022","COM","2020","144","2","146","2023-01-02"
"72041","2022","COM","2020","349","5","354","2023-01-02"
"72042","2022","COM","2020","2109","32","2141","2023-01-02"
"72043","2022","COM","2020","329","7","336","2023-01-02"
"72044","2022","COM","2020","432","5","437","2023-01-02"
"72045","2022","COM","2020","828","13","841","2023-01-02"
"72046","2022","COM","2020","1544","26","1570","2023-01-02"
"72047","2022","COM","2020","2128","140","2268","2023-01-02"
"72048","2022","COM","2020","523","4","527","2023-01-02"
"72049","2022","COM","2020","248","1","249","2023-01-02"
"72050","2022","COM","2020","1533","29","1562","2023-01-02"
"72051","2022","COM","2020","3377","36","3413","2023-01-02"
"72052","2022","COM","2020","671","10","681","2023-01-02"
"72053","2022","COM","2020","1205","21","1226","2023-01-02"
"72054","2022","COM","2020","3697","60","3757","2023-01-02"
"72056","2022","COM","2020","1332","24","1356","2023-01-02"
"72057","2022","COM","2020","70","3","73","2023-01-02"
"72058","2022","COM","2020","6569","174","6743","2023-01-02"
"72059","2022","COM","2020","829","19","848","2023-01-02"
"72060","2022","COM","2020","270","1","271","2023-01-02"
"72061","2022","COM","2020","1711","25","1736","2023-01-02"
"72062","2022","COM","2020","832","19","851","2023-01-02"
"72064","2022","COM","2020","519","10","529","2023-01-02"
"72065","2022","COM","2020","2278","66","2344","2023-01-02"
"72066","2022","COM","2020","423","7","430","2023-01-02"
"72067","2022","COM","2020","993","7","1000","2023-01-02"
"72068","2022","COM","2020","1367","16","1383","2023-01-02"
"72070","2022","COM","2020","250","6","256","2023-01-02"
"72071","2022","COM","2020","5903","217","6120","2023-01-02"
"72072","2022","COM","2020","253","2","255","2023-01-02"
"72073","2022","COM","2020","1124","23","1147","2023-01-02"
"72074","2022","COM","2020","211","9","220","2023-01-02"
"72075","2022","COM","2020","998","26","1024","2023-01-02"
"72076","2022","COM","2020","247","2","249","2023-01-02"
"72077","2022","COM","2020","426","8","434","2023-01-02"
"72078","2022","COM","2020","354","3","357","2023-01-02"
"72079","2022","COM","2020","312","3","315","2023-01-02"
"72080","2022","COM","2020","2723","80","2803","2023-01-02"
"72083","2022","COM","2020","367","11","378","2023-01-02"
"72084","2022","COM","2020","1268","35","1303","2023-01-02"
"72085","2022","COM","2020","183","2","185","2023-01-02"
"72086","2022","COM","2020","138","4","142","2023-01-02"
"72087","2022","COM","2020","471","14","485","2023-01-02"
"72088","2022","COM","2020","329","11","340","2023-01-02"
"72089","2022","COM","2020","1845","36","1881","2023-01-02"
"72090","2022","COM","2020","2953","58","3011","2023-01-02"
"72091","2022","COM","2020","133","4","137","2023-01-02"
"72093","2022","COM","2020","897","19","916","2023-01-02"
"72094","2022","COM","2020","623","13","636","2023-01-02"
"72095","2022","COM","2020","7958","118","8076","2023-01-02"
"72096","2022","COM","2020","1647","78","1725","2023-01-02"
"72098","2022","COM","2020","508","15","523","2023-01-02"
"72099","2022","COM","2020","642","7","649","2023-01-02"
"72100","2022","COM","2020","409","4","413","2023-01-02"
"72101","2022","COM","2020","675","13","688","2023-01-02"
"72102","2022","COM","2020","93","2","95","2023-01-02"
"72103","2022","COM","2020","609","8","617","2023-01-02"
"72104","2022","COM","2020","577","16","593","2023-01-02"
"72105","2022","COM","2020","482","9","491","2023-01-02"
"72106","2022","COM","2020","928","29","957","2023-01-02"
"72107","2022","COM","2020","345","7","352","2023-01-02"
"72109","2022","COM","2020","550","6","556","2023-01-02"
"72110","2022","COM","2020","1039","20","1059","2023-01-02"
"72111","2022","COM","2020","477","17","494","2023-01-02"
"72112","2022","COM","2020","477","5","482","2023-01-02"
"72113","2022","COM","2020","756","12","768","2023-01-02"
"72114","2022","COM","2020","267","7","274","2023-01-02"
"72115","2022","COM","2020","920","23","943","2023-01-02"
"72118","2022","COM","2020","1446","23","1469","2023-01-02"
"72119","2022","COM","2020","1043","19","1062","2023-01-02"
"72120","2022","COM","2020","243","5","248","2023-01-02"
"72121","2022","COM","2020","319","10","329","2023-01-02"
"72122","2022","COM","2020","1061","21","1082","2023-01-02"
"72123","2022","COM","2020","68","1","69","2023-01-02"
"72124","2022","COM","2020","4752","76","4828","2023-01-02"
"72125","2022","COM","2020","299","10","309","2023-01-02"
"72126","2022","COM","2020","292","9","301","2023-01-02"
"72127","2022","COM","2020","1921","38","1959","2023-01-02"
"72128","2022","COM","2020","518","6","524","2023-01-02"
"72129","2022","COM","2020","857","16","873","2023-01-02"
"72130","2022","COM","2020","716","12","728","2023-01-02"
"72131","2022","COM","2020","588","8","596","2023-01-02"
"72132","2022","COM","2020","8863","335","9198","2023-01-02"
"72133","2022","COM","2020","1507","28","1535","2023-01-02"
"72134","2022","COM","2020","528","15","543","2023-01-02"
"72135","2022","COM","2020","601","6","607","2023-01-02"
"72136","2022","COM","2020","313","8","321","2023-01-02"
"72137","2022","COM","2020","2218","39","2257","2023-01-02"
"72138","2022","COM","2020","2871","45","2916","2023-01-02"
"72139","2022","COM","2020","981","41","1022","2023-01-02"
"72141","2022","COM","2020","903","34","937","2023-01-02"
"72142","2022","COM","2020","146","5","151","2023-01-02"
"72143","2022","COM","2020","1927","25","1952","2023-01-02"
"72144","2022","COM","2020","330","4","334","2023-01-02"
"72145","2022","COM","2020","391","4","395","2023-01-02"
"72146","2022","COM","2020","3144","41","3185","2023-01-02"
"72147","2022","COM","2020","1178","24","1202","2023-01-02"
"72148","2022","COM","2020","81","1","82","2023-01-02"
"72149","2022","COM","2020","614","10","624","2023-01-02"
"72150","2022","COM","2020","1266","22","1288","2023-01-02"
"72151","2022","COM","2020","1131","31","1162","2023-01-02"
"72152","2022","COM","2020","429","11","440","2023-01-02"
"72153","2022","COM","2020","551","14","565","2023-01-02"
"72154","2022","COM","2020","15078","1087","16165","2023-01-02"
"72155","2022","COM","2020","2297","30","2327","2023-01-02"
"72156","2022","COM","2020","925","24","949","2023-01-02"
"72157","2022","COM","2020","703","13","716","2023-01-02"
"72158","2022","COM","2020","818","12","830","2023-01-02"
"72160","2022","COM","2020","586","12","598","2023-01-02"
"72161","2022","COM","2020","924","11","935","2023-01-02"
"72163","2022","COM","2020","488","9","497","2023-01-02"
"72164","2022","COM","2020","70","0","70","2023-01-02"
"72165","2022","COM","2020","1912","24","1936","2023-01-02"
"72166","2022","COM","2020","314","10","324","2023-01-02"
"72167","2022","COM","2020","714","11","725","2023-01-02"
"72168","2022","COM","2020","2062","40","2102","2023-01-02"
"72169","2022","COM","2020","1458","25","1483","2023-01-02"
"72170","2022","COM","2020","169","7","176","2023-01-02"
"72171","2022","COM","2020","103","3","106","2023-01-02"
"72172","2022","COM","2020","1441","17","1458","2023-01-02"
"72173","2022","COM","2020","1234","27","1261","2023-01-02"
"72174","2022","COM","2020","100","1","101","2023-01-02"
"72175","2022","COM","2020","1523","19","1542","2023-01-02"
"72176","2022","COM","2020","4100","73","4173","2023-01-02"
"72177","2022","COM","2020","357","4","361","2023-01-02"
"72178","2022","COM","2020","190","1","191","2023-01-02"
"72179","2022","COM","2020","1882","34","1916","2023-01-02"
"72180","2022","COM","2020","5082","170","5252","2023-01-02"
"72181","2022","COM","2020","145155","2828","147983","2023-01-02"
"72182","2022","COM","2020","1541","29","1570","2023-01-02"
"72183","2022","COM","2020","1076","17","1093","2023-01-02"
"72184","2022","COM","2020","371","6","377","2023-01-02"
"72185","2022","COM","2020","660","5","665","2023-01-02"
"72186","2022","COM","2020","885","11","896","2023-01-02"
"72187","2022","COM","2020","1613","17","1630","2023-01-02"
"72188","2022","COM","2020","154","2","156","2023-01-02"
"72189","2022","COM","2020","2061","26","2087","2023-01-02"
"72190","2022","COM","2020","280","10","290","2023-01-02"
"72191","2022","COM","2020","3142","43","3185","2023-01-02"
"72192","2022","COM","2020","98","3","101","2023-01-02"
"72193","2022","COM","2020","429","7","436","2023-01-02"
"72194","2022","COM","2020","267","2","269","2023-01-02"
"72195","2022","COM","2020","1853","28","1881","2023-01-02"
"72196","2022","COM","2020","730","6","736","2023-01-02"
"72197","2022","COM","2020","686","5","691","2023-01-02"
"72198","2022","COM","2020","2635","36","2671","2023-01-02"
"72199","2022","COM","2020","282","1","283","2023-01-02"
"72200","2022","COM","2020","3669","61","3730","2023-01-02"
"72201","2022","COM","2020","259","5","264","2023-01-02"
"72202","2022","COM","2020","194","10","204","2023-01-02"
"72204","2022","COM","2020","512","7","519","2023-01-02"
"72205","2022","COM","2020","1821","24","1845","2023-01-02"
"72208","2022","COM","2020","374","9","383","2023-01-02"
"72209","2022","COM","2020","304","1","305","2023-01-02"
"72210","2022","COM","2020","301","5","306","2023-01-02"
"72211","2022","COM","2020","636","9","645","2023-01-02"
"72212","2022","COM","2020","697","13","710","2023-01-02"
"72213","2022","COM","2020","5231","64","5295","2023-01-02"
"72214","2022","COM","2020","11","0","11","2023-01-02"
"72215","2022","COM","2020","1042","12","1054","2023-01-02"
"72216","2022","COM","2020","598","14","612","2023-01-02"
"72217","2022","COM","2020","2461","48","2509","2023-01-02"
"72218","2022","COM","2020","292","4","296","2023-01-02"
"72219","2022","COM","2020","821","88","909","2023-01-02"
"72220","2022","COM","2020","899","37","936","2023-01-02"
"72221","2022","COM","2020","369","5","374","2023-01-02"
"72222","2022","COM","2020","264","0","264","2023-01-02"
"72223","2022","COM","2020","2633","32","2665","2023-01-02"
"72224","2022","COM","2020","528","3","531","2023-01-02"
"72225","2022","COM","2020","669","8","677","2023-01-02"
"72226","2022","COM","2020","1334","19","1353","2023-01-02"
"72227","2022","COM","2020","39","0","39","2023-01-02"
"72228","2022","COM","2020","2086","49","2135","2023-01-02"
"72229","2022","COM","2020","465","8","473","2023-01-02"
"72230","2022","COM","2020","1062","26","1088","2023-01-02"
"72231","2022","COM","2020","5320","84","5404","2023-01-02"
"72232","2022","COM","2020","674","13","687","2023-01-02"
"72233","2022","COM","2020","64","0","64","2023-01-02"
"72234","2022","COM","2020","359","5","364","2023-01-02"
"72235","2022","COM","2020","373","7","380","2023-01-02"
"72236","2022","COM","2020","190","8","198","2023-01-02"
"72237","2022","COM","2020","502","6","508","2023-01-02"
"72238","2022","COM","2020","73","0","73","2023-01-02"
"72239","2022","COM","2020","605","21","626","2023-01-02"
"72241","2022","COM","2020","2906","48","2954","2023-01-02"
"72243","2022","COM","2020","1634","26","1660","2023-01-02"
"72244","2022","COM","2020","2938","63","3001","2023-01-02"
"72245","2022","COM","2020","684","14","698","2023-01-02"
"72246","2022","COM","2020","203","6","209","2023-01-02"
"72247","2022","COM","2020","1331","31","1362","2023-01-02"
"72248","2022","COM","2020","818","23","841","2023-01-02"
"72249","2022","COM","2020","778","13","791","2023-01-02"
"72250","2022","COM","2020","147","9","156","2023-01-02"
"72251","2022","COM","2020","389","5","394","2023-01-02"
"72252","2022","COM","2020","1134","10","1144","2023-01-02"
"72253","2022","COM","2020","2589","70","2659","2023-01-02"
"72254","2022","COM","2020","264","6","270","2023-01-02"
"72255","2022","COM","2020","795","16","811","2023-01-02"
"72256","2022","COM","2020","796","16","812","2023-01-02"
"72257","2022","COM","2020","2297","316","2613","2023-01-02"
"72259","2022","COM","2020","279","7","286","2023-01-02"
"72260","2022","COM","2020","3536","64","3600","2023-01-02"
"72261","2022","COM","2020","297","12","309","2023-01-02"
"72262","2022","COM","2020","2120","130","2250","2023-01-02"
"72264","2022","COM","2020","12123","471","12594","2023-01-02"
"72265","2022","COM","2020","232","2","234","2023-01-02"
"72266","2022","COM","2020","743","17","760","2023-01-02"
"72267","2022","COM","2020","913","21","934","2023-01-02"
"72268","2022","COM","2020","705","11","716","2023-01-02"
"72269","2022","COM","2020","3139","207","3346","2023-01-02"
"72270","2022","COM","2020","196","0","196","2023-01-02"
"72271","2022","COM","2020","897","7","904","2023-01-02"
"72272","2022","COM","2020","316","7","323","2023-01-02"
"72273","2022","COM","2020","231","3","234","2023-01-02"
"72274","2022","COM","2020","206","7","213","2023-01-02"
"72275","2022","COM","2020","1520","21","1541","2023-01-02"
"72276","2022","COM","2020","1902","46","1948","2023-01-02"
"72277","2022","COM","2020","113","1","114","2023-01-02"
"72278","2022","COM","2020","762","11","773","2023-01-02"
"72279","2022","COM","2020","151","3","154","2023-01-02"
"72280","2022","COM","2020","2162","37","2199","2023-01-02"
"72281","2022","COM","2020","447","5","452","2023-01-02"
"72282","2022","COM","2020","530","7","537","2023-01-02"
"72283","2022","COM","2020","337","6","343","2023-01-02"
"72286","2022","COM","2020","389","7","396","2023-01-02"
"72287","2022","COM","2020","2004","45","2049","2023-01-02"
"72289","2022","COM","2020","2010","34","2044","2023-01-02"
"72290","2022","COM","2020","1842","17","1859","2023-01-02"
"72291","2022","COM","2020","975","18","993","2023-01-02"
"72292","2022","COM","2020","230","5","235","2023-01-02"
"72293","2022","COM","2020","613","7","620","2023-01-02"
"72294","2022","COM","2020","474","15","489","2023-01-02"
"72295","2022","COM","2020","503","6","509","2023-01-02"
"72296","2022","COM","2020","744","23","767","2023-01-02"
"72297","2022","COM","2020","538","12","550","2023-01-02"
"72298","2022","COM","2020","565","14","579","2023-01-02"
"72299","2022","COM","2020","2450","34","2484","2023-01-02"
"72300","2022","COM","2020","2698","28","2726","2023-01-02"
"72302","2022","COM","2020","170","4","174","2023-01-02"
"72303","2022","COM","2020","731","9","740","2023-01-02"
"72305","2022","COM","2020","933","24","957","2023-01-02"
"72306","2022","COM","2020","1323","24","1347","2023-01-02"
"72307","2022","COM","2020","237","6","243","2023-01-02"
"72308","2022","COM","2020","2103","250","2353","2023-01-02"
"72309","2022","COM","2020","283","7","290","2023-01-02"
"72310","2022","COM","2020","1909","59","1968","2023-01-02"
"72311","2022","COM","2020","344","6","350","2023-01-02"
"72312","2022","COM","2020","232","3","235","2023-01-02"
"72313","2022","COM","2020","224","5","229","2023-01-02"
"72314","2022","COM","2020","378","8","386","2023-01-02"
"72315","2022","COM","2020","834","14","848","2023-01-02"
"72316","2022","COM","2020","692","13","705","2023-01-02"
"72317","2022","COM","2020","500","15","515","2023-01-02"
"72319","2022","COM","2020","738","19","757","2023-01-02"
"72320","2022","COM","2020","2705","82","2787","2023-01-02"
"72321","2022","COM","2020","509","10","519","2023-01-02"
"72322","2022","COM","2020","223","2","225","2023-01-02"
"72323","2022","COM","2020","452","7","459","2023-01-02"
"72324","2022","COM","2020","503","14","517","2023-01-02"
"72325","2022","COM","2020","832","17","849","2023-01-02"
"72326","2022","COM","2020","211","3","214","2023-01-02"
"72327","2022","COM","2020","289","8","297","2023-01-02"
"72328","2022","COM","2020","3761","93","3854","2023-01-02"
"72329","2022","COM","2020","4062","79","4141","2023-01-02"
"72330","2022","COM","2020","436","13","449","2023-01-02"
"72331","2022","COM","2020","577","12","589","2023-01-02"
"72332","2022","COM","2020","603","8","611","2023-01-02"
"72333","2022","COM","2020","438","11","449","2023-01-02"
"72334","2022","COM","2020","2195","85","2280","2023-01-02"
"72335","2022","COM","2020","1073","15","1088","2023-01-02"
"72336","2022","COM","2020","1212","40","1252","2023-01-02"
"72337","2022","COM","2020","847","20","867","2023-01-02"
"72338","2022","COM","2020","784","11","795","2023-01-02"
"72339","2022","COM","2020","665","10","675","2023-01-02"
"72340","2022","COM","2020","1239","22","1261","2023-01-02"
"72341","2022","COM","2020","619","12","631","2023-01-02"
"72342","2022","COM","2020","163","7","170","2023-01-02"
"72343","2022","COM","2020","619","13","632","2023-01-02"
"72344","2022","COM","2020","2863","50","2913","2023-01-02"
"72345","2022","COM","2020","339","5","344","2023-01-02"
"72346","2022","COM","2020","4498","59","4557","2023-01-02"
"72347","2022","COM","2020","297","5","302","2023-01-02"
"72348","2022","COM","2020","129","1","130","2023-01-02"
"72349","2022","COM","2020","476","2","478","2023-01-02"
"72350","2022","COM","2020","3056","62","3118","2023-01-02"
"72351","2022","COM","2020","1048","19","1067","2023-01-02"
"72352","2022","COM","2020","140","0","140","2023-01-02"
"72353","2022","COM","2020","215","5","220","2023-01-02"
"72354","2022","COM","2020","163","1","164","2023-01-02"
"72355","2022","COM","2020","110","1","111","2023-01-02"
"72356","2022","COM","2020","406","6","412","2023-01-02"
"72357","2022","COM","2020","735","12","747","2023-01-02"
"72358","2022","COM","2020","1613","37","1650","2023-01-02"
"72359","2022","COM","2020","1430","9","1439","2023-01-02"
"72360","2022","COM","2020","1553","39","1592","2023-01-02"
"72361","2022","COM","2020","491","8","499","2023-01-02"
"72362","2022","COM","2020","166","1","167","2023-01-02"
"72363","2022","COM","2020","1668","16","1684","2023-01-02"
"72364","2022","COM","2020","1394","25","1419","2023-01-02"
"72366","2022","COM","2020","315","2","317","2023-01-02"
"72367","2022","COM","2020","785","11","796","2023-01-02"
"72368","2022","COM","2020","310","3","313","2023-01-02"
"72369","2022","COM","2020","578","55","633","2023-01-02"
"72370","2022","COM","2020","326","6","332","2023-01-02"
"72372","2022","COM","2020","77","0","77","2023-01-02"
"72373","2022","COM","2020","2509","55","2564","2023-01-02"
"72374","2022","COM","2020","146","5","151","2023-01-02"
"72375","2022","COM","2020","529","14","543","2023-01-02"
"72376","2022","COM","2020","688","25","713","2023-01-02"
"72377","2022","COM","2020","1034","12","1046","2023-01-02"
"72378","2022","COM","2020","1426","28","1454","2023-01-02"
"72379","2022","COM","2020","198","7","205","2023-01-02"
"72380","2022","COM","2020","931","13","944","2023-01-02"
"72381","2022","COM","2020","1371","12","1383","2023-01-02"
"72382","2022","COM","2020","955","18","973","2023-01-02"
"72383","2022","COM","2020","132","4","136","2023-01-02"
"72385","2022","COM","2020","1759","24","1783","2023-01-02"
"72386","2022","COM","2020","4241","134","4375","2023-01-02"
"73001","2022","COM","2020","230","9","239","2023-01-02"
"73003","2022","COM","2020","3823","104","3927","2023-01-02"
"73004","2022","COM","2020","431","15","446","2023-01-02"
"73005","2022","COM","2020","194","5","199","2023-01-02"
"73006","2022","COM","2020","4433","104","4537","2023-01-02"
"73007","2022","COM","2020","1683","23","1706","2023-01-02"
"73008","2022","COM","2020","31100","542","31642","2023-01-02"
"73010","2022","COM","2020","6340","140","6480","2023-01-02"
"73011","2022","COM","2020","19830","584","20414","2023-01-02"
"73012","2022","COM","2020","146","2","148","2023-01-02"
"73013","2022","COM","2020","364","10","374","2023-01-02"
"73014","2022","COM","2020","290","8","298","2023-01-02"
"73015","2022","COM","2020","1829","48","1877","2023-01-02"
"73017","2022","COM","2020","979","21","1000","2023-01-02"
"73018","2022","COM","2020","765","21","786","2023-01-02"
"73019","2022","COM","2020","951","21","972","2023-01-02"
"73020","2022","COM","2020","440","11","451","2023-01-02"
"73021","2022","COM","2020","846","17","863","2023-01-02"
"73022","2022","COM","2020","566","13","579","2023-01-02"
"73023","2022","COM","2020","693","18","711","2023-01-02"
"73024","2022","COM","2020","768","22","790","2023-01-02"
"73025","2022","COM","2020","531","11","542","2023-01-02"
"73026","2022","COM","2020","389","16","405","2023-01-02"
"73027","2022","COM","2020","387","6","393","2023-01-02"
"73028","2022","COM","2020","344","3","347","2023-01-02"
"73029","2022","COM","2020","5167","123","5290","2023-01-02"
"73030","2022","COM","2020","3551","53","3604","2023-01-02"
"73031","2022","COM","2020","5063","127","5190","2023-01-02"
"73032","2022","COM","2020","2129","37","2166","2023-01-02"
"73033","2022","COM","2020","510","12","522","2023-01-02"
"73034","2022","COM","2020","2024","82","2106","2023-01-02"
"73036","2022","COM","2020","689","19","708","2023-01-02"
"73039","2022","COM","2020","523","12","535","2023-01-02"
"73040","2022","COM","2020","359","8","367","2023-01-02"
"73041","2022","COM","2020","307","8","315","2023-01-02"
"73042","2022","COM","2020","259","6","265","2023-01-02"
"73043","2022","COM","2020","2867","37","2904","2023-01-02"
"73047","2022","COM","2020","263","5","268","2023-01-02"
"73048","2022","COM","2020","353","14","367","2023-01-02"
"73049","2022","COM","2020","147","0","147","2023-01-02"
"73050","2022","COM","2020","579","20","599","2023-01-02"
"73051","2022","COM","2020","4911","98","5009","2023-01-02"
"73052","2022","COM","2020","147","5","152","2023-01-02"
"73053","2022","COM","2020","694","11","705","2023-01-02"
"73054","2022","COM","2020","7160","401","7561","2023-01-02"
"73055","2022","COM","2020","1876","58","1934","2023-01-02"
"73057","2022","COM","2020","491","13","504","2023-01-02"
"73058","2022","COM","2020","1250","19","1269","2023-01-02"
"73059","2022","COM","2020","2327","73","2400","2023-01-02"
"73061","2022","COM","2020","421","16","437","2023-01-02"
"73063","2022","COM","2020","705","9","714","2023-01-02"
"73064","2022","COM","2020","5609","266","5875","2023-01-02"
"73065","2022","COM","2020","59172","1577","60749","2023-01-02"
"73067","2022","COM","2020","1164","19","1183","2023-01-02"
"73068","2022","COM","2020","597","13","610","2023-01-02"
"73069","2022","COM","2020","954","17","971","2023-01-02"
"73070","2022","COM","2020","692","9","701","2023-01-02"
"73071","2022","COM","2020","557","20","577","2023-01-02"
"73072","2022","COM","2020","31","1","32","2023-01-02"
"73073","2022","COM","2020","547","7","554","2023-01-02"
"73074","2022","COM","2020","330","11","341","2023-01-02"
"73075","2022","COM","2020","577","23","600","2023-01-02"
"73076","2022","COM","2020","260","5","265","2023-01-02"
"73077","2022","COM","2020","563","9","572","2023-01-02"
"73078","2022","COM","2020","142","6","148","2023-01-02"
"73079","2022","COM","2020","936","16","952","2023-01-02"
"73081","2022","COM","2020","661","43","704","2023-01-02"
"73082","2022","COM","2020","740","29","769","2023-01-02"
"73083","2022","COM","2020","223","3","226","2023-01-02"
"73084","2022","COM","2020","938","15","953","2023-01-02"
"73085","2022","COM","2020","1408","21","1429","2023-01-02"
"73086","2022","COM","2020","388","13","401","2023-01-02"
"73087","2022","COM","2020","6467","189","6656","2023-01-02"
"73088","2022","COM","2020","151","4","155","2023-01-02"
"73089","2022","COM","2020","1281","26","1307","2023-01-02"
"73090","2022","COM","2020","264","7","271","2023-01-02"
"73091","2022","COM","2020","210","3","213","2023-01-02"
"73092","2022","COM","2020","154","4","158","2023-01-02"
"73094","2022","COM","2020","332","13","345","2023-01-02"
"73095","2022","COM","2020","383","9","392","2023-01-02"
"73096","2022","COM","2020","1045","19","1064","2023-01-02"
"73097","2022","COM","2020","671","21","692","2023-01-02"
"73098","2022","COM","2020","812","22","834","2023-01-02"
"73099","2022","COM","2020","435","4","439","2023-01-02"
"73100","2022","COM","2020","1929","45","1974","2023-01-02"
"73101","2022","COM","2020","97","2","99","2023-01-02"
"73103","2022","COM","2020","2998","67","3065","2023-01-02"
"73104","2022","COM","2020","483","5","488","2023-01-02"
"73105","2022","COM","2020","1246","16","1262","2023-01-02"
"73106","2022","COM","2020","306","6","312","2023-01-02"
"73107","2022","COM","2020","641","8","649","2023-01-02"
"73109","2022","COM","2020","770","14","784","2023-01-02"
"73110","2022","COM","2020","771","7","778","2023-01-02"
"73113","2022","COM","2020","175","3","178","2023-01-02"
"73114","2022","COM","2020","796","28","824","2023-01-02"
"73116","2022","COM","2020","481","12","493","2023-01-02"
"73117","2022","COM","2020","698","10","708","2023-01-02"
"73119","2022","COM","2020","100","4","104","2023-01-02"
"73120","2022","COM","2020","616","10","626","2023-01-02"
"73121","2022","COM","2020","1943","48","1991","2023-01-02"
"73122","2022","COM","2020","427","19","446","2023-01-02"
"73123","2022","COM","2020","383","14","397","2023-01-02"
"73124","2022","COM","2020","3062","79","3141","2023-01-02"
"73128","2022","COM","2020","4598","103","4701","2023-01-02"
"73129","2022","COM","2020","1202","39","1241","2023-01-02"
"73130","2022","COM","2020","2097","40","2137","2023-01-02"
"73131","2022","COM","2020","301","9","310","2023-01-02"
"73132","2022","COM","2020","759","23","782","2023-01-02"
"73133","2022","COM","2020","351","8","359","2023-01-02"
"73135","2022","COM","2020","1083","19","1102","2023-01-02"
"73137","2022","COM","2020","4017","77","4094","2023-01-02"
"73138","2022","COM","2020","495","11","506","2023-01-02"
"73139","2022","COM","2020","266","4","270","2023-01-02"
"73140","2022","COM","2020","281","6","287","2023-01-02"
"73141","2022","COM","2020","709","8","717","2023-01-02"
"73142","2022","COM","2020","802","20","822","2023-01-02"
"73145","2022","COM","2020","469","13","482","2023-01-02"
"73146","2022","COM","2020","790","17","807","2023-01-02"
"73147","2022","COM","2020","200","0","200","2023-01-02"
"73149","2022","COM","2020","298","6","304","2023-01-02"
"73150","2022","COM","2020","3828","131","3959","2023-01-02"
"73151","2022","COM","2020","3830","73","3903","2023-01-02"
"73152","2022","COM","2020","225","5","230","2023-01-02"
"73153","2022","COM","2020","1345","31","1376","2023-01-02"
"73154","2022","COM","2020","3351","83","3434","2023-01-02"
"73155","2022","COM","2020","2106","42","2148","2023-01-02"
"73156","2022","COM","2020","314","6","320","2023-01-02"
"73157","2022","COM","2020","3010","144","3154","2023-01-02"
"73159","2022","COM","2020","859","9","868","2023-01-02"
"73160","2022","COM","2020","976","26","1002","2023-01-02"
"73161","2022","COM","2020","651","14","665","2023-01-02"
"73162","2022","COM","2020","671","24","695","2023-01-02"
"73164","2022","COM","2020","1037","55","1092","2023-01-02"
"73166","2022","COM","2020","53","2","55","2023-01-02"
"73168","2022","COM","2020","117","2","119","2023-01-02"
"73170","2022","COM","2020","526","10","536","2023-01-02"
"73171","2022","COM","2020","4064","73","4137","2023-01-02"
"73173","2022","COM","2020","477","10","487","2023-01-02"
"73175","2022","COM","2020","78","3","81","2023-01-02"
"73176","2022","COM","2020","718","10","728","2023-01-02"
"73177","2022","COM","2020","236","7","243","2023-01-02"
"73178","2022","COM","2020","509","12","521","2023-01-02"
"73179","2022","COM","2020","12377","658","13035","2023-01-02"
"73180","2022","COM","2020","436","7","443","2023-01-02"
"73181","2022","COM","2020","3467","465","3932","2023-01-02"
"73182","2022","COM","2020","2248","51","2299","2023-01-02"
"73183","2022","COM","2020","1296","34","1330","2023-01-02"
"73184","2022","COM","2020","518","11","529","2023-01-02"
"73186","2022","COM","2020","474","12","486","2023-01-02"
"73187","2022","COM","2020","2601","50","2651","2023-01-02"
"73188","2022","COM","2020","1024","24","1048","2023-01-02"
"73189","2022","COM","2020","223","2","225","2023-01-02"
"73190","2022","COM","2020","250","6","256","2023-01-02"
"73191","2022","COM","2020","2185","66","2251","2023-01-02"
"73192","2022","COM","2020","211","5","216","2023-01-02"
"73193","2022","COM","2020","107","3","110","2023-01-02"
"73194","2022","COM","2020","317","9","326","2023-01-02"
"73196","2022","COM","2020","794","18","812","2023-01-02"
"73197","2022","COM","2020","636","24","660","2023-01-02"
"73200","2022","COM","2020","555","7","562","2023-01-02"
"73201","2022","COM","2020","441","11","452","2023-01-02"
"73202","2022","COM","2020","463","11","474","2023-01-02"
"73204","2022","COM","2020","2069","30","2099","2023-01-02"
"73205","2022","COM","2020","122","1","123","2023-01-02"
"73206","2022","COM","2020","712","22","734","2023-01-02"
"73207","2022","COM","2020","433","12","445","2023-01-02"
"73208","2022","COM","2020","987","25","1012","2023-01-02"
"73210","2022","COM","2020","377","6","383","2023-01-02"
"73211","2022","COM","2020","821","23","844","2023-01-02"
"73212","2022","COM","2020","2015","23","2038","2023-01-02"
"73213","2022","COM","2020","8939","548","9487","2023-01-02"
"73214","2022","COM","2020","243","10","253","2023-01-02"
"73215","2022","COM","2020","4175","69","4244","2023-01-02"
"73216","2022","COM","2020","492","6","498","2023-01-02"
"73217","2022","COM","2020","368","12","380","2023-01-02"
"73218","2022","COM","2020","808","17","825","2023-01-02"
"73219","2022","COM","2020","666","15","681","2023-01-02"
"73220","2022","COM","2020","369","10","379","2023-01-02"
"73221","2022","COM","2020","87","3","90","2023-01-02"
"73222","2022","COM","2020","6286","213","6499","2023-01-02"
"73223","2022","COM","2020","446","7","453","2023-01-02"
"73224","2022","COM","2020","899","21","920","2023-01-02"
"73225","2022","COM","2020","2730","89","2819","2023-01-02"
"73226","2022","COM","2020","1710","21","1731","2023-01-02"
"73227","2022","COM","2020","2358","77","2435","2023-01-02"
"73228","2022","COM","2020","936","23","959","2023-01-02"
"73229","2022","COM","2020","529","13","542","2023-01-02"
"73230","2022","COM","2020","130","1","131","2023-01-02"
"73231","2022","COM","2020","1208","24","1232","2023-01-02"
"73232","2022","COM","2020","707","22","729","2023-01-02"
"73233","2022","COM","2020","158","4","162","2023-01-02"
"73234","2022","COM","2020","148","3","151","2023-01-02"
"73235","2022","COM","2020","545","6","551","2023-01-02"
"73236","2022","COM","2020","2895","67","2962","2023-01-02"
"73237","2022","COM","2020","369","4","373","2023-01-02"
"73240","2022","COM","2020","803","21","824","2023-01-02"
"73241","2022","COM","2020","1201","20","1221","2023-01-02"
"73242","2022","COM","2020","272","10","282","2023-01-02"
"73243","2022","COM","2020","1724","59","1783","2023-01-02"
"73245","2022","COM","2020","834","15","849","2023-01-02"
"73246","2022","COM","2020","303","5","308","2023-01-02"
"73247","2022","COM","2020","963","73","1036","2023-01-02"
"73248","2022","COM","2020","7560","334","7894","2023-01-02"
"73249","2022","COM","2020","1898","50","1948","2023-01-02"
"73250","2022","COM","2020","1588","37","1625","2023-01-02"
"73252","2022","COM","2020","247","3","250","2023-01-02"
"73253","2022","COM","2020","606","5","611","2023-01-02"
"73254","2022","COM","2020","123","2","125","2023-01-02"
"73255","2022","COM","2020","826","21","847","2023-01-02"
"73256","2022","COM","2020","310","8","318","2023-01-02"
"73257","2022","COM","2020","3476","116","3592","2023-01-02"
"73258","2022","COM","2020","679","20","699","2023-01-02"
"73259","2022","COM","2020","541","15","556","2023-01-02"
"73261","2022","COM","2020","2474","280","2754","2023-01-02"
"73262","2022","COM","2020","476","35","511","2023-01-02"
"73263","2022","COM","2020","1151","31","1182","2023-01-02"
"73265","2022","COM","2020","732","20","752","2023-01-02"
"73267","2022","COM","2020","301","10","311","2023-01-02"
"73268","2022","COM","2020","526","61","587","2023-01-02"
"73269","2022","COM","2020","730","14","744","2023-01-02"
"73270","2022","COM","2020","4168","104","4272","2023-01-02"
"73271","2022","COM","2020","310","10","320","2023-01-02"
"73272","2022","COM","2020","177","4","181","2023-01-02"
"73273","2022","COM","2020","488","6","494","2023-01-02"
"73274","2022","COM","2020","447","15","462","2023-01-02"
"73275","2022","COM","2020","319","9","328","2023-01-02"
"73276","2022","COM","2020","418","19","437","2023-01-02"
"73277","2022","COM","2020","172","7","179","2023-01-02"
"73278","2022","COM","2020","1238","21","1259","2023-01-02"
"73280","2022","COM","2020","349","8","357","2023-01-02"
"73281","2022","COM","2020","771","20","791","2023-01-02"
"73282","2022","COM","2020","1074","18","1092","2023-01-02"
"73283","2022","COM","2020","726","18","744","2023-01-02"
"73284","2022","COM","2020","994","20","1014","2023-01-02"
"73285","2022","COM","2020","2367","49","2416","2023-01-02"
"73286","2022","COM","2020","1166","18","1184","2023-01-02"
"73288","2022","COM","2020","2072","47","2119","2023-01-02"
"73289","2022","COM","2020","421","10","431","2023-01-02"
"73290","2022","COM","2020","2068","38","2106","2023-01-02"
"73292","2022","COM","2020","317","8","325","2023-01-02"
"73293","2022","COM","2020","454","7","461","2023-01-02"
"73294","2022","COM","2020","341","6","347","2023-01-02"
"73296","2022","COM","2020","2016","42","2058","2023-01-02"
"73297","2022","COM","2020","583","23","606","2023-01-02"
"73298","2022","COM","2020","908","11","919","2023-01-02"
"73299","2022","COM","2020","326","6","332","2023-01-02"
"73300","2022","COM","2020","2981","107","3088","2023-01-02"
"73301","2022","COM","2020","833","16","849","2023-01-02"
"73302","2022","COM","2020","352","6","358","2023-01-02"
"73303","2022","COM","2020","7135","231","7366","2023-01-02"
"73304","2022","COM","2020","1589","47","1636","2023-01-02"
"73306","2022","COM","2020","1071","25","1096","2023-01-02"
"73307","2022","COM","2020","569","3","572","2023-01-02"
"73308","2022","COM","2020","584","18","602","2023-01-02"
"73309","2022","COM","2020","313","6","319","2023-01-02"
"73310","2022","COM","2020","480","12","492","2023-01-02"
"73311","2022","COM","2020","100","5","105","2023-01-02"
"73312","2022","COM","2020","932","35","967","2023-01-02"
"73313","2022","COM","2020","231","2","233","2023-01-02"
"73314","2022","COM","2020","257","5","262","2023-01-02"
"73315","2022","COM","2020","450","13","463","2023-01-02"
"73316","2022","COM","2020","288","4","292","2023-01-02"
"73317","2022","COM","2020","692","26","718","2023-01-02"
"73318","2022","COM","2020","250","9","259","2023-01-02"
"73320","2022","COM","2020","834","26","860","2023-01-02"
"73322","2022","COM","2020","538","14","552","2023-01-02"
"73323","2022","COM","2020","362","15","377","2023-01-02"
"73324","2022","COM","2020","189","7","196","2023-01-02"
"73326","2022","COM","2020","2172","40","2212","2023-01-02"
"73327","2022","COM","2020","405","3","408","2023-01-02"
"73328","2022","COM","2020","2286","56","2342","2023-01-02"
"73329","2022","COM","2020","1941","30","1971","2023-01-02"
"73330","2022","COM","2020","3083","31","3114","2023-01-02"
"74001","2022","COM","2020","1450","118","1568","2023-01-02"
"74002","2022","COM","2020","2665","58","2723","2023-01-02"
"74003","2022","COM","2020","1106","34","1140","2023-01-02"
"74004","2022","COM","2020","411","8","419","2023-01-02"
"74005","2022","COM","2020","4767","118","4885","2023-01-02"
"74006","2022","COM","2020","2182","37","2219","2023-01-02"
"74007","2022","COM","2020","2767","56","2823","2023-01-02"
"74008","2022","COM","2020","6014","66","6080","2023-01-02"
"74009","2022","COM","2020","980","19","999","2023-01-02"
"74010","2022","COM","2020","131766","3176","134942","2023-01-02"
"74012","2022","COM","2020","37485","374","37859","2023-01-02"
"74013","2022","COM","2020","2253","92","2345","2023-01-02"
"74014","2022","COM","2020","1814","51","1865","2023-01-02"
"74015","2022","COM","2020","1135","24","1159","2023-01-02"
"74016","2022","COM","2020","2621","36","2657","2023-01-02"
"74018","2022","COM","2020","1888","50","1938","2023-01-02"
"74019","2022","COM","2020","3508","273","3781","2023-01-02"
"74020","2022","COM","2020","1398","58","1456","2023-01-02"
"74021","2022","COM","2020","1646","31","1677","2023-01-02"
"74024","2022","COM","2020","2225","60","2285","2023-01-02"
"74025","2022","COM","2020","1495","21","1516","2023-01-02"
"74026","2022","COM","2020","5119","140","5259","2023-01-02"
"74027","2022","COM","2020","451","9","460","2023-01-02"
"74029","2022","COM","2020","414","14","428","2023-01-02"
"74030","2022","COM","2020","322","6","328","2023-01-02"
"74031","2022","COM","2020","3045","57","3102","2023-01-02"
"74032","2022","COM","2020","1275","39","1314","2023-01-02"
"74033","2022","COM","2020","1407","28","1435","2023-01-02"
"74034","2022","COM","2020","636","7","643","2023-01-02"
"74035","2022","COM","2020","587","23","610","2023-01-02"
"74036","2022","COM","2020","382","12","394","2023-01-02"
"74037","2022","COM","2020","1870","62","1932","2023-01-02"
"74038","2022","COM","2020","1128","29","1157","2023-01-02"
"74040","2022","COM","2020","3246","146","3392","2023-01-02"
"74041","2022","COM","2020","283","5","288","2023-01-02"
"74042","2022","COM","2020","12511","391","12902","2023-01-02"
"74043","2022","COM","2020","5806","109","5915","2023-01-02"
"74044","2022","COM","2020","1010","10","1020","2023-01-02"
"74045","2022","COM","2020","253","6","259","2023-01-02"
"74046","2022","COM","2020","512","12","524","2023-01-02"
"74048","2022","COM","2020","1103","20","1123","2023-01-02"
"74049","2022","COM","2020","481","1","482","2023-01-02"
"74050","2022","COM","2020","680","16","696","2023-01-02"
"74051","2022","COM","2020","712","11","723","2023-01-02"
"74052","2022","COM","2020","1109","19","1128","2023-01-02"
"74053","2022","COM","2020","1237","29","1266","2023-01-02"
"74054","2022","COM","2020","763","29","792","2023-01-02"
"74055","2022","COM","2020","546","13","559","2023-01-02"
"74056","2022","COM","2020","8644","375","9019","2023-01-02"
"74057","2022","COM","2020","1128","32","1160","2023-01-02"
"74058","2022","COM","2020","909","16","925","2023-01-02"
"74059","2022","COM","2020","258","9","267","2023-01-02"
"74060","2022","COM","2020","113","0","113","2023-01-02"
"74061","2022","COM","2020","948","16","964","2023-01-02"
"74062","2022","COM","2020","1454","28","1482","2023-01-02"
"74063","2022","COM","2020","1219","29","1248","2023-01-02"
"74064","2022","COM","2020","1190","42","1232","2023-01-02"
"74065","2022","COM","2020","513","11","524","2023-01-02"
"74066","2022","COM","2020","249","1","250","2023-01-02"
"74067","2022","COM","2020","2803","171","2974","2023-01-02"
"74068","2022","COM","2020","515","9","524","2023-01-02"
"74069","2022","COM","2020","807","14","821","2023-01-02"
"74070","2022","COM","2020","2877","35","2912","2023-01-02"
"74071","2022","COM","2020","224","7","231","2023-01-02"
"74072","2022","COM","2020","195","4","199","2023-01-02"
"74073","2022","COM","2020","674","11","685","2023-01-02"
"74074","2022","COM","2020","638","7","645","2023-01-02"
"74075","2022","COM","2020","1507","24","1531","2023-01-02"
"74076","2022","COM","2020","1688","44","1732","2023-01-02"
"74077","2022","COM","2020","1040","23","1063","2023-01-02"
"74078","2022","COM","2020","400","5","405","2023-01-02"
"74079","2022","COM","2020","684","6","690","2023-01-02"
"74080","2022","COM","2020","1706","52","1758","2023-01-02"
"74081","2022","COM","2020","16976","396","17372","2023-01-02"
"74082","2022","COM","2020","3973","116","4089","2023-01-02"
"74083","2022","COM","2020","2109","114","2223","2023-01-02"
"74085","2022","COM","2020","1107","46","1153","2023-01-02"
"74086","2022","COM","2020","743","13","756","2023-01-02"
"74087","2022","COM","2020","2256","150","2406","2023-01-02"
"74088","2022","COM","2020","1243","23","1266","2023-01-02"
"74089","2022","COM","2020","984","26","1010","2023-01-02"
"74090","2022","COM","2020","1385","20","1405","2023-01-02"
"74091","2022","COM","2020","359","2","361","2023-01-02"
"74094","2022","COM","2020","7069","170","7239","2023-01-02"
"74095","2022","COM","2020","321","11","332","2023-01-02"
"74096","2022","COM","2020","4665","316","4981","2023-01-02"
"74097","2022","COM","2020","1843","50","1893","2023-01-02"
"74098","2022","COM","2020","1584","57","1641","2023-01-02"
"74099","2022","COM","2020","814","36","850","2023-01-02"
"74100","2022","COM","2020","775","26","801","2023-01-02"
"74101","2022","COM","2020","737","18","755","2023-01-02"
"74102","2022","COM","2020","1445","47","1492","2023-01-02"
"74103","2022","COM","2020","2236","76","2312","2023-01-02"
"74104","2022","COM","2020","3626","87","3713","2023-01-02"
"74105","2022","COM","2020","6688","84","6772","2023-01-02"
"74106","2022","COM","2020","895","23","918","2023-01-02"
"74107","2022","COM","2020","153","5","158","2023-01-02"
"74108","2022","COM","2020","1020","26","1046","2023-01-02"
"74109","2022","COM","2020","931","20","951","2023-01-02"
"74111","2022","COM","2020","210","3","213","2023-01-02"
"74112","2022","COM","2020","8271","202","8473","2023-01-02"
"74114","2022","COM","2020","516","6","522","2023-01-02"
"74116","2022","COM","2020","2032","73","2105","2023-01-02"
"74117","2022","COM","2020","884","18","902","2023-01-02"
"74118","2022","COM","2020","2612","29","2641","2023-01-02"
"74119","2022","COM","2020","9117","252","9369","2023-01-02"
"74121","2022","COM","2020","1231","17","1248","2023-01-02"
"74122","2022","COM","2020","646","21","667","2023-01-02"
"74123","2022","COM","2020","7591","223","7814","2023-01-02"
"74124","2022","COM","2020","1791","42","1833","2023-01-02"
"74126","2022","COM","2020","1026","32","1058","2023-01-02"
"74127","2022","COM","2020","1461","45","1506","2023-01-02"
"74128","2022","COM","2020","3525","71","3596","2023-01-02"
"74129","2022","COM","2020","226","3","229","2023-01-02"
"74130","2022","COM","2020","540","31","571","2023-01-02"
"74131","2022","COM","2020","2047","39","2086","2023-01-02"
"74133","2022","COM","2020","10350","118","10468","2023-01-02"
"74134","2022","COM","2020","1224","26","1250","2023-01-02"
"74135","2022","COM","2020","540","12","552","2023-01-02"
"74136","2022","COM","2020","2082","53","2135","2023-01-02"
"74137","2022","COM","2020","3936","156","4092","2023-01-02"
"74138","2022","COM","2020","1508","63","1571","2023-01-02"
"74139","2022","COM","2020","1049","31","1080","2023-01-02"
"74140","2022","COM","2020","1476","25","1501","2023-01-02"
"74141","2022","COM","2020","1045","27","1072","2023-01-02"
"74142","2022","COM","2020","979","32","1011","2023-01-02"
"74143","2022","COM","2020","3177","74","3251","2023-01-02"
"74144","2022","COM","2020","833","20","853","2023-01-02"
"74145","2022","COM","2020","629","12","641","2023-01-02"
"74146","2022","COM","2020","1584","48","1632","2023-01-02"
"74147","2022","COM","2020","1018","29","1047","2023-01-02"
"74148","2022","COM","2020","270","7","277","2023-01-02"
"74150","2022","COM","2020","1647","30","1677","2023-01-02"
"74151","2022","COM","2020","578","9","587","2023-01-02"
"74152","2022","COM","2020","1271","42","1313","2023-01-02"
"74153","2022","COM","2020","1594","65","1659","2023-01-02"
"74154","2022","COM","2020","2511","52","2563","2023-01-02"
"74155","2022","COM","2020","804","27","831","2023-01-02"
"74156","2022","COM","2020","700","14","714","2023-01-02"
"74157","2022","COM","2020","1745","63","1808","2023-01-02"
"74158","2022","COM","2020","1104","17","1121","2023-01-02"
"74159","2022","COM","2020","3266","64","3330","2023-01-02"
"74160","2022","COM","2020","999","27","1026","2023-01-02"
"74161","2022","COM","2020","1977","58","2035","2023-01-02"
"74162","2022","COM","2020","1067","19","1086","2023-01-02"
"74163","2022","COM","2020","2235","80","2315","2023-01-02"
"74164","2022","COM","2020","6333","180","6513","2023-01-02"
"74165","2022","COM","2020","696","15","711","2023-01-02"
"74166","2022","COM","2020","1885","53","1938","2023-01-02"
"74167","2022","COM","2020","1387","24","1411","2023-01-02"
"74168","2022","COM","2020","1053","14","1067","2023-01-02"
"74169","2022","COM","2020","5735","102","5837","2023-01-02"
"74170","2022","COM","2020","869","21","890","2023-01-02"
"74171","2022","COM","2020","1540","33","1573","2023-01-02"
"74172","2022","COM","2020","1451","34","1485","2023-01-02"
"74173","2022","COM","2020","2999","124","3123","2023-01-02"
"74174","2022","COM","2020","590","25","615","2023-01-02"
"74175","2022","COM","2020","313","6","319","2023-01-02"
"74176","2022","COM","2020","1884","70","1954","2023-01-02"
"74177","2022","COM","2020","1097","20","1117","2023-01-02"
"74178","2022","COM","2020","733","14","747","2023-01-02"
"74179","2022","COM","2020","794","26","820","2023-01-02"
"74180","2022","COM","2020","2164","50","2214","2023-01-02"
"74183","2022","COM","2020","2461","66","2527","2023-01-02"
"74184","2022","COM","2020","1043","12","1055","2023-01-02"
"74185","2022","COM","2020","2332","46","2378","2023-01-02"
"74186","2022","COM","2020","772","23","795","2023-01-02"
"74188","2022","COM","2020","944","24","968","2023-01-02"
"74189","2022","COM","2020","1666","49","1715","2023-01-02"
"74190","2022","COM","2020","671","13","684","2023-01-02"
"74191","2022","COM","2020","2690","74","2764","2023-01-02"
"74192","2022","COM","2020","970","36","1006","2023-01-02"
"74193","2022","COM","2020","1059","23","1082","2023-01-02"
"74194","2022","COM","2020","892","24","916","2023-01-02"
"74195","2022","COM","2020","416","8","424","2023-01-02"
"74196","2022","COM","2020","473","15","488","2023-01-02"
"74197","2022","COM","2020","1629","34","1663","2023-01-02"
"74198","2022","COM","2020","1003","23","1026","2023-01-02"
"74199","2022","COM","2020","398","11","409","2023-01-02"
"74200","2022","COM","2020","3181","97","3278","2023-01-02"
"74201","2022","COM","2020","2271","24","2295","2023-01-02"
"74202","2022","COM","2020","724","10","734","2023-01-02"
"74203","2022","COM","2020","50","2","52","2023-01-02"
"74205","2022","COM","2020","1280","29","1309","2023-01-02"
"74206","2022","COM","2020","1053","19","1072","2023-01-02"
"74208","2022","COM","2020","11350","440","11790","2023-01-02"
"74209","2022","COM","2020","1371","40","1411","2023-01-02"
"74210","2022","COM","2020","1875","39","1914","2023-01-02"
"74211","2022","COM","2020","3145","91","3236","2023-01-02"
"74212","2022","COM","2020","1828","31","1859","2023-01-02"
"74213","2022","COM","2020","8522","364","8886","2023-01-02"
"74215","2022","COM","2020","1245","34","1279","2023-01-02"
"74216","2022","COM","2020","1053","17","1070","2023-01-02"
"74218","2022","COM","2020","7499","187","7686","2023-01-02"
"74219","2022","COM","2020","1254","51","1305","2023-01-02"
"74220","2022","COM","2020","8150","199","8349","2023-01-02"
"74221","2022","COM","2020","539","23","562","2023-01-02"
"74222","2022","COM","2020","502","9","511","2023-01-02"
"74223","2022","COM","2020","477","8","485","2023-01-02"
"74224","2022","COM","2020","11155","382","11537","2023-01-02"
"74225","2022","COM","2020","15944","418","16362","2023-01-02"
"74226","2022","COM","2020","592","12","604","2023-01-02"
"74228","2022","COM","2020","358","12","370","2023-01-02"
"74229","2022","COM","2020","3682","73","3755","2023-01-02"
"74231","2022","COM","2020","620","14","634","2023-01-02"
"74232","2022","COM","2020","491","21","512","2023-01-02"
"74233","2022","COM","2020","2425","45","2470","2023-01-02"
"74234","2022","COM","2020","897","23","920","2023-01-02"
"74235","2022","COM","2020","617","12","629","2023-01-02"
"74236","2022","COM","2020","5606","124","5730","2023-01-02"
"74237","2022","COM","2020","890","4","894","2023-01-02"
"74238","2022","COM","2020","1580","26","1606","2023-01-02"
"74239","2022","COM","2020","1465","37","1502","2023-01-02"
"74240","2022","COM","2020","1057","22","1079","2023-01-02"
"74241","2022","COM","2020","3426","101","3527","2023-01-02"
"74242","2022","COM","2020","6151","207","6358","2023-01-02"
"74243","2022","COM","2020","15739","229","15968","2023-01-02"
"74244","2022","COM","2020","840","34","874","2023-01-02"
"74249","2022","COM","2020","2522","61","2583","2023-01-02"
"74250","2022","COM","2020","7333","131","7464","2023-01-02"
"74252","2022","COM","2020","608","20","628","2023-01-02"
"74253","2022","COM","2020","1017","38","1055","2023-01-02"
"74254","2022","COM","2020","603","16","619","2023-01-02"
"74255","2022","COM","2020","2152","52","2204","2023-01-02"
"74256","2022","COM","2020","16986","464","17450","2023-01-02"
"74257","2022","COM","2020","792","19","811","2023-01-02"
"74258","2022","COM","2020","2380","58","2438","2023-01-02"
"74259","2022","COM","2020","446","8","454","2023-01-02"
"74260","2022","COM","2020","985","21","1006","2023-01-02"
"74261","2022","COM","2020","491","8","499","2023-01-02"
"74262","2022","COM","2020","1159","21","1180","2023-01-02"
"74263","2022","COM","2020","6375","141","6516","2023-01-02"
"74264","2022","COM","2020","9057","138","9195","2023-01-02"
"74265","2022","COM","2020","702","72","774","2023-01-02"
"74266","2022","COM","2020","1068","35","1103","2023-01-02"
"74267","2022","COM","2020","4151","185","4336","2023-01-02"
"74269","2022","COM","2020","2353","73","2426","2023-01-02"
"74271","2022","COM","2020","529","13","542","2023-01-02"
"74272","2022","COM","2020","5480","139","5619","2023-01-02"
"74273","2022","COM","2020","752","17","769","2023-01-02"
"74275","2022","COM","2020","1924","66","1990","2023-01-02"
"74276","2022","COM","2020","3429","93","3522","2023-01-02"
"74278","2022","COM","2020","6419","148","6567","2023-01-02"
"74279","2022","COM","2020","825","24","849","2023-01-02"
"74280","2022","COM","2020","6599","277","6876","2023-01-02"
"74281","2022","COM","2020","36626","1106","37732","2023-01-02"
"74282","2022","COM","2020","9534","247","9781","2023-01-02"
"74283","2022","COM","2020","1143","19","1162","2023-01-02"
"74284","2022","COM","2020","1313","25","1338","2023-01-02"
"74285","2022","COM","2020","421","9","430","2023-01-02"
"74286","2022","COM","2020","860","17","877","2023-01-02"
"74287","2022","COM","2020","916","20","936","2023-01-02"
"74288","2022","COM","2020","4907","61","4968","2023-01-02"
"74289","2022","COM","2020","2633","61","2694","2023-01-02"
"74290","2022","COM","2020","407","12","419","2023-01-02"
"74291","2022","COM","2020","340","5","345","2023-01-02"
"74292","2022","COM","2020","1044","31","1075","2023-01-02"
"74293","2022","COM","2020","3967","45","4012","2023-01-02"
"74294","2022","COM","2020","766","25","791","2023-01-02"
"74295","2022","COM","2020","323","8","331","2023-01-02"
"74296","2022","COM","2020","933","17","950","2023-01-02"
"74297","2022","COM","2020","643","27","670","2023-01-02"
"74298","2022","COM","2020","9360","271","9631","2023-01-02"
"74299","2022","COM","2020","2286","83","2369","2023-01-02"
"74301","2022","COM","2020","941","21","962","2023-01-02"
"74302","2022","COM","2020","1089","21","1110","2023-01-02"
"74303","2022","COM","2020","3348","129","3477","2023-01-02"
"74304","2022","COM","2020","935","10","945","2023-01-02"
"74305","2022","COM","2020","9031","118","9149","2023-01-02"
"74306","2022","COM","2020","608","17","625","2023-01-02"
"74307","2022","COM","2020","995","16","1011","2023-01-02"
"74308","2022","COM","2020","858","22","880","2023-01-02"
"74309","2022","COM","2020","5590","84","5674","2023-01-02"
"74310","2022","COM","2020","1299","33","1332","2023-01-02"
"74311","2022","COM","2020","4532","104","4636","2023-01-02"
"74312","2022","COM","2020","1584","27","1611","2023-01-02"
"74313","2022","COM","2020","554","8","562","2023-01-02"
"74314","2022","COM","2020","1645","54","1699","2023-01-02"
"74315","2022","COM","2020","1084","22","1106","2023-01-02"
"75056","2022","COM","2020","2145906","16692","2162598","2023-01-02"
"75101","2022","ARM","2020","16030","119","16149","2023-01-02"
"75102","2022","ARM","2020","21130","147","21277","2023-01-02"
"75103","2022","ARM","2020","33402","249","33651","2023-01-02"
"75104","2022","ARM","2020","29064","262","29326","2023-01-02"
"75105","2022","ARM","2020","57380","670","58050","2023-01-02"
"75106","2022","ARM","2020","39625","827","40452","2023-01-02"
"75107","2022","ARM","2020","48520","780","49300","2023-01-02"
"75108","2022","ARM","2020","35631","587","36218","2023-01-02"
"75109","2022","ARM","2020","60168","616","60784","2023-01-02"
"75110","2022","ARM","2020","83459","414","83873","2023-01-02"
"75111","2022","ARM","2020","144292","832","145124","2023-01-02"
"75112","2022","ARM","2020","140311","964","141275","2023-01-02"
"75113","2022","ARM","2020","177833","1180","179013","2023-01-02"
"75114","2022","ARM","2020","133967","959","134926","2023-01-02"
"75115","2022","ARM","2020","229472","1714","231186","2023-01-02"
"75116","2022","ARM","2020","162820","2298","165118","2023-01-02"
"75117","2022","ARM","2020","166336","1429","167765","2023-01-02"
"75118","2022","ARM","2020","191135","776","191911","2023-01-02"
"75119","2022","ARM","2020","183211","945","184156","2023-01-02"
"75120","2022","ARM","2020","192120","924","193044","2023-01-02"
"76001","2022","COM","2020","1155","19","1174","2023-01-02"
"76002","2022","COM","2020","618","9","627","2023-01-02"
"76004","2022","COM","2020","473","14","487","2023-01-02"
"76005","2022","COM","2020","3299","30","3329","2023-01-02"
"76006","2022","COM","2020","179","4","183","2023-01-02"
"76007","2022","COM","2020","689","10","699","2023-01-02"
"76008","2022","COM","2020","630","11","641","2023-01-02"
"76009","2022","COM","2020","349","4","353","2023-01-02"
"76010","2022","COM","2020","371","6","377","2023-01-02"
"76011","2022","COM","2020","151","4","155","2023-01-02"
"76012","2022","COM","2020","186","3","189","2023-01-02"
"76013","2022","COM","2020","1084","31","1115","2023-01-02"
"76014","2022","COM","2020","1400","15","1415","2023-01-02"
"76015","2022","COM","2020","514","9","523","2023-01-02"
"76016","2022","COM","2020","125","2","127","2023-01-02"
"76017","2022","COM","2020","662","6","668","2023-01-02"
"76018","2022","COM","2020","1484","32","1516","2023-01-02"
"76019","2022","COM","2020","425","10","435","2023-01-02"
"76020","2022","COM","2020","1176","23","1199","2023-01-02"
"76021","2022","COM","2020","461","3","464","2023-01-02"
"76022","2022","COM","2020","334","13","347","2023-01-02"
"76023","2022","COM","2020","300","5","305","2023-01-02"
"76024","2022","COM","2020","156","4","160","2023-01-02"
"76025","2022","COM","2020","343","5","348","2023-01-02"
"76026","2022","COM","2020","2526","44","2570","2023-01-02"
"76028","2022","COM","2020","186","1","187","2023-01-02"
"76029","2022","COM","2020","200","3","203","2023-01-02"
"76030","2022","COM","2020","516","3","519","2023-01-02"
"76032","2022","COM","2020","138","2","140","2023-01-02"
"76033","2022","COM","2020","456","6","462","2023-01-02"
"76034","2022","COM","2020","2525","25","2550","2023-01-02"
"76035","2022","COM","2020","1963","51","2014","2023-01-02"
"76036","2022","COM","2020","692","19","711","2023-01-02"
"76038","2022","COM","2020","401","6","407","2023-01-02"
"76039","2022","COM","2020","1254","26","1280","2023-01-02"
"76040","2022","COM","2020","312","0","312","2023-01-02"
"76041","2022","COM","2020","1347","18","1365","2023-01-02"
"76042","2022","COM","2020","103","3","106","2023-01-02"
"76043","2022","COM","2020","1138","360","1498","2023-01-02"
"76045","2022","COM","2020","358","9","367","2023-01-02"
"76046","2022","COM","2020","690","12","702","2023-01-02"
"76047","2022","COM","2020","150","1","151","2023-01-02"
"76048","2022","COM","2020","291","6","297","2023-01-02"
"76049","2022","COM","2020","275","8","283","2023-01-02"
"76050","2022","COM","2020","1008","27","1035","2023-01-02"
"76051","2022","COM","2020","1904","37","1941","2023-01-02"
"76052","2022","COM","2020","223","1","224","2023-01-02"
"76053","2022","COM","2020","109","2","111","2023-01-02"
"76054","2022","COM","2020","522","4","526","2023-01-02"
"76055","2022","COM","2020","334","17","351","2023-01-02"
"76056","2022","COM","2020","622","10","632","2023-01-02"
"76057","2022","COM","2020","12239","239","12478","2023-01-02"
"76058","2022","COM","2020","216","5","221","2023-01-02"
"76059","2022","COM","2020","419","11","430","2023-01-02"
"76060","2022","COM","2020","485","10","495","2023-01-02"
"76062","2022","COM","2020","264","3","267","2023-01-02"
"76063","2022","COM","2020","463","10","473","2023-01-02"
"76064","2022","COM","2020","498","13","511","2023-01-02"
"76065","2022","COM","2020","413","4","417","2023-01-02"
"76066","2022","COM","2020","152","4","156","2023-01-02"
"76067","2022","COM","2020","596","14","610","2023-01-02"
"76068","2022","COM","2020","643","17","660","2023-01-02"
"76069","2022","COM","2020","2242","53","2295","2023-01-02"
"76070","2022","COM","2020","596","11","607","2023-01-02"
"76071","2022","COM","2020","473","14","487","2023-01-02"
"76072","2022","COM","2020","742","11","753","2023-01-02"
"76074","2022","COM","2020","53","0","53","2023-01-02"
"76075","2022","COM","2020","450","3","453","2023-01-02"
"76076","2022","COM","2020","267","5","272","2023-01-02"
"76077","2022","COM","2020","170","5","175","2023-01-02"
"76079","2022","COM","2020","182","1","183","2023-01-02"
"76082","2022","COM","2020","634","6","640","2023-01-02"
"76083","2022","COM","2020","96","1","97","2023-01-02"
"76084","2022","COM","2020","119","2","121","2023-01-02"
"76085","2022","COM","2020","335","9","344","2023-01-02"
"76086","2022","COM","2020","216","2","218","2023-01-02"
"76087","2022","COM","2020","687","10","697","2023-01-02"
"76088","2022","COM","2020","544","11","555","2023-01-02"
"76090","2022","COM","2020","1253","16","1269","2023-01-02"
"76091","2022","COM","2020","231","7","238","2023-01-02"
"76092","2022","COM","2020","626","10","636","2023-01-02"
"76093","2022","COM","2020","360","13","373","2023-01-02"
"76094","2022","COM","2020","331","2","333","2023-01-02"
"76095","2022","COM","2020","8197","166","8363","2023-01-02"
"76096","2022","COM","2020","660","10","670","2023-01-02"
"76097","2022","COM","2020","105","0","105","2023-01-02"
"76099","2022","COM","2020","730","9","739","2023-01-02"
"76100","2022","COM","2020","1227","18","1245","2023-01-02"
"76101","2022","COM","2020","2882","30","2912","2023-01-02"
"76103","2022","COM","2020","6466","95","6561","2023-01-02"
"76104","2022","COM","2020","252","13","265","2023-01-02"
"76105","2022","COM","2020","657","7","664","2023-01-02"
"76106","2022","COM","2020","569","8","577","2023-01-02"
"76107","2022","COM","2020","297","4","301","2023-01-02"
"76108","2022","COM","2020","14378","375","14753","2023-01-02"
"76109","2022","COM","2020","173","4","177","2023-01-02"
"76110","2022","COM","2020","469","5","474","2023-01-02"
"76111","2022","COM","2020","610","10","620","2023-01-02"
"76112","2022","COM","2020","364","10","374","2023-01-02"
"76113","2022","COM","2020","409","7","416","2023-01-02"
"76114","2022","COM","2020","11551","133","11684","2023-01-02"
"76115","2022","COM","2020","579","3","582","2023-01-02"
"76116","2022","COM","2020","3990","46","4036","2023-01-02"
"76117","2022","COM","2020","644","20","664","2023-01-02"
"76118","2022","COM","2020","248","8","256","2023-01-02"
"76119","2022","COM","2020","201","2","203","2023-01-02"
"76120","2022","COM","2020","441","10","451","2023-01-02"
"76121","2022","COM","2020","366","3","369","2023-01-02"
"76122","2022","COM","2020","504","8","512","2023-01-02"
"76123","2022","COM","2020","1062","29","1091","2023-01-02"
"76124","2022","COM","2020","433","8","441","2023-01-02"
"76125","2022","COM","2020","1567","19","1586","2023-01-02"
"76126","2022","COM","2020","318","6","324","2023-01-02"
"76128","2022","COM","2020","580","15","595","2023-01-02"
"76129","2022","COM","2020","211","5","216","2023-01-02"
"76130","2022","COM","2020","281","4","285","2023-01-02"
"76131","2022","COM","2020","707","12","719","2023-01-02"
"76132","2022","COM","2020","468","2","470","2023-01-02"
"76133","2022","COM","2020","433","9","442","2023-01-02"
"76134","2022","COM","2020","293","4","297","2023-01-02"
"76135","2022","COM","2020","996","12","1008","2023-01-02"
"76136","2022","COM","2020","700","13","713","2023-01-02"
"76138","2022","COM","2020","330","8","338","2023-01-02"
"76139","2022","COM","2020","221","3","224","2023-01-02"
"76140","2022","COM","2020","195","2","197","2023-01-02"
"76141","2022","COM","2020","1367","13","1380","2023-01-02"
"76142","2022","COM","2020","447","125","572","2023-01-02"
"76143","2022","COM","2020","1366","23","1389","2023-01-02"
"76144","2022","COM","2020","157","2","159","2023-01-02"
"76146","2022","COM","2020","2820","113","2933","2023-01-02"
"76147","2022","COM","2020","898","22","920","2023-01-02"
"76148","2022","COM","2020","328","4","332","2023-01-02"
"76149","2022","COM","2020","285","5","290","2023-01-02"
"76151","2022","COM","2020","257","7","264","2023-01-02"
"76152","2022","COM","2020","749","4","753","2023-01-02"
"76153","2022","COM","2020","333","3","336","2023-01-02"
"76154","2022","COM","2020","465","7","472","2023-01-02"
"76155","2022","COM","2020","383","4","387","2023-01-02"
"76156","2022","COM","2020","344","9","353","2023-01-02"
"76157","2022","COM","2020","13807","350","14157","2023-01-02"
"76158","2022","COM","2020","319","1","320","2023-01-02"
"76159","2022","COM","2020","2997","46","3043","2023-01-02"
"76160","2022","COM","2020","424","9","433","2023-01-02"
"76161","2022","COM","2020","98","3","101","2023-01-02"
"76162","2022","COM","2020","275","5","280","2023-01-02"
"76163","2022","COM","2020","681","14","695","2023-01-02"
"76164","2022","COM","2020","4092","66","4158","2023-01-02"
"76165","2022","COM","2020","9996","65","10061","2023-01-02"
"76166","2022","COM","2020","481","4","485","2023-01-02"
"76167","2022","COM","2020","1599","28","1627","2023-01-02"
"76168","2022","COM","2020","65","1","66","2023-01-02"
"76169","2022","COM","2020","1287","115","1402","2023-01-02"
"76170","2022","COM","2020","112","1","113","2023-01-02"
"76171","2022","COM","2020","137","1","138","2023-01-02"
"76172","2022","COM","2020","159","3","162","2023-01-02"
"76173","2022","COM","2020","538","6","544","2023-01-02"
"76174","2022","COM","2020","409","5","414","2023-01-02"
"76175","2022","COM","2020","261","7","268","2023-01-02"
"76176","2022","COM","2020","348","7","355","2023-01-02"
"76177","2022","COM","2020","276","6","282","2023-01-02"
"76178","2022","COM","2020","4919","26","4945","2023-01-02"
"76179","2022","COM","2020","1376","17","1393","2023-01-02"
"76180","2022","COM","2020","190","8","198","2023-01-02"
"76181","2022","COM","2020","149","3","152","2023-01-02"
"76182","2022","COM","2020","254","2","256","2023-01-02"
"76183","2022","COM","2020","765","19","784","2023-01-02"
"76184","2022","COM","2020","110","3","113","2023-01-02"
"76185","2022","COM","2020","165","4","169","2023-01-02"
"76186","2022","COM","2020","497","3","500","2023-01-02"
"76187","2022","COM","2020","166","3","169","2023-01-02"
"76188","2022","COM","2020","474","4","478","2023-01-02"
"76189","2022","COM","2020","165","3","168","2023-01-02"
"76190","2022","COM","2020","209","3","212","2023-01-02"
"76192","2022","COM","2020","2617","52","2669","2023-01-02"
"76193","2022","COM","2020","336","5","341","2023-01-02"
"76194","2022","COM","2020","402","3","405","2023-01-02"
"76195","2022","COM","2020","183","4","187","2023-01-02"
"76196","2022","COM","2020","2563","82","2645","2023-01-02"
"76197","2022","COM","2020","218","2","220","2023-01-02"
"76198","2022","COM","2020","794","19","813","2023-01-02"
"76199","2022","COM","2020","711","10","721","2023-01-02"
"76200","2022","COM","2020","481","11","492","2023-01-02"
"76201","2022","COM","2020","527","4","531","2023-01-02"
"76202","2022","COM","2020","319","3","322","2023-01-02"
"76203","2022","COM","2020","733","7","740","2023-01-02"
"76204","2022","COM","2020","258","1","259","2023-01-02"
"76205","2022","COM","2020","248","2","250","2023-01-02"
"76206","2022","COM","2020","344","8","352","2023-01-02"
"76207","2022","COM","2020","196","6","202","2023-01-02"
"76208","2022","COM","2020","654","9","663","2023-01-02"
"76209","2022","COM","2020","444","8","452","2023-01-02"
"76210","2022","COM","2020","453","1","454","2023-01-02"
"76211","2022","COM","2020","232","2","234","2023-01-02"
"76212","2022","COM","2020","9780","84","9864","2023-01-02"
"76213","2022","COM","2020","399","9","408","2023-01-02"
"76214","2022","COM","2020","271","2","273","2023-01-02"
"76216","2022","COM","2020","10644","79","10723","2023-01-02"
"76217","2022","COM","2020","28091","444","28535","2023-01-02"
"76218","2022","COM","2020","104","2","106","2023-01-02"
"76219","2022","COM","2020","2472","44","2516","2023-01-02"
"76220","2022","COM","2020","522","12","534","2023-01-02"
"76221","2022","COM","2020","192","5","197","2023-01-02"
"76222","2022","COM","2020","4010","51","4061","2023-01-02"
"76223","2022","COM","2020","509","6","515","2023-01-02"
"76224","2022","COM","2020","972","19","991","2023-01-02"
"76225","2022","COM","2020","369","6","375","2023-01-02"
"76226","2022","COM","2020","162","2","164","2023-01-02"
"76227","2022","COM","2020","701","10","711","2023-01-02"
"76228","2022","COM","2020","397","7","404","2023-01-02"
"76229","2022","COM","2020","401","14","415","2023-01-02"
"76230","2022","COM","2020","475","6","481","2023-01-02"
"76231","2022","COM","2020","16087","138","16225","2023-01-02"
"76232","2022","COM","2020","639","8","647","2023-01-02"
"76233","2022","COM","2020","153","4","157","2023-01-02"
"76234","2022","COM","2020","753","12","765","2023-01-02"
"76235","2022","COM","2020","1993","133","2126","2023-01-02"
"76236","2022","COM","2020","351","1","352","2023-01-02"
"76237","2022","COM","2020","510","7","517","2023-01-02"
"76238","2022","COM","2020","2638","39","2677","2023-01-02"
"76239","2022","COM","2020","784","14","798","2023-01-02"
"76240","2022","COM","2020","1036","13","1049","2023-01-02"
"76241","2022","COM","2020","139","6","145","2023-01-02"
"76242","2022","COM","2020","204","4","208","2023-01-02"
"76243","2022","COM","2020","293","2","295","2023-01-02"
"76244","2022","COM","2020","385","6","391","2023-01-02"
"76245","2022","COM","2020","1638","16","1654","2023-01-02"
"76247","2022","COM","2020","496","4","500","2023-01-02"
"76249","2022","COM","2020","838","7","845","2023-01-02"
"76250","2022","COM","2020","1203","27","1230","2023-01-02"
"76251","2022","COM","2020","434","3","437","2023-01-02"
"76252","2022","COM","2020","1047","30","1077","2023-01-02"
"76253","2022","COM","2020","834","14","848","2023-01-02"
"76254","2022","COM","2020","1238","6","1244","2023-01-02"
"76255","2022","COM","2020","6653","200","6853","2023-01-02"
"76257","2022","COM","2020","183","2","185","2023-01-02"
"76258","2022","COM","2020","4205","112","4317","2023-01-02"
"76259","2022","COM","2020","18054","280","18334","2023-01-02"
"76260","2022","COM","2020","1669","18","1687","2023-01-02"
"76261","2022","COM","2020","450","11","461","2023-01-02"
"76262","2022","COM","2020","142","2","144","2023-01-02"
"76263","2022","COM","2020","1280","23","1303","2023-01-02"
"76264","2022","COM","2020","476","9","485","2023-01-02"
"76265","2022","COM","2020","162","4","166","2023-01-02"
"76266","2022","COM","2020","701","15","716","2023-01-02"
"76268","2022","COM","2020","182","5","187","2023-01-02"
"76269","2022","COM","2020","172","3","175","2023-01-02"
"76270","2022","COM","2020","2637","54","2691","2023-01-02"
"76271","2022","COM","2020","1817","18","1835","2023-01-02"
"76272","2022","COM","2020","893","10","903","2023-01-02"
"76273","2022","COM","2020","558","14","572","2023-01-02"
"76274","2022","COM","2020","27","0","27","2023-01-02"
"76275","2022","COM","2020","1664","26","1690","2023-01-02"
"76276","2022","COM","2020","3750","172","3922","2023-01-02"
"76278","2022","COM","2020","781","13","794","2023-01-02"
"76279","2022","COM","2020","359","10","369","2023-01-02"
"76280","2022","COM","2020","136","1","137","2023-01-02"
"76281","2022","COM","2020","2091","44","2135","2023-01-02"
"76282","2022","COM","2020","960","9","969","2023-01-02"
"76283","2022","COM","2020","237","5","242","2023-01-02"
"76284","2022","COM","2020","329","5","334","2023-01-02"
"76285","2022","COM","2020","567","8","575","2023-01-02"
"76286","2022","COM","2020","678","8","686","2023-01-02"
"76287","2022","COM","2020","1046","15","1061","2023-01-02"
"76288","2022","COM","2020","362","3","365","2023-01-02"
"76289","2022","COM","2020","1728","24","1752","2023-01-02"
"76290","2022","COM","2020","393","10","403","2023-01-02"
"76291","2022","COM","2020","1168","25","1193","2023-01-02"
"76292","2022","COM","2020","142","3","145","2023-01-02"
"76293","2022","COM","2020","240","0","240","2023-01-02"
"76294","2022","COM","2020","385","8","393","2023-01-02"
"76295","2022","COM","2020","1205","15","1220","2023-01-02"
"76296","2022","COM","2020","2495","30","2525","2023-01-02"
"76297","2022","COM","2020","226","6","232","2023-01-02"
"76298","2022","COM","2020","468","6","474","2023-01-02"
"76299","2022","COM","2020","388","4","392","2023-01-02"
"76300","2022","COM","2020","439","4","443","2023-01-02"
"76302","2022","COM","2020","2853","40","2893","2023-01-02"
"76303","2022","COM","2020","726","8","734","2023-01-02"
"76304","2022","COM","2020","385","1","386","2023-01-02"
"76305","2022","COM","2020","9042","59","9101","2023-01-02"
"76306","2022","COM","2020","176","2","178","2023-01-02"
"76307","2022","COM","2020","1376","19","1395","2023-01-02"
"76308","2022","COM","2020","522","8","530","2023-01-02"
"76309","2022","COM","2020","126","2","128","2023-01-02"
"76311","2022","COM","2020","417","5","422","2023-01-02"
"76312","2022","COM","2020","6027","93","6120","2023-01-02"
"76313","2022","COM","2020","898","14","912","2023-01-02"
"76314","2022","COM","2020","616","9","625","2023-01-02"
"76315","2022","COM","2020","1076","18","1094","2023-01-02"
"76316","2022","COM","2020","441","9","450","2023-01-02"
"76317","2022","COM","2020","430","12","442","2023-01-02"
"76318","2022","COM","2020","755","28","783","2023-01-02"
"76319","2022","COM","2020","9731","181","9912","2023-01-02"
"76320","2022","COM","2020","317","6","323","2023-01-02"
"76321","2022","COM","2020","1764","26","1790","2023-01-02"
"76322","2022","COM","2020","26034","235","26269","2023-01-02"
"76323","2022","COM","2020","155","4","159","2023-01-02"
"76324","2022","COM","2020","852","15","867","2023-01-02"
"76325","2022","COM","2020","450","5","455","2023-01-02"
"76327","2022","COM","2020","372","5","377","2023-01-02"
"76328","2022","COM","2020","376","5","381","2023-01-02"
"76329","2022","COM","2020","3123","39","3162","2023-01-02"
"76330","2022","COM","2020","686","20","706","2023-01-02"
"76331","2022","COM","2020","1006","5","1011","2023-01-02"
"76332","2022","COM","2020","437","7","444","2023-01-02"
"76333","2022","COM","2020","471","4","475","2023-01-02"
"76334","2022","COM","2020","527","17","544","2023-01-02"
"76335","2022","COM","2020","89","0","89","2023-01-02"
"76336","2022","COM","2020","372","5","377","2023-01-02"
"76338","2022","COM","2020","218","4","222","2023-01-02"
"76339","2022","COM","2020","261","4","265","2023-01-02"
"76340","2022","COM","2020","530","7","537","2023-01-02"
"76341","2022","COM","2020","8333","54","8387","2023-01-02"
"76342","2022","COM","2020","712","17","729","2023-01-02"
"76343","2022","COM","2020","187","4","191","2023-01-02"
"76344","2022","COM","2020","423","8","431","2023-01-02"
"76345","2022","COM","2020","281","2","283","2023-01-02"
"76346","2022","COM","2020","315","8","323","2023-01-02"
"76347","2022","COM","2020","351","6","357","2023-01-02"
"76348","2022","COM","2020","688","8","696","2023-01-02"
"76349","2022","COM","2020","1896","70","1966","2023-01-02"
"76350","2022","COM","2020","396","7","403","2023-01-02"
"76351","2022","COM","2020","165830","1828","167658","2023-01-02"
"76352","2022","COM","2020","368","3","371","2023-01-02"
"76353","2022","COM","2020","103","6","109","2023-01-02"
"76354","2022","COM","2020","1366","14","1380","2023-01-02"
"76355","2022","COM","2020","950","13","963","2023-01-02"
"76356","2022","COM","2020","115","2","117","2023-01-02"
"76357","2022","COM","2020","354","16","370","2023-01-02"
"76358","2022","COM","2020","250","1","251","2023-01-02"
"76359","2022","COM","2020","147","2","149","2023-01-02"
"76360","2022","COM","2020","640","9","649","2023-01-02"
"76361","2022","COM","2020","713","9","722","2023-01-02"
"76362","2022","COM","2020","293","7","300","2023-01-02"
"76363","2022","COM","2020","579","9","588","2023-01-02"
"76364","2022","COM","2020","268","5","273","2023-01-02"
"76365","2022","COM","2020","189","0","189","2023-01-02"
"76366","2022","COM","2020","4149","33","4182","2023-01-02"
"76367","2022","COM","2020","2918","48","2966","2023-01-02"
"76368","2022","COM","2020","335","6","341","2023-01-02"
"76369","2022","COM","2020","534","7","541","2023-01-02"
"76370","2022","COM","2020","429","3","432","2023-01-02"
"76371","2022","COM","2020","71","0","71","2023-01-02"
"76372","2022","COM","2020","411","3","414","2023-01-02"
"76373","2022","COM","2020","304","6","310","2023-01-02"
"76374","2022","COM","2020","1202","17","1219","2023-01-02"
"76375","2022","COM","2020","275","12","287","2023-01-02"
"76377","2022","COM","2020","3601","63","3664","2023-01-02"
"76378","2022","COM","2020","1693","34","1727","2023-01-02"
"76379","2022","COM","2020","195","2","197","2023-01-02"
"76380","2022","COM","2020","312","8","320","2023-01-02"
"76381","2022","COM","2020","129","1","130","2023-01-02"
"76382","2022","COM","2020","1156","19","1175","2023-01-02"
"76383","2022","COM","2020","95","1","96","2023-01-02"
"76384","2022","COM","2020","8761","143","8904","2023-01-02"
"76385","2022","COM","2020","1483","54","1537","2023-01-02"
"76386","2022","COM","2020","391","6","397","2023-01-02"
"76387","2022","COM","2020","388","7","395","2023-01-02"
"76388","2022","COM","2020","473","4","477","2023-01-02"
"76389","2022","COM","2020","188","7","195","2023-01-02"
"76390","2022","COM","2020","1095","21","1116","2023-01-02"
"76391","2022","COM","2020","2351","68","2419","2023-01-02"
"76392","2022","COM","2020","1253","20","1273","2023-01-02"
"76393","2022","COM","2020","48","0","48","2023-01-02"
"76394","2022","COM","2020","634","6","640","2023-01-02"
"76395","2022","COM","2020","543","9","552","2023-01-02"
"76396","2022","COM","2020","338","2","340","2023-01-02"
"76397","2022","COM","2020","964","16","980","2023-01-02"
"76398","2022","COM","2020","760","6","766","2023-01-02"
"76399","2022","COM","2020","191","3","194","2023-01-02"
"76400","2022","COM","2020","2164","37","2201","2023-01-02"
"76401","2022","COM","2020","2524","44","2568","2023-01-02"
"76402","2022","COM","2020","6160","47","6207","2023-01-02"
"76403","2022","COM","2020","205","3","208","2023-01-02"
"76404","2022","COM","2020","1265","23","1288","2023-01-02"
"76405","2022","COM","2020","224","1","225","2023-01-02"
"76406","2022","COM","2020","424","6","430","2023-01-02"
"76407","2022","COM","2020","307","8","315","2023-01-02"
"76408","2022","COM","2020","1051","13","1064","2023-01-02"
"76409","2022","COM","2020","909","13","922","2023-01-02"
"76410","2022","COM","2020","10845","126","10971","2023-01-02"
"76411","2022","COM","2020","233","1","234","2023-01-02"
"76412","2022","COM","2020","716","10","726","2023-01-02"
"76413","2022","COM","2020","419","6","425","2023-01-02"
"76414","2022","COM","2020","1605","50","1655","2023-01-02"
"76415","2022","COM","2020","327","5","332","2023-01-02"
"76416","2022","COM","2020","333","5","338","2023-01-02"
"76417","2022","COM","2020","407","10","417","2023-01-02"
"76418","2022","COM","2020","1017","17","1034","2023-01-02"
"76419","2022","COM","2020","159","6","165","2023-01-02"
"76420","2022","COM","2020","359","5","364","2023-01-02"
"76421","2022","COM","2020","921","14","935","2023-01-02"
"76422","2022","COM","2020","264","6","270","2023-01-02"
"76423","2022","COM","2020","168","2","170","2023-01-02"
"76424","2022","COM","2020","231","2","233","2023-01-02"
"76425","2022","COM","2020","296","5","301","2023-01-02"
"76426","2022","COM","2020","159","0","159","2023-01-02"
"76427","2022","COM","2020","928","249","1177","2023-01-02"
"76428","2022","COM","2020","17","3","20","2023-01-02"
"76429","2022","COM","2020","7925","348","8273","2023-01-02"
"76430","2022","COM","2020","118","3","121","2023-01-02"
"76431","2022","COM","2020","96","3","99","2023-01-02"
"76432","2022","COM","2020","244","4","248","2023-01-02"
"76433","2022","COM","2020","742","7","749","2023-01-02"
"76434","2022","COM","2020","1126","7","1133","2023-01-02"
"76435","2022","COM","2020","795","16","811","2023-01-02"
"76436","2022","COM","2020","617","4","621","2023-01-02"
"76437","2022","COM","2020","562","14","576","2023-01-02"
"76438","2022","COM","2020","237","5","242","2023-01-02"
"76439","2022","COM","2020","351","9","360","2023-01-02"
"76440","2022","COM","2020","207","4","211","2023-01-02"
"76441","2022","COM","2020","622","12","634","2023-01-02"
"76442","2022","COM","2020","578","13","591","2023-01-02"
"76443","2022","COM","2020","851","16","867","2023-01-02"
"76445","2022","COM","2020","606","7","613","2023-01-02"
"76446","2022","COM","2020","1288","18","1306","2023-01-02"
"76447","2022","COM","2020","15500","219","15719","2023-01-02"
"76448","2022","COM","2020","1397","36","1433","2023-01-02"
"76449","2022","COM","2020","497","6","503","2023-01-02"
"76450","2022","COM","2020","271","21","292","2023-01-02"
"76451","2022","COM","2020","19686","415","20101","2023-01-02"
"76452","2022","COM","2020","4593","49","4642","2023-01-02"
"76453","2022","COM","2020","1074","20","1094","2023-01-02"
"76454","2022","COM","2020","86","0","86","2023-01-02"
"76455","2022","COM","2020","302","5","307","2023-01-02"
"76456","2022","COM","2020","767","12","779","2023-01-02"
"76457","2022","COM","2020","922","15","937","2023-01-02"
"76458","2022","COM","2020","128","3","131","2023-01-02"
"76459","2022","COM","2020","348","5","353","2023-01-02"
"76460","2022","COM","2020","503","8","511","2023-01-02"
"76461","2022","COM","2020","403","5","408","2023-01-02"
"76462","2022","COM","2020","4646","209","4855","2023-01-02"
"76463","2022","COM","2020","664","21","685","2023-01-02"
"76464","2022","COM","2020","2378","38","2416","2023-01-02"
"76465","2022","COM","2020","559","9","568","2023-01-02"
"76467","2022","COM","2020","1329","19","1348","2023-01-02"
"76468","2022","COM","2020","1365","33","1398","2023-01-02"
"76469","2022","COM","2020","424","5","429","2023-01-02"
"76470","2022","COM","2020","658","25","683","2023-01-02"
"76471","2022","COM","2020","995","27","1022","2023-01-02"
"76472","2022","COM","2020","754","5","759","2023-01-02"
"76473","2022","COM","2020","808","11","819","2023-01-02"
"76474","2022","COM","2020","6966","87","7053","2023-01-02"
"76475","2022","COM","2020","6099","192","6291","2023-01-02"
"76476","2022","COM","2020","10264","189","10453","2023-01-02"
"76477","2022","COM","2020","449","7","456","2023-01-02"
"76478","2022","COM","2020","190","1","191","2023-01-02"
"76479","2022","COM","2020","138","2","140","2023-01-02"
"76480","2022","COM","2020","453","11","464","2023-01-02"
"76481","2022","COM","2020","6070","119","6189","2023-01-02"
"76482","2022","COM","2020","3162","211","3373","2023-01-02"
"76483","2022","COM","2020","227","2","229","2023-01-02"
"76484","2022","COM","2020","12266","75","12341","2023-01-02"
"76485","2022","COM","2020","275","43","318","2023-01-02"
"76486","2022","COM","2020","881","5","886","2023-01-02"
"76487","2022","COM","2020","315","6","321","2023-01-02"
"76488","2022","COM","2020","517","12","529","2023-01-02"
"76489","2022","COM","2020","441","11","452","2023-01-02"
"76490","2022","COM","2020","1118","15","1133","2023-01-02"
"76491","2022","COM","2020","659","11","670","2023-01-02"
"76492","2022","COM","2020","459","16","475","2023-01-02"
"76493","2022","COM","2020","401","12","413","2023-01-02"
"76494","2022","COM","2020","587","9","596","2023-01-02"
"76495","2022","COM","2020","6164","52","6216","2023-01-02"
"76497","2022","COM","2020","8732","178","8910","2023-01-02"
"76498","2022","COM","2020","21997","286","22283","2023-01-02"
"76499","2022","COM","2020","1124","28","1152","2023-01-02"
"76500","2022","COM","2020","479","4","483","2023-01-02"
"76501","2022","COM","2020","134","7","141","2023-01-02"
"76502","2022","COM","2020","541","10","551","2023-01-02"
"76503","2022","COM","2020","1275","20","1295","2023-01-02"
"76504","2022","COM","2020","127","2","129","2023-01-02"
"76505","2022","COM","2020","98","2","100","2023-01-02"
"76506","2022","COM","2020","496","4","500","2023-01-02"
"76507","2022","COM","2020","819","15","834","2023-01-02"
"76508","2022","COM","2020","453","15","468","2023-01-02"
"76509","2022","COM","2020","1846","32","1878","2023-01-02"
"76510","2022","COM","2020","234","2","236","2023-01-02"
"76511","2022","COM","2020","158","1","159","2023-01-02"
"76512","2022","COM","2020","23","0","23","2023-01-02"
"76513","2022","COM","2020","593","15","608","2023-01-02"
"76514","2022","COM","2020","1029","13","1042","2023-01-02"
"76515","2022","COM","2020","534","14","548","2023-01-02"
"76516","2022","COM","2020","411","18","429","2023-01-02"
"76517","2022","COM","2020","3102","72","3174","2023-01-02"
"76518","2022","COM","2020","499","9","508","2023-01-02"
"76519","2022","COM","2020","75","4","79","2023-01-02"
"76520","2022","COM","2020","595","14","609","2023-01-02"
"76521","2022","COM","2020","147","1","148","2023-01-02"
"76522","2022","COM","2020","1274","24","1298","2023-01-02"
"76523","2022","COM","2020","179","2","181","2023-01-02"
"76524","2022","COM","2020","140","2","142","2023-01-02"
"76526","2022","COM","2020","185","7","192","2023-01-02"
"76527","2022","COM","2020","438","3","441","2023-01-02"
"76528","2022","COM","2020","605","12","617","2023-01-02"
"76529","2022","COM","2020","301","6","307","2023-01-02"
"76530","2022","COM","2020","223","5","228","2023-01-02"
"76531","2022","COM","2020","323","8","331","2023-01-02"
"76532","2022","COM","2020","784","18","802","2023-01-02"
"76533","2022","COM","2020","1668","18","1686","2023-01-02"
"76534","2022","COM","2020","1196","12","1208","2023-01-02"
"76535","2022","COM","2020","462","8","470","2023-01-02"
"76536","2022","COM","2020","1212","22","1234","2023-01-02"
"76537","2022","COM","2020","183","6","189","2023-01-02"
"76538","2022","COM","2020","268","5","273","2023-01-02"
"76540","2022","COM","2020","114187","1605","115792","2023-01-02"
"76541","2022","COM","2020","1536","27","1563","2023-01-02"
"76542","2022","COM","2020","280","4","284","2023-01-02"
"76543","2022","COM","2020","607","11","618","2023-01-02"
"76544","2022","COM","2020","224","7","231","2023-01-02"
"76545","2022","COM","2020","1811","41","1852","2023-01-02"
"76546","2022","COM","2020","308","7","315","2023-01-02"
"76547","2022","COM","2020","773","9","782","2023-01-02"
"76548","2022","COM","2020","760","16","776","2023-01-02"
"76549","2022","COM","2020","139","6","145","2023-01-02"
"76550","2022","COM","2020","1212","16","1228","2023-01-02"
"76551","2022","COM","2020","852","11","863","2023-01-02"
"76552","2022","COM","2020","7216","190","7406","2023-01-02"
"76553","2022","COM","2020","298","4","302","2023-01-02"
"76554","2022","COM","2020","350","3","353","2023-01-02"
"76555","2022","COM","2020","821","21","842","2023-01-02"
"76556","2022","COM","2020","1093","22","1115","2023-01-02"
"76557","2022","COM","2020","1455","22","1477","2023-01-02"
"76558","2022","COM","2020","1180","6","1186","2023-01-02"
"76559","2022","COM","2020","505","8","513","2023-01-02"
"76560","2022","COM","2020","1020","17","1037","2023-01-02"
"76561","2022","COM","2020","8428","73","8501","2023-01-02"
"76562","2022","COM","2020","838","22","860","2023-01-02"
"76563","2022","COM","2020","1935","21","1956","2023-01-02"
"76564","2022","COM","2020","163","3","166","2023-01-02"
"76565","2022","COM","2020","1200","101","1301","2023-01-02"
"76566","2022","COM","2020","654","6","660","2023-01-02"
"76567","2022","COM","2020","175","5","180","2023-01-02"
"76568","2022","COM","2020","611","12","623","2023-01-02"
"76569","2022","COM","2020","222","1","223","2023-01-02"
"76570","2022","COM","2020","313","4","317","2023-01-02"
"76571","2022","COM","2020","688","3","691","2023-01-02"
"76572","2022","COM","2020","123","5","128","2023-01-02"
"76573","2022","COM","2020","498","14","512","2023-01-02"
"76574","2022","COM","2020","701","4","705","2023-01-02"
"76575","2022","COM","2020","28331","231","28562","2023-01-02"
"76576","2022","COM","2020","1218","16","1234","2023-01-02"
"76577","2022","COM","2020","625","13","638","2023-01-02"
"76578","2022","COM","2020","269","5","274","2023-01-02"
"76580","2022","COM","2020","912","17","929","2023-01-02"
"76581","2022","COM","2020","383","9","392","2023-01-02"
"76582","2022","COM","2020","239","5","244","2023-01-02"
"76583","2022","COM","2020","331","5","336","2023-01-02"
"76584","2022","COM","2020","219","5","224","2023-01-02"
"76585","2022","COM","2020","400","15","415","2023-01-02"
"76586","2022","COM","2020","644","5","649","2023-01-02"
"76587","2022","COM","2020","732","9","741","2023-01-02"
"76588","2022","COM","2020","504","12","516","2023-01-02"
"76589","2022","COM","2020","194","5","199","2023-01-02"
"76590","2022","COM","2020","341","2","343","2023-01-02"
"76591","2022","COM","2020","3108","48","3156","2023-01-02"
"76592","2022","COM","2020","811","26","837","2023-01-02"
"76593","2022","COM","2020","624","11","635","2023-01-02"
"76594","2022","COM","2020","1338","26","1364","2023-01-02"
"76595","2022","COM","2020","1837","35","1872","2023-01-02"
"76596","2022","COM","2020","1491","38","1529","2023-01-02"
"76597","2022","COM","2020","763","9","772","2023-01-02"
"76598","2022","COM","2020","485","9","494","2023-01-02"
"76599","2022","COM","2020","3617","42","3659","2023-01-02"
"76600","2022","COM","2020","1702","34","1736","2023-01-02"
"76601","2022","COM","2020","234","3","237","2023-01-02"
"76602","2022","COM","2020","619","15","634","2023-01-02"
"76603","2022","COM","2020","462","6","468","2023-01-02"
"76604","2022","COM","2020","177","6","183","2023-01-02"
"76605","2022","COM","2020","463","13","476","2023-01-02"
"76606","2022","COM","2020","189","25","214","2023-01-02"
"76608","2022","COM","2020","2027","33","2060","2023-01-02"
"76609","2022","COM","2020","367","11","378","2023-01-02"
"76610","2022","COM","2020","1576","13","1589","2023-01-02"
"76611","2022","COM","2020","316","9","325","2023-01-02"
"76612","2022","COM","2020","262","6","268","2023-01-02"
"76613","2022","COM","2020","646","12","658","2023-01-02"
"76614","2022","COM","2020","1536","30","1566","2023-01-02"
"76615","2022","COM","2020","637","23","660","2023-01-02"
"76616","2022","COM","2020","1460","33","1493","2023-01-02"
"76617","2022","COM","2020","1675","64","1739","2023-01-02"
"76618","2022","COM","2020","9654","208","9862","2023-01-02"
"76619","2022","COM","2020","284","5","289","2023-01-02"
"76620","2022","COM","2020","272","7","279","2023-01-02"
"76621","2022","COM","2020","1183","22","1205","2023-01-02"
"76622","2022","COM","2020","298","10","308","2023-01-02"
"76623","2022","COM","2020","116","3","119","2023-01-02"
"76624","2022","COM","2020","3718","60","3778","2023-01-02"
"76626","2022","COM","2020","414","14","428","2023-01-02"
"76627","2022","COM","2020","1649","18","1667","2023-01-02"
"76628","2022","COM","2020","816","13","829","2023-01-02"
"76629","2022","COM","2020","278","5","283","2023-01-02"
"76630","2022","COM","2020","227","7","234","2023-01-02"
"76631","2022","COM","2020","1307","15","1322","2023-01-02"
"76632","2022","COM","2020","379","3","382","2023-01-02"
"76634","2022","COM","2020","885","15","900","2023-01-02"
"76635","2022","COM","2020","74","0","74","2023-01-02"
"76636","2022","COM","2020","2290","33","2323","2023-01-02"
"76637","2022","COM","2020","826","14","840","2023-01-02"
"76638","2022","COM","2020","1087","16","1103","2023-01-02"
"76640","2022","COM","2020","8251","73","8324","2023-01-02"
"76641","2022","COM","2020","194","5","199","2023-01-02"
"76642","2022","COM","2020","265","3","268","2023-01-02"
"76644","2022","COM","2020","797","16","813","2023-01-02"
"76645","2022","COM","2020","145","5","150","2023-01-02"
"76646","2022","COM","2020","614","14","628","2023-01-02"
"76647","2022","COM","2020","4355","42","4397","2023-01-02"
"76648","2022","COM","2020","2326","24","2350","2023-01-02"
"76649","2022","COM","2020","579","11","590","2023-01-02"
"76650","2022","COM","2020","1226","29","1255","2023-01-02"
"76651","2022","COM","2020","140","3","143","2023-01-02"
"76652","2022","COM","2020","762","5","767","2023-01-02"
"76653","2022","COM","2020","372","3","375","2023-01-02"
"76654","2022","COM","2020","466","10","476","2023-01-02"
"76655","2022","COM","2020","3906","162","4068","2023-01-02"
"76656","2022","COM","2020","761","6","767","2023-01-02"
"76657","2022","COM","2020","1141","23","1164","2023-01-02"
"76658","2022","COM","2020","695","21","716","2023-01-02"
"76660","2022","COM","2020","795","11","806","2023-01-02"
"76662","2022","COM","2020","108","1","109","2023-01-02"
"76663","2022","COM","2020","1002","19","1021","2023-01-02"
"76664","2022","COM","2020","280","5","285","2023-01-02"
"76665","2022","COM","2020","438","5","443","2023-01-02"
"76666","2022","COM","2020","411","16","427","2023-01-02"
"76667","2022","COM","2020","342","6","348","2023-01-02"
"76668","2022","COM","2020","366","7","373","2023-01-02"
"76669","2022","COM","2020","429","7","436","2023-01-02"
"76670","2022","COM","2020","888","11","899","2023-01-02"
"76671","2022","COM","2020","171","1","172","2023-01-02"
"76672","2022","COM","2020","965","15","980","2023-01-02"
"76673","2022","COM","2020","1131","16","1147","2023-01-02"
"76675","2022","COM","2020","1111","14","1125","2023-01-02"
"76676","2022","COM","2020","494","8","502","2023-01-02"
"76677","2022","COM","2020","368","8","376","2023-01-02"
"76678","2022","COM","2020","837","10","847","2023-01-02"
"76679","2022","COM","2020","113","1","114","2023-01-02"
"76680","2022","COM","2020","185","4","189","2023-01-02"
"76681","2022","COM","2020","29071","459","29530","2023-01-02"
"76682","2022","COM","2020","749","4","753","2023-01-02"
"76683","2022","COM","2020","399","10","409","2023-01-02"
"76684","2022","COM","2020","1233","22","1255","2023-01-02"
"76685","2022","COM","2020","666","8","674","2023-01-02"
"76686","2022","COM","2020","535","8","543","2023-01-02"
"76688","2022","COM","2020","399","11","410","2023-01-02"
"76689","2022","COM","2020","369","38","407","2023-01-02"
"76690","2022","COM","2020","654","19","673","2023-01-02"
"76691","2022","COM","2020","236","1","237","2023-01-02"
"76692","2022","COM","2020","285","5","290","2023-01-02"
"76693","2022","COM","2020","686","7","693","2023-01-02"
"76694","2022","COM","2020","139","3","142","2023-01-02"
"76695","2022","COM","2020","280","5","285","2023-01-02"
"76697","2022","COM","2020","792","24","816","2023-01-02"
"76698","2022","COM","2020","499","8","507","2023-01-02"
"76699","2022","COM","2020","459","4","463","2023-01-02"
"76700","2022","COM","2020","1576","30","1606","2023-01-02"
"76702","2022","COM","2020","835","16","851","2023-01-02"
"76703","2022","COM","2020","215","8","223","2023-01-02"
"76705","2022","COM","2020","2562","19","2581","2023-01-02"
"76706","2022","COM","2020","722","8","730","2023-01-02"
"76707","2022","COM","2020","1200","35","1235","2023-01-02"
"76708","2022","COM","2020","699","11","710","2023-01-02"
"76709","2022","COM","2020","4831","45","4876","2023-01-02"
"76710","2022","COM","2020","103","2","105","2023-01-02"
"76711","2022","COM","2020","4441","92","4533","2023-01-02"
"76712","2022","COM","2020","850","27","877","2023-01-02"
"76714","2022","COM","2020","786","14","800","2023-01-02"
"76715","2022","COM","2020","625","8","633","2023-01-02"
"76716","2022","COM","2020","1505","19","1524","2023-01-02"
"76717","2022","COM","2020","718","3","721","2023-01-02"
"76718","2022","COM","2020","1423","38","1461","2023-01-02"
"76719","2022","COM","2020","863","15","878","2023-01-02"
"76720","2022","COM","2020","952","31","983","2023-01-02"
"76721","2022","COM","2020","327","9","336","2023-01-02"
"76723","2022","COM","2020","429","7","436","2023-01-02"
"76724","2022","COM","2020","131","2","133","2023-01-02"
"76725","2022","COM","2020","578","5","583","2023-01-02"
"76726","2022","COM","2020","323","6","329","2023-01-02"
"76727","2022","COM","2020","1146","26","1172","2023-01-02"
"76728","2022","COM","2020","1171","21","1192","2023-01-02"
"76730","2022","COM","2020","131","5","136","2023-01-02"
"76731","2022","COM","2020","209","2","211","2023-01-02"
"76732","2022","COM","2020","240","4","244","2023-01-02"
"76733","2022","COM","2020","224","3","227","2023-01-02"
"76734","2022","COM","2020","445","12","457","2023-01-02"
"76735","2022","COM","2020","523","13","536","2023-01-02"
"76736","2022","COM","2020","275","6","281","2023-01-02"
"76737","2022","COM","2020","607","11","618","2023-01-02"
"76738","2022","COM","2020","767","11","778","2023-01-02"
"76739","2022","COM","2020","563","6","569","2023-01-02"
"76740","2022","COM","2020","578","10","588","2023-01-02"
"76741","2022","COM","2020","282","12","294","2023-01-02"
"76743","2022","COM","2020","1753","19","1772","2023-01-02"
"76744","2022","COM","2020","184","2","186","2023-01-02"
"76745","2022","COM","2020","205","2","207","2023-01-02"
"76746","2022","COM","2020","228","2","230","2023-01-02"
"76747","2022","COM","2020","348","3","351","2023-01-02"
"76748","2022","COM","2020","654","7","661","2023-01-02"
"76749","2022","COM","2020","335","8","343","2023-01-02"
"76750","2022","COM","2020","1037","13","1050","2023-01-02"
"76751","2022","COM","2020","1274","15","1289","2023-01-02"
"76752","2022","COM","2020","2515","20","2535","2023-01-02"
"76753","2022","COM","2020","1182","22","1204","2023-01-02"
"76754","2022","COM","2020","718","13","731","2023-01-02"
"76755","2022","COM","2020","565","8","573","2023-01-02"
"76756","2022","COM","2020","240","1","241","2023-01-02"
"76757","2022","COM","2020","636","13","649","2023-01-02"
"76758","2022","COM","2020","11280","205","11485","2023-01-02"
"76759","2022","COM","2020","437","8","445","2023-01-02"
"77001","2022","COM","2020","1151","29","1180","2023-01-02"
"77002","2022","COM","2020","819","4","823","2023-01-02"
"77003","2022","COM","2020","342","7","349","2023-01-02"
"77004","2022","COM","2020","299","1","300","2023-01-02"
"77005","2022","COM","2020","3305","47","3352","2023-01-02"
"77006","2022","COM","2020","978","20","998","2023-01-02"
"77007","2022","COM","2020","355","6","361","2023-01-02"
"77008","2022","COM","2020","1213","24","1237","2023-01-02"
"77009","2022","COM","2020","129","2","131","2023-01-02"
"77010","2022","COM","2020","941","10","951","2023-01-02"
"77011","2022","COM","2020","491","7","498","2023-01-02"
"77012","2022","COM","2020","292","7","299","2023-01-02"
"77013","2022","COM","2020","361","9","370","2023-01-02"
"77014","2022","COM","2020","13545","218","13763","2023-01-02"
"77015","2022","COM","2020","100","2","102","2023-01-02"
"77016","2022","COM","2020","1607","14","1621","2023-01-02"
"77018","2022","COM","2020","7288","80","7368","2023-01-02"
"77019","2022","COM","2020","335","3","338","2023-01-02"
"77020","2022","COM","2020","649","12","661","2023-01-02"
"77021","2022","COM","2020","154","3","157","2023-01-02"
"77022","2022","COM","2020","1245","40","1285","2023-01-02"
"77023","2022","COM","2020","359","7","366","2023-01-02"
"77024","2022","COM","2020","393","1","394","2023-01-02"
"77025","2022","COM","2020","872","8","880","2023-01-02"
"77026","2022","COM","2020","354","15","369","2023-01-02"
"77027","2022","COM","2020","1175","16","1191","2023-01-02"
"77029","2022","COM","2020","185","3","188","2023-01-02"
"77030","2022","COM","2020","773","5","778","2023-01-02"
"77031","2022","COM","2020","946","11","957","2023-01-02"
"77032","2022","COM","2020","924","17","941","2023-01-02"
"77033","2022","COM","2020","230","8","238","2023-01-02"
"77034","2022","COM","2020","782","7","789","2023-01-02"
"77035","2022","COM","2020","546","7","553","2023-01-02"
"77036","2022","COM","2020","134","3","137","2023-01-02"
"77037","2022","COM","2020","5933","147","6080","2023-01-02"
"77038","2022","COM","2020","413","7","420","2023-01-02"
"77039","2022","COM","2020","1169","11","1180","2023-01-02"
"77040","2022","COM","2020","3712","42","3754","2023-01-02"
"77041","2022","COM","2020","278","7","285","2023-01-02"
"77042","2022","COM","2020","3249","41","3290","2023-01-02"
"77043","2022","COM","2020","334","7","341","2023-01-02"
"77044","2022","COM","2020","952","9","961","2023-01-02"
"77045","2022","COM","2020","721","11","732","2023-01-02"
"77046","2022","COM","2020","329","10","339","2023-01-02"
"77047","2022","COM","2020","1698","13","1711","2023-01-02"
"77048","2022","COM","2020","2768","86","2854","2023-01-02"
"77049","2022","COM","2020","837","13","850","2023-01-02"
"77050","2022","COM","2020","528","11","539","2023-01-02"
"77051","2022","COM","2020","2337","18","2355","2023-01-02"
"77052","2022","COM","2020","361","5","366","2023-01-02"
"77053","2022","COM","2020","19161","286","19447","2023-01-02"
"77054","2022","COM","2020","721","14","735","2023-01-02"
"77055","2022","COM","2020","4890","10","4900","2023-01-02"
"77056","2022","COM","2020","147","6","153","2023-01-02"
"77057","2022","COM","2020","539","3","542","2023-01-02"
"77058","2022","COM","2020","26551","356","26907","2023-01-02"
"77059","2022","COM","2020","676","14","690","2023-01-02"
"77060","2022","COM","2020","730","16","746","2023-01-02"
"77061","2022","COM","2020","2575","26","2601","2023-01-02"
"77062","2022","COM","2020","456","10","466","2023-01-02"
"77063","2022","COM","2020","1251","15","1266","2023-01-02"
"77065","2022","COM","2020","1247","24","1271","2023-01-02"
"77066","2022","COM","2020","310","3","313","2023-01-02"
"77067","2022","COM","2020","10937","132","11069","2023-01-02"
"77068","2022","COM","2020","215","4","219","2023-01-02"
"77069","2022","COM","2020","2083","32","2115","2023-01-02"
"77070","2022","COM","2020","1520","131","1651","2023-01-02"
"77071","2022","COM","2020","842","15","857","2023-01-02"
"77072","2022","COM","2020","678","10","688","2023-01-02"
"77073","2022","COM","2020","553","17","570","2023-01-02"
"77075","2022","COM","2020","1384","10","1394","2023-01-02"
"77076","2022","COM","2020","757","54","811","2023-01-02"
"77077","2022","COM","2020","1032","11","1043","2023-01-02"
"77078","2022","COM","2020","1365","52","1417","2023-01-02"
"77079","2022","COM","2020","6354","150","6504","2023-01-02"
"77080","2022","COM","2020","197","2","199","2023-01-02"
"77081","2022","COM","2020","731","8","739","2023-01-02"
"77082","2022","COM","2020","812","12","824","2023-01-02"
"77083","2022","COM","2020","25230","142","25372","2023-01-02"
"77084","2022","COM","2020","1372","12","1384","2023-01-02"
"77085","2022","COM","2020","4017","51","4068","2023-01-02"
"77086","2022","COM","2020","1428","6","1434","2023-01-02"
"77087","2022","COM","2020","177","2","179","2023-01-02"
"77088","2022","COM","2020","2367","29","2396","2023-01-02"
"77089","2022","COM","2020","908","7","915","2023-01-02"
"77090","2022","COM","2020","240","4","244","2023-01-02"
"77091","2022","COM","2020","494","3","497","2023-01-02"
"77093","2022","COM","2020","434","2","436","2023-01-02"
"77094","2022","COM","2020","300","1","301","2023-01-02"
"77095","2022","COM","2020","1539","17","1556","2023-01-02"
"77096","2022","COM","2020","2542","56","2598","2023-01-02"
"77097","2022","COM","2020","299","2","301","2023-01-02"
"77098","2022","COM","2020","360","5","365","2023-01-02"
"77099","2022","COM","2020","3020","54","3074","2023-01-02"
"77100","2022","COM","2020","4282","67","4349","2023-01-02"
"77101","2022","COM","2020","1060","16","1076","2023-01-02"
"77102","2022","COM","2020","161","1","162","2023-01-02"
"77103","2022","COM","2020","220","2","222","2023-01-02"
"77104","2022","COM","2020","704","7","711","2023-01-02"
"77106","2022","COM","2020","1024","18","1042","2023-01-02"
"77107","2022","COM","2020","3387","27","3414","2023-01-02"
"77108","2022","COM","2020","54372","319","54691","2023-01-02"
"77109","2022","COM","2020","1653","26","1679","2023-01-02"
"77110","2022","COM","2020","305","7","312","2023-01-02"
"77111","2022","COM","2020","6724","56","6780","2023-01-02"
"77112","2022","COM","2020","255","4","259","2023-01-02"
"77113","2022","COM","2020","1068","11","1079","2023-01-02"
"77114","2022","COM","2020","3920","42","3962","2023-01-02"
"77115","2022","COM","2020","511","17","528","2023-01-02"
"77116","2022","COM","2020","1314","15","1329","2023-01-02"
"77117","2022","COM","2020","958","12","970","2023-01-02"
"77118","2022","COM","2020","12316","119","12435","2023-01-02"
"77119","2022","COM","2020","244","3","247","2023-01-02"
"77120","2022","COM","2020","631","5","636","2023-01-02"
"77121","2022","COM","2020","3339","42","3381","2023-01-02"
"77122","2022","COM","2020","21657","144","21801","2023-01-02"
"77123","2022","COM","2020","816","2","818","2023-01-02"
"77124","2022","COM","2020","1746","28","1774","2023-01-02"
"77125","2022","COM","2020","1429","17","1446","2023-01-02"
"77126","2022","COM","2020","1769","182","1951","2023-01-02"
"77127","2022","COM","2020","1885","13","1898","2023-01-02"
"77128","2022","COM","2020","2096","29","2125","2023-01-02"
"77129","2022","COM","2020","566","8","574","2023-01-02"
"77130","2022","COM","2020","517","4","521","2023-01-02"
"77131","2022","COM","2020","14953","214","15167","2023-01-02"
"77132","2022","COM","2020","2867","28","2895","2023-01-02"
"77133","2022","COM","2020","196","3","199","2023-01-02"
"77134","2022","COM","2020","150","3","153","2023-01-02"
"77135","2022","COM","2020","1272","15","1287","2023-01-02"
"77136","2022","COM","2020","189","7","196","2023-01-02"
"77137","2022","COM","2020","240","10","250","2023-01-02"
"77138","2022","COM","2020","548","5","553","2023-01-02"
"77139","2022","COM","2020","6643","53","6696","2023-01-02"
"77140","2022","COM","2020","271","3","274","2023-01-02"
"77141","2022","COM","2020","1196","9","1205","2023-01-02"
"77142","2022","COM","2020","4774","69","4843","2023-01-02"
"77143","2022","COM","2020","5288","40","5328","2023-01-02"
"77144","2022","COM","2020","440","1","441","2023-01-02"
"77145","2022","COM","2020","616","12","628","2023-01-02"
"77146","2022","COM","2020","2009","20","2029","2023-01-02"
"77147","2022","COM","2020","664","7","671","2023-01-02"
"77148","2022","COM","2020","1820","23","1843","2023-01-02"
"77150","2022","COM","2020","460","5","465","2023-01-02"
"77151","2022","COM","2020","270","4","274","2023-01-02"
"77152","2022","COM","2020","22318","153","22471","2023-01-02"
"77153","2022","COM","2020","10830","92","10922","2023-01-02"
"77154","2022","COM","2020","1168","15","1183","2023-01-02"
"77155","2022","COM","2020","3517","39","3556","2023-01-02"
"77156","2022","COM","2020","903","12","915","2023-01-02"
"77157","2022","COM","2020","317","5","322","2023-01-02"
"77158","2022","COM","2020","199","2","201","2023-01-02"
"77159","2022","COM","2020","2760","49","2809","2023-01-02"
"77161","2022","COM","2020","797","18","815","2023-01-02"
"77162","2022","COM","2020","1094","9","1103","2023-01-02"
"77163","2022","COM","2020","374","6","380","2023-01-02"
"77164","2022","COM","2020","558","5","563","2023-01-02"
"77165","2022","COM","2020","602","5","607","2023-01-02"
"77167","2022","COM","2020","320","5","325","2023-01-02"
"77168","2022","COM","2020","2151","36","2187","2023-01-02"
"77169","2022","COM","2020","7667","32","7699","2023-01-02"
"77171","2022","COM","2020","6464","45","6509","2023-01-02"
"77172","2022","COM","2020","891","10","901","2023-01-02"
"77173","2022","COM","2020","825","8","833","2023-01-02"
"77174","2022","COM","2020","578","12","590","2023-01-02"
"77175","2022","COM","2020","3070","31","3101","2023-01-02"
"77176","2022","COM","2020","2991","27","3018","2023-01-02"
"77177","2022","COM","2020","1186","6","1192","2023-01-02"
"77178","2022","COM","2020","497","10","507","2023-01-02"
"77179","2022","COM","2020","601","15","616","2023-01-02"
"77180","2022","COM","2020","1263","27","1290","2023-01-02"
"77181","2022","COM","2020","3796","36","3832","2023-01-02"
"77182","2022","COM","2020","4877","33","4910","2023-01-02"
"77183","2022","COM","2020","9672","80","9752","2023-01-02"
"77184","2022","COM","2020","610","11","621","2023-01-02"
"77185","2022","COM","2020","654","17","671","2023-01-02"
"77186","2022","COM","2020","15903","465","16368","2023-01-02"
"77187","2022","COM","2020","581","3","584","2023-01-02"
"77188","2022","COM","2020","992","18","1010","2023-01-02"
"77190","2022","COM","2020","263","6","269","2023-01-02"
"77191","2022","COM","2020","1052","13","1065","2023-01-02"
"77192","2022","COM","2020","5756","58","5814","2023-01-02"
"77193","2022","COM","2020","241","1","242","2023-01-02"
"77194","2022","COM","2020","421","17","438","2023-01-02"
"77195","2022","COM","2020","583","10","593","2023-01-02"
"77196","2022","COM","2020","964","7","971","2023-01-02"
"77197","2022","COM","2020","166","3","169","2023-01-02"
"77198","2022","COM","2020","241","9","250","2023-01-02"
"77199","2022","COM","2020","1402","11","1413","2023-01-02"
"77200","2022","COM","2020","122","2","124","2023-01-02"
"77201","2022","COM","2020","688","3","691","2023-01-02"
"77202","2022","COM","2020","809","6","815","2023-01-02"
"77203","2022","COM","2020","1336","21","1357","2023-01-02"
"77204","2022","COM","2020","209","3","212","2023-01-02"
"77205","2022","COM","2020","147","1","148","2023-01-02"
"77206","2022","COM","2020","183","4","187","2023-01-02"
"77207","2022","COM","2020","152","5","157","2023-01-02"
"77208","2022","COM","2020","1361","27","1388","2023-01-02"
"77209","2022","COM","2020","1188","23","1211","2023-01-02"
"77210","2022","COM","2020","2886","36","2922","2023-01-02"
"77211","2022","COM","2020","1015","5","1020","2023-01-02"
"77212","2022","COM","2020","163","3","166","2023-01-02"
"77214","2022","COM","2020","807","13","820","2023-01-02"
"77215","2022","COM","2020","8459","66","8525","2023-01-02"
"77216","2022","COM","2020","1421","34","1455","2023-01-02"
"77217","2022","COM","2020","2521","30","2551","2023-01-02"
"77218","2022","COM","2020","107","1","108","2023-01-02"
"77219","2022","COM","2020","2641","32","2673","2023-01-02"
"77220","2022","COM","2020","265","4","269","2023-01-02"
"77221","2022","COM","2020","1136","24","1160","2023-01-02"
"77222","2022","COM","2020","4344","29","4373","2023-01-02"
"77223","2022","COM","2020","564","6","570","2023-01-02"
"77224","2022","COM","2020","253","4","257","2023-01-02"
"77225","2022","COM","2020","327","6","333","2023-01-02"
"77226","2022","COM","2020","2518","97","2615","2023-01-02"
"77227","2022","COM","2020","615","17","632","2023-01-02"
"77228","2022","COM","2020","257","2","259","2023-01-02"
"77229","2022","COM","2020","1646","18","1664","2023-01-02"
"77230","2022","COM","2020","160","1","161","2023-01-02"
"77231","2022","COM","2020","819","2","821","2023-01-02"
"77232","2022","COM","2020","1145","17","1162","2023-01-02"
"77233","2022","COM","2020","596","6","602","2023-01-02"
"77234","2022","COM","2020","702","7","709","2023-01-02"
"77235","2022","COM","2020","317","5","322","2023-01-02"
"77236","2022","COM","2020","345","4","349","2023-01-02"
"77237","2022","COM","2020","640","9","649","2023-01-02"
"77238","2022","COM","2020","4345","39","4384","2023-01-02"
"77239","2022","COM","2020","1504","20","1524","2023-01-02"
"77240","2022","COM","2020","2212","26","2238","2023-01-02"
"77241","2022","COM","2020","2018","14","2032","2023-01-02"
"77242","2022","COM","2020","532","8","540","2023-01-02"
"77243","2022","COM","2020","21139","193","21332","2023-01-02"
"77244","2022","COM","2020","697","12","709","2023-01-02"
"77245","2022","COM","2020","403","4","407","2023-01-02"
"77246","2022","COM","2020","583","16","599","2023-01-02"
"77247","2022","COM","2020","441","8","449","2023-01-02"
"77248","2022","COM","2020","776","8","784","2023-01-02"
"77249","2022","COM","2020","7125","117","7242","2023-01-02"
"77250","2022","COM","2020","163","3","166","2023-01-02"
"77251","2022","COM","2020","13804","87","13891","2023-01-02"
"77252","2022","COM","2020","564","6","570","2023-01-02"
"77253","2022","COM","2020","315","1","316","2023-01-02"
"77254","2022","COM","2020","1295","23","1318","2023-01-02"
"77255","2022","COM","2020","2207","30","2237","2023-01-02"
"77256","2022","COM","2020","187","1","188","2023-01-02"
"77257","2022","COM","2020","3529","18","3547","2023-01-02"
"77258","2022","COM","2020","14388","53","14441","2023-01-02"
"77259","2022","COM","2020","2303","10","2313","2023-01-02"
"77260","2022","COM","2020","1778","26","1804","2023-01-02"
"77261","2022","COM","2020","1208","22","1230","2023-01-02"
"77262","2022","COM","2020","497","18","515","2023-01-02"
"77263","2022","COM","2020","232","7","239","2023-01-02"
"77264","2022","COM","2020","1512","20","1532","2023-01-02"
"77265","2022","COM","2020","1092","52","1144","2023-01-02"
"77266","2022","COM","2020","785","12","797","2023-01-02"
"77267","2022","COM","2020","355","4","359","2023-01-02"
"77268","2022","COM","2020","9082","148","9230","2023-01-02"
"77269","2022","COM","2020","1819","53","1872","2023-01-02"
"77270","2022","COM","2020","954","12","966","2023-01-02"
"77271","2022","COM","2020","137","1","138","2023-01-02"
"77272","2022","COM","2020","861","8","869","2023-01-02"
"77273","2022","COM","2020","594","3","597","2023-01-02"
"77274","2022","COM","2020","449","2","451","2023-01-02"
"77275","2022","COM","2020","150","3","153","2023-01-02"
"77276","2022","COM","2020","3306","43","3349","2023-01-02"
"77277","2022","COM","2020","1798","21","1819","2023-01-02"
"77278","2022","COM","2020","415","6","421","2023-01-02"
"77279","2022","COM","2020","1832","34","1866","2023-01-02"
"77280","2022","COM","2020","1095","10","1105","2023-01-02"
"77281","2022","COM","2020","472","4","476","2023-01-02"
"77282","2022","COM","2020","365","4","369","2023-01-02"
"77283","2022","COM","2020","923","11","934","2023-01-02"
"77284","2022","COM","2020","55709","482","56191","2023-01-02"
"77285","2022","COM","2020","20677","140","20817","2023-01-02"
"77286","2022","COM","2020","231","6","237","2023-01-02"
"77287","2022","COM","2020","499","1","500","2023-01-02"
"77288","2022","COM","2020","41609","258","41867","2023-01-02"
"77289","2022","COM","2020","351","3","354","2023-01-02"
"77290","2022","COM","2020","684","57","741","2023-01-02"
"77291","2022","COM","2020","1041","4","1045","2023-01-02"
"77292","2022","COM","2020","1210","10","1220","2023-01-02"
"77293","2022","COM","2020","894","17","911","2023-01-02"
"77294","2022","COM","2020","20620","93","20713","2023-01-02"
"77295","2022","COM","2020","1379","14","1393","2023-01-02"
"77296","2022","COM","2020","17982","135","18117","2023-01-02"
"77297","2022","COM","2020","327","5","332","2023-01-02"
"77298","2022","COM","2020","445","10","455","2023-01-02"
"77300","2022","COM","2020","601","12","613","2023-01-02"
"77301","2022","COM","2020","322","1","323","2023-01-02"
"77302","2022","COM","2020","1943","33","1976","2023-01-02"
"77303","2022","COM","2020","236","3","239","2023-01-02"
"77304","2022","COM","2020","25","0","25","2023-01-02"
"77305","2022","COM","2020","21888","185","22073","2023-01-02"
"77306","2022","COM","2020","497","5","502","2023-01-02"
"77307","2022","COM","2020","14017","103","14120","2023-01-02"
"77308","2022","COM","2020","728","6","734","2023-01-02"
"77309","2022","COM","2020","1751","10","1761","2023-01-02"
"77310","2022","COM","2020","305","6","311","2023-01-02"
"77311","2022","COM","2020","1405","18","1423","2023-01-02"
"77312","2022","COM","2020","2640","75","2715","2023-01-02"
"77313","2022","COM","2020","259","2","261","2023-01-02"
"77314","2022","COM","2020","239","2","241","2023-01-02"
"77315","2022","COM","2020","3740","30","3770","2023-01-02"
"77316","2022","COM","2020","12507","338","12845","2023-01-02"
"77317","2022","COM","2020","5104","37","5141","2023-01-02"
"77318","2022","COM","2020","1423","21","1444","2023-01-02"
"77319","2022","COM","2020","142","4","146","2023-01-02"
"77320","2022","COM","2020","5972","59","6031","2023-01-02"
"77321","2022","COM","2020","667","4","671","2023-01-02"
"77322","2022","COM","2020","3212","27","3239","2023-01-02"
"77323","2022","COM","2020","1476","9","1485","2023-01-02"
"77325","2022","COM","2020","360","5","365","2023-01-02"
"77326","2022","COM","2020","6262","73","6335","2023-01-02"
"77327","2022","COM","2020","8904","86","8990","2023-01-02"
"77328","2022","COM","2020","419","7","426","2023-01-02"
"77329","2022","COM","2020","687","3","690","2023-01-02"
"77330","2022","COM","2020","6549","76","6625","2023-01-02"
"77331","2022","COM","2020","428","6","434","2023-01-02"
"77332","2022","COM","2020","293","1","294","2023-01-02"
"77333","2022","COM","2020","12966","143","13109","2023-01-02"
"77335","2022","COM","2020","3595","28","3623","2023-01-02"
"77336","2022","COM","2020","1195","11","1206","2023-01-02"
"77337","2022","COM","2020","15750","103","15853","2023-01-02"
"77338","2022","COM","2020","595","8","603","2023-01-02"
"77339","2022","COM","2020","1829","61","1890","2023-01-02"
"77340","2022","COM","2020","606","12","618","2023-01-02"
"77341","2022","COM","2020","382","10","392","2023-01-02"
"77342","2022","COM","2020","109","0","109","2023-01-02"
"77343","2022","COM","2020","386","19","405","2023-01-02"
"77344","2022","COM","2020","2448","23","2471","2023-01-02"
"77345","2022","COM","2020","660","9","669","2023-01-02"
"77347","2022","COM","2020","855","10","865","2023-01-02"
"77348","2022","COM","2020","237","3","240","2023-01-02"
"77349","2022","COM","2020","6737","70","6807","2023-01-02"
"77350","2022","COM","2020","20712","209","20921","2023-01-02"
"77352","2022","COM","2020","1951","20","1971","2023-01-02"
"77353","2022","COM","2020","444","5","449","2023-01-02"
"77354","2022","COM","2020","951","9","960","2023-01-02"
"77355","2022","COM","2020","167","0","167","2023-01-02"
"77356","2022","COM","2020","45","1","46","2023-01-02"
"77357","2022","COM","2020","845","10","855","2023-01-02"
"77358","2022","COM","2020","1340","13","1353","2023-01-02"
"77359","2022","COM","2020","2007","33","2040","2023-01-02"
"77360","2022","COM","2020","392","4","396","2023-01-02"
"77361","2022","COM","2020","461","7","468","2023-01-02"
"77363","2022","COM","2020","1569","12","1581","2023-01-02"
"77364","2022","COM","2020","257","2","259","2023-01-02"
"77365","2022","COM","2020","624","5","629","2023-01-02"
"77366","2022","COM","2020","289","1","290","2023-01-02"
"77367","2022","COM","2020","279","4","283","2023-01-02"
"77368","2022","COM","2020","508","13","521","2023-01-02"
"77369","2022","COM","2020","759","11","770","2023-01-02"
"77370","2022","COM","2020","783","12","795","2023-01-02"
"77371","2022","COM","2020","2990","27","3017","2023-01-02"
"77372","2022","COM","2020","4168","37","4205","2023-01-02"
"77373","2022","COM","2020","37579","225","37804","2023-01-02"
"77374","2022","COM","2020","2154","19","2173","2023-01-02"
"77376","2022","COM","2020","797","2","799","2023-01-02"
"77377","2022","COM","2020","2310","29","2339","2023-01-02"
"77378","2022","COM","2020","3254","30","3284","2023-01-02"
"77379","2022","COM","2020","12115","279","12394","2023-01-02"
"77380","2022","COM","2020","321","6","327","2023-01-02"
"77381","2022","COM","2020","661","5","666","2023-01-02"
"77382","2022","COM","2020","5443","54","5497","2023-01-02"
"77383","2022","COM","2020","828","10","838","2023-01-02"
"77384","2022","COM","2020","1954","3","1957","2023-01-02"
"77385","2022","COM","2020","2298","23","2321","2023-01-02"
"77386","2022","COM","2020","607","22","629","2023-01-02"
"77387","2022","COM","2020","468","9","477","2023-01-02"
"77388","2022","COM","2020","822","7","829","2023-01-02"
"77389","2022","COM","2020","3820","91","3911","2023-01-02"
"77390","2022","COM","2020","22643","104","22747","2023-01-02"
"77391","2022","COM","2020","491","11","502","2023-01-02"
"77392","2022","COM","2020","916","12","928","2023-01-02"
"77393","2022","COM","2020","2826","37","2863","2023-01-02"
"77394","2022","COM","2020","3095","31","3126","2023-01-02"
"77395","2022","COM","2020","120","4","124","2023-01-02"
"77396","2022","COM","2020","100","0","100","2023-01-02"
"77397","2022","COM","2020","1859","21","1880","2023-01-02"
"77398","2022","COM","2020","722","8","730","2023-01-02"
"77400","2022","COM","2020","1774","25","1799","2023-01-02"
"77401","2022","COM","2020","671","7","678","2023-01-02"
"77402","2022","COM","2020","339","5","344","2023-01-02"
"77403","2022","COM","2020","808","13","821","2023-01-02"
"77404","2022","COM","2020","1808","37","1845","2023-01-02"
"77405","2022","COM","2020","1955","43","1998","2023-01-02"
"77406","2022","COM","2020","1005","20","1025","2023-01-02"
"77407","2022","COM","2020","14315","114","14429","2023-01-02"
"77408","2022","COM","2020","425","2","427","2023-01-02"
"77409","2022","COM","2020","2769","82","2851","2023-01-02"
"77410","2022","COM","2020","746","33","779","2023-01-02"
"77411","2022","COM","2020","560","12","572","2023-01-02"
"77412","2022","COM","2020","386","5","391","2023-01-02"
"77413","2022","COM","2020","3849","46","3895","2023-01-02"
"77414","2022","COM","2020","489","7","496","2023-01-02"
"77415","2022","COM","2020","1281","17","1298","2023-01-02"
"77416","2022","COM","2020","247","5","252","2023-01-02"
"77417","2022","COM","2020","254","1","255","2023-01-02"
"77418","2022","COM","2020","871","12","883","2023-01-02"
"77419","2022","COM","2020","3404","118","3522","2023-01-02"
"77420","2022","COM","2020","3846","26","3872","2023-01-02"
"77421","2022","COM","2020","256","7","263","2023-01-02"
"77423","2022","COM","2020","658","9","667","2023-01-02"
"77424","2022","COM","2020","274","4","278","2023-01-02"
"77425","2022","COM","2020","730","21","751","2023-01-02"
"77426","2022","COM","2020","332","9","341","2023-01-02"
"77427","2022","COM","2020","608","5","613","2023-01-02"
"77428","2022","COM","2020","834","9","843","2023-01-02"
"77429","2022","COM","2020","533","7","540","2023-01-02"
"77430","2022","COM","2020","6238","53","6291","2023-01-02"
"77431","2022","COM","2020","5408","95","5503","2023-01-02"
"77432","2022","COM","2020","987","10","997","2023-01-02"
"77433","2022","COM","2020","1992","34","2026","2023-01-02"
"77434","2022","COM","2020","366","5","371","2023-01-02"
"77435","2022","COM","2020","1102","32","1134","2023-01-02"
"77436","2022","COM","2020","905","5","910","2023-01-02"
"77437","2022","COM","2020","3574","31","3605","2023-01-02"
"77438","2022","COM","2020","6304","74","6378","2023-01-02"
"77439","2022","COM","2020","1170","13","1183","2023-01-02"
"77440","2022","COM","2020","1138","12","1150","2023-01-02"
"77441","2022","COM","2020","2024","48","2072","2023-01-02"
"77442","2022","COM","2020","2441","62","2503","2023-01-02"
"77443","2022","COM","2020","390","8","398","2023-01-02"
"77444","2022","COM","2020","324","6","330","2023-01-02"
"77445","2022","COM","2020","30169","235","30404","2023-01-02"
"77446","2022","COM","2020","598","9","607","2023-01-02"
"77447","2022","COM","2020","1835","48","1883","2023-01-02"
"77448","2022","COM","2020","547","9","556","2023-01-02"
"77449","2022","COM","2020","9699","90","9789","2023-01-02"
"77450","2022","COM","2020","3308","51","3359","2023-01-02"
"77451","2022","COM","2020","584","6","590","2023-01-02"
"77452","2022","COM","2020","66","0","66","2023-01-02"
"77453","2022","COM","2020","1136","14","1150","2023-01-02"
"77454","2022","COM","2020","367","5","372","2023-01-02"
"77455","2022","COM","2020","2038","31","2069","2023-01-02"
"77456","2022","COM","2020","823","19","842","2023-01-02"
"77457","2022","COM","2020","1212","23","1235","2023-01-02"
"77458","2022","COM","2020","5253","99","5352","2023-01-02"
"77459","2022","COM","2020","1519","393","1912","2023-01-02"
"77460","2022","COM","2020","338","4","342","2023-01-02"
"77461","2022","COM","2020","299","6","305","2023-01-02"
"77462","2022","COM","2020","893","2","895","2023-01-02"
"77463","2022","COM","2020","3419","112","3531","2023-01-02"
"77464","2022","COM","2020","10427","106","10533","2023-01-02"
"77465","2022","COM","2020","646","9","655","2023-01-02"
"77466","2022","COM","2020","378","3","381","2023-01-02"
"77467","2022","COM","2020","203","0","203","2023-01-02"
"77468","2022","COM","2020","22500","104","22604","2023-01-02"
"77469","2022","COM","2020","1224","12","1236","2023-01-02"
"77470","2022","COM","2020","8429","104","8533","2023-01-02"
"77471","2022","COM","2020","349","8","357","2023-01-02"
"77472","2022","COM","2020","492","7","499","2023-01-02"
"77473","2022","COM","2020","404","7","411","2023-01-02"
"77474","2022","COM","2020","666","5","671","2023-01-02"
"77475","2022","COM","2020","5020","31","5051","2023-01-02"
"77476","2022","COM","2020","230","2","232","2023-01-02"
"77477","2022","COM","2020","855","30","885","2023-01-02"
"77478","2022","COM","2020","1085","7","1092","2023-01-02"
"77479","2022","COM","2020","13340","110","13450","2023-01-02"
"77480","2022","COM","2020","1056","9","1065","2023-01-02"
"77481","2022","COM","2020","188","2","190","2023-01-02"
"77482","2022","COM","2020","3660","72","3732","2023-01-02"
"77483","2022","COM","2020","2077","17","2094","2023-01-02"
"77484","2022","COM","2020","284","6","290","2023-01-02"
"77485","2022","COM","2020","730","13","743","2023-01-02"
"77486","2022","COM","2020","893","16","909","2023-01-02"
"77487","2022","COM","2020","11102","152","11254","2023-01-02"
"77489","2022","COM","2020","237","2","239","2023-01-02"
"77490","2022","COM","2020","689","9","698","2023-01-02"
"77492","2022","COM","2020","641","4","645","2023-01-02"
"77493","2022","COM","2020","3186","22","3208","2023-01-02"
"77494","2022","COM","2020","2630","37","2667","2023-01-02"
"77495","2022","COM","2020","8564","85","8649","2023-01-02"
"77496","2022","COM","2020","189","4","193","2023-01-02"
"77498","2022","COM","2020","313","5","318","2023-01-02"
"77500","2022","COM","2020","463","11","474","2023-01-02"
"77501","2022","COM","2020","720","14","734","2023-01-02"
"77504","2022","COM","2020","1096","23","1119","2023-01-02"
"77505","2022","COM","2020","381","5","386","2023-01-02"
"77506","2022","COM","2020","789","10","799","2023-01-02"
"77507","2022","COM","2020","424","7","431","2023-01-02"
"77508","2022","COM","2020","1862","37","1899","2023-01-02"
"77509","2022","COM","2020","615","6","621","2023-01-02"
"77510","2022","COM","2020","1193","5","1198","2023-01-02"
"77511","2022","COM","2020","645","0","645","2023-01-02"
"77512","2022","COM","2020","1128","12","1140","2023-01-02"
"77513","2022","COM","2020","4982","31","5013","2023-01-02"
"77514","2022","COM","2020","26700","97","26797","2023-01-02"
"77515","2022","COM","2020","701","5","706","2023-01-02"
"77516","2022","COM","2020","845","10","855","2023-01-02"
"77517","2022","COM","2020","2135","13","2148","2023-01-02"
"77518","2022","COM","2020","234","6","240","2023-01-02"
"77519","2022","COM","2020","1168","26","1194","2023-01-02"
"77520","2022","COM","2020","659","19","678","2023-01-02"
"77521","2022","COM","2020","1928","44","1972","2023-01-02"
"77522","2022","COM","2020","297","5","302","2023-01-02"
"77523","2022","COM","2020","258","3","261","2023-01-02"
"77524","2022","COM","2020","522","6","528","2023-01-02"
"77525","2022","COM","2020","382","1","383","2023-01-02"
"77526","2022","COM","2020","276","5","281","2023-01-02"
"77527","2022","COM","2020","583","17","600","2023-01-02"
"77528","2022","COM","2020","1168","16","1184","2023-01-02"
"77529","2022","COM","2020","1490","30","1520","2023-01-02"
"77530","2022","COM","2020","310","5","315","2023-01-02"
"77531","2022","COM","2020","1645","23","1668","2023-01-02"
"77532","2022","COM","2020","65","0","65","2023-01-02"
"77533","2022","COM","2020","2743","60","2803","2023-01-02"
"77534","2022","COM","2020","949","1","950","2023-01-02"
"78003","2022","COM","2020","3509","48","3557","2023-01-02"
"78005","2022","COM","2020","21660","152","21812","2023-01-02"
"78006","2022","COM","2020","654","16","670","2023-01-02"
"78007","2022","COM","2020","1085","37","1122","2023-01-02"
"78009","2022","COM","2020","286","6","292","2023-01-02"
"78010","2022","COM","2020","1215","38","1253","2023-01-02"
"78013","2022","COM","2020","482","4","486","2023-01-02"
"78015","2022","COM","2020","13236","149","13385","2023-01-02"
"78020","2022","COM","2020","940","14","954","2023-01-02"
"78029","2022","COM","2020","12082","82","12164","2023-01-02"
"78030","2022","COM","2020","1970","47","2017","2023-01-02"
"78031","2022","COM","2020","650","10","660","2023-01-02"
"78033","2022","COM","2020","1143","24","1167","2023-01-02"
"78034","2022","COM","2020","976","19","995","2023-01-02"
"78036","2022","COM","2020","612","7","619","2023-01-02"
"78043","2022","COM","2020","3692","137","3829","2023-01-02"
"78048","2022","COM","2020","1460","41","1501","2023-01-02"
"78049","2022","COM","2020","1682","46","1728","2023-01-02"
"78050","2022","COM","2020","650","10","660","2023-01-02"
"78053","2022","COM","2020","488","13","501","2023-01-02"
"78057","2022","COM","2020","1882","21","1903","2023-01-02"
"78062","2022","COM","2020","7585","112","7697","2023-01-02"
"78068","2022","COM","2020","892","27","919","2023-01-02"
"78070","2022","COM","2020","287","5","292","2023-01-02"
"78071","2022","COM","2020","607","10","617","2023-01-02"
"78072","2022","COM","2020","250","2","252","2023-01-02"
"78073","2022","COM","2020","15028","156","15184","2023-01-02"
"78076","2022","COM","2020","280","4","284","2023-01-02"
"78077","2022","COM","2020","756","57","813","2023-01-02"
"78082","2022","COM","2020","625","11","636","2023-01-02"
"78084","2022","COM","2020","640","13","653","2023-01-02"
"78087","2022","COM","2020","2095","49","2144","2023-01-02"
"78089","2022","COM","2020","4882","42","4924","2023-01-02"
"78090","2022","COM","2020","2204","25","2229","2023-01-02"
"78092","2022","COM","2020","8983","144","9127","2023-01-02"
"78096","2022","COM","2020","502","14","516","2023-01-02"
"78104","2022","COM","2020","754","13","767","2023-01-02"
"78107","2022","COM","2020","1901","28","1929","2023-01-02"
"78108","2022","COM","2020","1305","29","1334","2023-01-02"
"78113","2022","COM","2020","698","14","712","2023-01-02"
"78117","2022","COM","2020","5972","125","6097","2023-01-02"
"78118","2022","COM","2020","3315","19","3334","2023-01-02"
"78120","2022","COM","2020","1915","63","1978","2023-01-02"
"78123","2022","COM","2020","17417","125","17542","2023-01-02"
"78124","2022","COM","2020","15115","220","15335","2023-01-02"
"78125","2022","COM","2020","831","31","862","2023-01-02"
"78126","2022","COM","2020","20496","393","20889","2023-01-02"
"78128","2022","COM","2020","1546","38","1584","2023-01-02"
"78133","2022","COM","2020","5646","150","5796","2023-01-02"
"78138","2022","COM","2020","10730","65","10795","2023-01-02"
"78140","2022","COM","2020","1336","25","1361","2023-01-02"
"78143","2022","COM","2020","1467","39","1506","2023-01-02"
"78146","2022","COM","2020","29709","481","30190","2023-01-02"
"78147","2022","COM","2020","478","7","485","2023-01-02"
"78152","2022","COM","2020","1743","74","1817","2023-01-02"
"78158","2022","COM","2020","31057","650","31707","2023-01-02"
"78160","2022","COM","2020","5572","136","5708","2023-01-02"
"78162","2022","COM","2020","540","26","566","2023-01-02"
"78163","2022","COM","2020","344","10","354","2023-01-02"
"78164","2022","COM","2020","829","65","894","2023-01-02"
"78165","2022","COM","2020","17378","246","17624","2023-01-02"
"78168","2022","COM","2020","4375","33","4408","2023-01-02"
"78171","2022","COM","2020","1255","27","1282","2023-01-02"
"78172","2022","COM","2020","35957","415","36372","2023-01-02"
"78185","2022","COM","2020","366","11","377","2023-01-02"
"78188","2022","COM","2020","410","6","416","2023-01-02"
"78189","2022","COM","2020","1700","64","1764","2023-01-02"
"78190","2022","COM","2020","10324","300","10624","2023-01-02"
"78192","2022","COM","2020","1381","15","1396","2023-01-02"
"78193","2022","COM","2020","1012","17","1029","2023-01-02"
"78194","2022","COM","2020","217","3","220","2023-01-02"
"78196","2022","COM","2020","286","14","300","2023-01-02"
"78202","2022","COM","2020","561","8","569","2023-01-02"
"78206","2022","COM","2020","4124","44","4168","2023-01-02"
"78208","2022","COM","2020","25857","260","26117","2023-01-02"
"78209","2022","COM","2020","890","13","903","2023-01-02"
"78217","2022","COM","2020","6625","91","6716","2023-01-02"
"78220","2022","COM","2020","6737","140","6877","2023-01-02"
"78224","2022","COM","2020","4430","183","4613","2023-01-02"
"78227","2022","COM","2020","782","5","787","2023-01-02"
"78230","2022","COM","2020","617","8","625","2023-01-02"
"78231","2022","COM","2020","154","6","160","2023-01-02"
"78233","2022","COM","2020","3001","89","3090","2023-01-02"
"78234","2022","COM","2020","186","0","186","2023-01-02"
"78236","2022","COM","2020","579","9","588","2023-01-02"
"78237","2022","COM","2020","155","2","157","2023-01-02"
"78238","2022","COM","2020","2439","30","2469","2023-01-02"
"78239","2022","COM","2020","2167","29","2196","2023-01-02"
"78242","2022","COM","2020","13518","164","13682","2023-01-02"
"78245","2022","COM","2020","401","13","414","2023-01-02"
"78246","2022","COM","2020","950","18","968","2023-01-02"
"78255","2022","COM","2020","4262","58","4320","2023-01-02"
"78261","2022","COM","2020","670","12","682","2023-01-02"
"78262","2022","COM","2020","1246","17","1263","2023-01-02"
"78263","2022","COM","2020","2469","64","2533","2023-01-02"
"78264","2022","COM","2020","60","2","62","2023-01-02"
"78265","2022","COM","2020","2447","45","2492","2023-01-02"
"78267","2022","COM","2020","7878","55","7933","2023-01-02"
"78269","2022","COM","2020","1295","30","1325","2023-01-02"
"78276","2022","COM","2020","656","8","664","2023-01-02"
"78278","2022","COM","2020","530","12","542","2023-01-02"
"78281","2022","COM","2020","628","10","638","2023-01-02"
"78283","2022","COM","2020","293","10","303","2023-01-02"
"78285","2022","COM","2020","542","15","557","2023-01-02"
"78289","2022","COM","2020","892","39","931","2023-01-02"
"78290","2022","COM","2020","1075","14","1089","2023-01-02"
"78291","2022","COM","2020","2157","38","2195","2023-01-02"
"78296","2022","COM","2020","626","11","637","2023-01-02"
"78297","2022","COM","2020","29269","491","29760","2023-01-02"
"78299","2022","COM","2020","2488","20","2508","2023-01-02"
"78300","2022","COM","2020","444","10","454","2023-01-02"
"78302","2022","COM","2020","164","5","169","2023-01-02"
"78305","2022","COM","2020","242","4","246","2023-01-02"
"78307","2022","COM","2020","942","25","967","2023-01-02"
"78310","2022","COM","2020","3690","40","3730","2023-01-02"
"78311","2022","COM","2020","33250","319","33569","2023-01-02"
"78314","2022","COM","2020","3913","46","3959","2023-01-02"
"78317","2022","COM","2020","787","13","800","2023-01-02"
"78320","2022","COM","2020","704","15","719","2023-01-02"
"78321","2022","COM","2020","5803","119","5922","2023-01-02"
"78322","2022","COM","2020","7983","166","8149","2023-01-02"
"78324","2022","COM","2020","559","3","562","2023-01-02"
"78325","2022","COM","2020","607","6","613","2023-01-02"
"78327","2022","COM","2020","3912","40","3952","2023-01-02"
"78329","2022","COM","2020","786","15","801","2023-01-02"
"78334","2022","COM","2020","1604","33","1637","2023-01-02"
"78335","2022","COM","2020","17112","104","17216","2023-01-02"
"78337","2022","COM","2020","1972","33","2005","2023-01-02"
"78343","2022","COM","2020","1661","66","1727","2023-01-02"
"78344","2022","COM","2020","652","9","661","2023-01-02"
"78346","2022","COM","2020","1529","23","1552","2023-01-02"
"78349","2022","COM","2020","505","12","517","2023-01-02"
"78350","2022","COM","2020","7342","163","7505","2023-01-02"
"78354","2022","COM","2020","6138","131","6269","2023-01-02"
"78356","2022","COM","2020","9417","152","9569","2023-01-02"
"78358","2022","COM","2020","23204","496","23700","2023-01-02"
"78361","2022","COM","2020","43945","169","44114","2023-01-02"
"78362","2022","COM","2020","20844","171","21015","2023-01-02"
"78364","2022","COM","2020","768","9","777","2023-01-02"
"78366","2022","COM","2020","397","13","410","2023-01-02"
"78367","2022","COM","2020","3669","166","3835","2023-01-02"
"78368","2022","COM","2020","1705","35","1740","2023-01-02"
"78372","2022","COM","2020","16352","505","16857","2023-01-02"
"78380","2022","COM","2020","5949","233","6182","2023-01-02"
"78381","2022","COM","2020","1033","15","1048","2023-01-02"
"78382","2022","COM","2020","4384","51","4435","2023-01-02"
"78383","2022","COM","2020","18046","234","18280","2023-01-02"
"78384","2022","COM","2020","1332","43","1375","2023-01-02"
"78385","2022","COM","2020","214","3","217","2023-01-02"
"78389","2022","COM","2020","1658","49","1707","2023-01-02"
"78391","2022","COM","2020","380","7","387","2023-01-02"
"78396","2022","COM","2020","6304","110","6414","2023-01-02"
"78397","2022","COM","2020","6831","117","6948","2023-01-02"
"78398","2022","COM","2020","876","23","899","2023-01-02"
"78401","2022","COM","2020","9080","82","9162","2023-01-02"
"78402","2022","COM","2020","3776","42","3818","2023-01-02"
"78403","2022","COM","2020","2292","34","2326","2023-01-02"
"78404","2022","COM","2020","280","4","284","2023-01-02"
"78406","2022","COM","2020","283","12","295","2023-01-02"
"78407","2022","COM","2020","632","15","647","2023-01-02"
"78410","2022","COM","2020","959","15","974","2023-01-02"
"78413","2022","COM","2020","407","3","410","2023-01-02"
"78415","2022","COM","2020","502","21","523","2023-01-02"
"78416","2022","COM","2020","318","5","323","2023-01-02"
"78417","2022","COM","2020","306","6","312","2023-01-02"
"78418","2022","COM","2020","14811","265","15076","2023-01-02"
"78420","2022","COM","2020","2903","77","2980","2023-01-02"
"78423","2022","COM","2020","31854","481","32335","2023-01-02"
"78431","2022","COM","2020","3069","83","3152","2023-01-02"
"78437","2022","COM","2020","677","9","686","2023-01-02"
"78439","2022","COM","2020","108","1","109","2023-01-02"
"78440","2022","COM","2020","33543","162","33705","2023-01-02"
"78442","2022","COM","2020","3384","55","3439","2023-01-02"
"78443","2022","COM","2020","910","19","929","2023-01-02"
"78444","2022","COM","2020","839","16","855","2023-01-02"
"78451","2022","COM","2020","1054","15","1069","2023-01-02"
"78455","2022","COM","2020","7692","285","7977","2023-01-02"
"78460","2022","COM","2020","1078","17","1095","2023-01-02"
"78464","2022","COM","2020","1007","17","1024","2023-01-02"
"78465","2022","COM","2020","2467","69","2536","2023-01-02"
"78466","2022","COM","2020","6849","204","7053","2023-01-02"
"78470","2022","COM","2020","882","19","901","2023-01-02"
"78472","2022","COM","2020","328","7","335","2023-01-02"
"78474","2022","COM","2020","938","8","946","2023-01-02"
"78475","2022","COM","2020","400","9","409","2023-01-02"
"78478","2022","COM","2020","224","7","231","2023-01-02"
"78481","2022","COM","2020","15792","289","16081","2023-01-02"
"78484","2022","COM","2020","652","17","669","2023-01-02"
"78486","2022","COM","2020","6571","100","6671","2023-01-02"
"78490","2022","COM","2020","30897","346","31243","2023-01-02"
"78497","2022","COM","2020","909","41","950","2023-01-02"
"78498","2022","COM","2020","39731","318","40049","2023-01-02"
"78499","2022","COM","2020","685","21","706","2023-01-02"
"78501","2022","COM","2020","3155","58","3213","2023-01-02"
"78502","2022","COM","2020","5454","51","5505","2023-01-02"
"78505","2022","COM","2020","412","17","429","2023-01-02"
"78506","2022","COM","2020","861","7","868","2023-01-02"
"78513","2022","COM","2020","2346","33","2379","2023-01-02"
"78516","2022","COM","2020","991","13","1004","2023-01-02"
"78517","2022","COM","2020","27043","491","27534","2023-01-02"
"78518","2022","COM","2020","112","4","116","2023-01-02"
"78520","2022","COM","2020","1565","50","1615","2023-01-02"
"78522","2022","COM","2020","894","38","932","2023-01-02"
"78528","2022","COM","2020","367","3","370","2023-01-02"
"78530","2022","COM","2020","377","6","383","2023-01-02"
"78531","2022","COM","2020","6906","47","6953","2023-01-02"
"78536","2022","COM","2020","348","10","358","2023-01-02"
"78537","2022","COM","2020","5791","134","5925","2023-01-02"
"78545","2022","COM","2020","20611","633","21244","2023-01-02"
"78548","2022","COM","2020","450","12","462","2023-01-02"
"78550","2022","COM","2020","1847","37","1884","2023-01-02"
"78551","2022","COM","2020","44410","1761","46171","2023-01-02"
"78557","2022","COM","2020","966","18","984","2023-01-02"
"78558","2022","COM","2020","378","6","384","2023-01-02"
"78559","2022","COM","2020","425","5","430","2023-01-02"
"78561","2022","COM","2020","444","35","479","2023-01-02"
"78562","2022","COM","2020","1402","32","1434","2023-01-02"
"78564","2022","COM","2020","680","8","688","2023-01-02"
"78565","2022","COM","2020","303","9","312","2023-01-02"
"78567","2022","COM","2020","929","11","940","2023-01-02"
"78569","2022","COM","2020","912","18","930","2023-01-02"
"78571","2022","COM","2020","4892","208","5100","2023-01-02"
"78575","2022","COM","2020","7750","158","7908","2023-01-02"
"78576","2022","COM","2020","1647","24","1671","2023-01-02"
"78586","2022","COM","2020","51746","412","52158","2023-01-02"
"78588","2022","COM","2020","961","28","989","2023-01-02"
"78590","2022","COM","2020","503","11","514","2023-01-02"
"78591","2022","COM","2020","2310","41","2351","2023-01-02"
"78597","2022","COM","2020","698","7","705","2023-01-02"
"78601","2022","COM","2020","1580","59","1639","2023-01-02"
"78605","2022","COM","2020","1092","16","1108","2023-01-02"
"78606","2022","COM","2020","36","1","37","2023-01-02"
"78608","2022","COM","2020","121","1","122","2023-01-02"
"78609","2022","COM","2020","1024","10","1034","2023-01-02"
"78615","2022","COM","2020","1198","22","1220","2023-01-02"
"78616","2022","COM","2020","1428","28","1456","2023-01-02"
"78618","2022","COM","2020","509","14","523","2023-01-02"
"78620","2022","COM","2020","1164","38","1202","2023-01-02"
"78621","2022","COM","2020","33419","108","33527","2023-01-02"
"78623","2022","COM","2020","956","150","1106","2023-01-02"
"78624","2022","COM","2020","12360","196","12556","2023-01-02"
"78638","2022","COM","2020","5020","68","5088","2023-01-02"
"78640","2022","COM","2020","22836","184","23020","2023-01-02"
"78642","2022","COM","2020","15959","324","16283","2023-01-02"
"78643","2022","COM","2020","10266","192","10458","2023-01-02"
"78644","2022","COM","2020","6222","74","6296","2023-01-02"
"78646","2022","COM","2020","83583","1891","85474","2023-01-02"
"78647","2022","COM","2020","851","13","864","2023-01-02"
"78650","2022","COM","2020","15619","489","16108","2023-01-02"
"78653","2022","COM","2020","366","9","375","2023-01-02"
"78655","2022","COM","2020","622","26","648","2023-01-02"
"78668","2022","COM","2020","658","19","677","2023-01-02"
"78672","2022","COM","2020","5476","172","5648","2023-01-02"
"78674","2022","COM","2020","11044","195","11239","2023-01-02"
"78677","2022","COM","2020","526","18","544","2023-01-02"
"78681","2022","COM","2020","840","16","856","2023-01-02"
"78683","2022","COM","2020","2895","160","3055","2023-01-02"
"78686","2022","COM","2020","16744","345","17089","2023-01-02"
"78688","2022","COM","2020","10722","396","11118","2023-01-02"
"79001","2022","COM","2020","1062","16","1078","2023-01-02"
"79002","2022","COM","2020","310","9","319","2023-01-02"
"79003","2022","COM","2020","5359","164","5523","2023-01-02"
"79005","2022","COM","2020","3279","49","3328","2023-01-02"
"79007","2022","COM","2020","652","21","673","2023-01-02"
"79008","2022","COM","2020","822","13","835","2023-01-02"
"79009","2022","COM","2020","434","9","443","2023-01-02"
"79010","2022","COM","2020","609","6","615","2023-01-02"
"79012","2022","COM","2020","1245","31","1276","2023-01-02"
"79013","2022","COM","2020","3197","86","3283","2023-01-02"
"79014","2022","COM","2020","2609","48","2657","2023-01-02"
"79015","2022","COM","2020","192","5","197","2023-01-02"
"79016","2022","COM","2020","770","10","780","2023-01-02"
"79018","2022","COM","2020","171","4","175","2023-01-02"
"79019","2022","COM","2020","163","1","164","2023-01-02"
"79020","2022","COM","2020","886","19","905","2023-01-02"
"79022","2022","COM","2020","193","2","195","2023-01-02"
"79023","2022","COM","2020","61","1","62","2023-01-02"
"79024","2022","COM","2020","1995","94","2089","2023-01-02"
"79025","2022","COM","2020","1113","29","1142","2023-01-02"
"79029","2022","COM","2020","668","18","686","2023-01-02"
"79030","2022","COM","2020","968","55","1023","2023-01-02"
"79031","2022","COM","2020","1776","33","1809","2023-01-02"
"79032","2022","COM","2020","780","14","794","2023-01-02"
"79034","2022","COM","2020","1774","54","1828","2023-01-02"
"79038","2022","COM","2020","1186","20","1206","2023-01-02"
"79040","2022","COM","2020","233","2","235","2023-01-02"
"79042","2022","COM","2020","176","6","182","2023-01-02"
"79046","2022","COM","2020","568","12","580","2023-01-02"
"79047","2022","COM","2020","452","9","461","2023-01-02"
"79048","2022","COM","2020","5782","135","5917","2023-01-02"
"79049","2022","COM","2020","19862","984","20846","2023-01-02"
"79050","2022","COM","2020","591","16","607","2023-01-02"
"79055","2022","COM","2020","124","3","127","2023-01-02"
"79056","2022","COM","2020","740","11","751","2023-01-02"
"79057","2022","COM","2020","1440","53","1493","2023-01-02"
"79058","2022","COM","2020","775","17","792","2023-01-02"
"79059","2022","COM","2020","733","9","742","2023-01-02"
"79060","2022","COM","2020","177","3","180","2023-01-02"
"79061","2022","COM","2020","3881","79","3960","2023-01-02"
"79062","2022","COM","2020","4802","72","4874","2023-01-02"
"79063","2022","COM","2020","2035","119","2154","2023-01-02"
"79064","2022","COM","2020","823","19","842","2023-01-02"
"79066","2022","COM","2020","1753","38","1791","2023-01-02"
"79069","2022","COM","2020","1003","26","1029","2023-01-02"
"79070","2022","COM","2020","406","10","416","2023-01-02"
"79071","2022","COM","2020","467","14","481","2023-01-02"
"79074","2022","COM","2020","176","6","182","2023-01-02"
"79076","2022","COM","2020","2049","26","2075","2023-01-02"
"79077","2022","COM","2020","733","10","743","2023-01-02"
"79078","2022","COM","2020","974","22","996","2023-01-02"
"79079","2022","COM","2020","8623","221","8844","2023-01-02"
"79080","2022","COM","2020","2671","53","2724","2023-01-02"
"79081","2022","COM","2020","7155","207","7362","2023-01-02"
"79083","2022","COM","2020","2407","107","2514","2023-01-02"
"79084","2022","COM","2020","447","6","453","2023-01-02"
"79085","2022","COM","2020","133","5","138","2023-01-02"
"79086","2022","COM","2020","1929","46","1975","2023-01-02"
"79087","2022","COM","2020","554","9","563","2023-01-02"
"79088","2022","COM","2020","1688","44","1732","2023-01-02"
"79089","2022","COM","2020","161","2","163","2023-01-02"
"79090","2022","COM","2020","843","21","864","2023-01-02"
"79091","2022","COM","2020","946","24","970","2023-01-02"
"79092","2022","COM","2020","361","4","365","2023-01-02"
"79094","2022","COM","2020","943","17","960","2023-01-02"
"79095","2022","COM","2020","584","12","596","2023-01-02"
"79096","2022","COM","2020","1139","34","1173","2023-01-02"
"79100","2022","COM","2020","2266","53","2319","2023-01-02"
"79101","2022","COM","2020","2349","52","2401","2023-01-02"
"79102","2022","COM","2020","437","9","446","2023-01-02"
"79103","2022","COM","2020","2416","48","2464","2023-01-02"
"79104","2022","COM","2020","563","13","576","2023-01-02"
"79105","2022","COM","2020","465","13","478","2023-01-02"
"79106","2022","COM","2020","405","2","407","2023-01-02"
"79108","2022","COM","2020","230","1","231","2023-01-02"
"79109","2022","COM","2020","3532","100","3632","2023-01-02"
"79111","2022","COM","2020","289","4","293","2023-01-02"
"79112","2022","COM","2020","857","22","879","2023-01-02"
"79114","2022","COM","2020","1571","30","1601","2023-01-02"
"79115","2022","COM","2020","558","10","568","2023-01-02"
"79116","2022","COM","2020","1119","17","1136","2023-01-02"
"79117","2022","COM","2020","656","8","664","2023-01-02"
"79118","2022","COM","2020","283","6","289","2023-01-02"
"79119","2022","COM","2020","633","13","646","2023-01-02"
"79120","2022","COM","2020","757","13","770","2023-01-02"
"79121","2022","COM","2020","399","10","409","2023-01-02"
"79122","2022","COM","2020","533","8","541","2023-01-02"
"79123","2022","COM","2020","2284","48","2332","2023-01-02"
"79124","2022","COM","2020","109","5","114","2023-01-02"
"79125","2022","COM","2020","1824","54","1878","2023-01-02"
"79126","2022","COM","2020","435","10","445","2023-01-02"
"79127","2022","COM","2020","847","16","863","2023-01-02"
"79128","2022","COM","2020","953","30","983","2023-01-02"
"79129","2022","COM","2020","1751","31","1782","2023-01-02"
"79130","2022","COM","2020","2924","74","2998","2023-01-02"
"79131","2022","COM","2020","322","7","329","2023-01-02"
"79132","2022","COM","2020","313","5","318","2023-01-02"
"79133","2022","COM","2020","1194","24","1218","2023-01-02"
"79134","2022","COM","2020","570","14","584","2023-01-02"
"79135","2022","COM","2020","937","15","952","2023-01-02"
"79136","2022","COM","2020","907","17","924","2023-01-02"
"79137","2022","COM","2020","902","18","920","2023-01-02"
"79139","2022","COM","2020","55","2","57","2023-01-02"
"79140","2022","COM","2020","818","10","828","2023-01-02"
"79141","2022","COM","2020","207","4","211","2023-01-02"
"79142","2022","COM","2020","100","2","102","2023-01-02"
"79144","2022","COM","2020","377","6","383","2023-01-02"
"79145","2022","COM","2020","367","5","372","2023-01-02"
"79147","2022","COM","2020","731","9","740","2023-01-02"
"79148","2022","COM","2020","1977","27","2004","2023-01-02"
"79149","2022","COM","2020","137","2","139","2023-01-02"
"79150","2022","COM","2020","831","14","845","2023-01-02"
"79152","2022","COM","2020","303","5","308","2023-01-02"
"79153","2022","COM","2020","156","3","159","2023-01-02"
"79154","2022","COM","2020","386","7","393","2023-01-02"
"79156","2022","COM","2020","685","28","713","2023-01-02"
"79157","2022","COM","2020","1300","39","1339","2023-01-02"
"79158","2022","COM","2020","127","3","130","2023-01-02"
"79159","2022","COM","2020","528","4","532","2023-01-02"
"79160","2022","COM","2020","167","3","170","2023-01-02"
"79161","2022","COM","2020","637","11","648","2023-01-02"
"79162","2022","COM","2020","2689","63","2752","2023-01-02"
"79163","2022","COM","2020","510","10","520","2023-01-02"
"79164","2022","COM","2020","258","0","258","2023-01-02"
"79165","2022","COM","2020","137","5","142","2023-01-02"
"79166","2022","COM","2020","885","21","906","2023-01-02"
"79167","2022","COM","2020","225","7","232","2023-01-02"
"79170","2022","COM","2020","2893","53","2946","2023-01-02"
"79172","2022","COM","2020","1029","22","1051","2023-01-02"
"79174","2022","COM","2020","6018","301","6319","2023-01-02"
"79175","2022","COM","2020","483","11","494","2023-01-02"
"79176","2022","COM","2020","862","23","885","2023-01-02"
"79177","2022","COM","2020","193","4","197","2023-01-02"
"79179","2022","COM","2020","5070","181","5251","2023-01-02"
"79180","2022","COM","2020","311","3","314","2023-01-02"
"79183","2022","COM","2020","369","10","379","2023-01-02"
"79184","2022","COM","2020","1665","23","1688","2023-01-02"
"79185","2022","COM","2020","4683","149","4832","2023-01-02"
"79189","2022","COM","2020","1701","31","1732","2023-01-02"
"79190","2022","COM","2020","481","2","483","2023-01-02"
"79191","2022","COM","2020","58966","1879","60845","2023-01-02"
"79195","2022","COM","2020","5541","117","5658","2023-01-02"
"79196","2022","COM","2020","2367","49","2416","2023-01-02"
"79197","2022","COM","2020","95","4","99","2023-01-02"
"79198","2022","COM","2020","258","3","261","2023-01-02"
"79200","2022","COM","2020","267","3","270","2023-01-02"
"79201","2022","COM","2020","1683","18","1701","2023-01-02"
"79202","2022","COM","2020","10108","386","10494","2023-01-02"
"79203","2022","COM","2020","359","8","367","2023-01-02"
"79204","2022","COM","2020","998","38","1036","2023-01-02"
"79205","2022","COM","2020","74","3","77","2023-01-02"
"79207","2022","COM","2020","633","18","651","2023-01-02"
"79208","2022","COM","2020","1119","29","1148","2023-01-02"
"79209","2022","COM","2020","332","8","340","2023-01-02"
"79210","2022","COM","2020","1044","23","1067","2023-01-02"
"79212","2022","COM","2020","208","3","211","2023-01-02"
"79213","2022","COM","2020","2013","47","2060","2023-01-02"
"79215","2022","COM","2020","367","7","374","2023-01-02"
"79216","2022","COM","2020","2242","40","2282","2023-01-02"
"79217","2022","COM","2020","951","22","973","2023-01-02"
"79218","2022","COM","2020","192","6","198","2023-01-02"
"79220","2022","COM","2020","600","11","611","2023-01-02"
"79223","2022","COM","2020","62","2","64","2023-01-02"
"79225","2022","COM","2020","380","6","386","2023-01-02"
"79226","2022","COM","2020","273","5","278","2023-01-02"
"79229","2022","COM","2020","538","14","552","2023-01-02"
"79230","2022","COM","2020","844","10","854","2023-01-02"
"79231","2022","COM","2020","710","15","725","2023-01-02"
"79235","2022","COM","2020","1408","41","1449","2023-01-02"
"79236","2022","COM","2020","647","15","662","2023-01-02"
"79238","2022","COM","2020","547","15","562","2023-01-02"
"79239","2022","COM","2020","1688","136","1824","2023-01-02"
"79241","2022","COM","2020","571","11","582","2023-01-02"
"79242","2022","COM","2020","1123","20","1143","2023-01-02"
"79243","2022","COM","2020","282","0","282","2023-01-02"
"79244","2022","COM","2020","371","4","375","2023-01-02"
"79246","2022","COM","2020","604","13","617","2023-01-02"
"79249","2022","COM","2020","2150","62","2212","2023-01-02"
"79250","2022","COM","2020","405","4","409","2023-01-02"
"79251","2022","COM","2020","737","29","766","2023-01-02"
"79252","2022","COM","2020","342","12","354","2023-01-02"
"79253","2022","COM","2020","692","13","705","2023-01-02"
"79254","2022","COM","2020","445","8","453","2023-01-02"
"79255","2022","COM","2020","402","3","405","2023-01-02"
"79256","2022","COM","2020","242","5","247","2023-01-02"
"79257","2022","COM","2020","1523","22","1545","2023-01-02"
"79258","2022","COM","2020","427","14","441","2023-01-02"
"79259","2022","COM","2020","1355","31","1386","2023-01-02"
"79263","2022","COM","2020","610","10","620","2023-01-02"
"79265","2022","COM","2020","1260","23","1283","2023-01-02"
"79267","2022","COM","2020","320","4","324","2023-01-02"
"79268","2022","COM","2020","996","38","1034","2023-01-02"
"79269","2022","COM","2020","419","5","424","2023-01-02"
"79270","2022","COM","2020","7243","134","7377","2023-01-02"
"79271","2022","COM","2020","373","2","375","2023-01-02"
"79273","2022","COM","2020","802","23","825","2023-01-02"
"79274","2022","COM","2020","301","4","305","2023-01-02"
"79276","2022","COM","2020","1072","32","1104","2023-01-02"
"79277","2022","COM","2020","1069","17","1086","2023-01-02"
"79278","2022","COM","2020","243","3","246","2023-01-02"
"79280","2022","COM","2020","881","15","896","2023-01-02"
"79281","2022","COM","2020","1308","36","1344","2023-01-02"
"79283","2022","COM","2020","1331","31","1362","2023-01-02"
"79284","2022","COM","2020","777","10","787","2023-01-02"
"79285","2022","COM","2020","1855","41","1896","2023-01-02"
"79286","2022","COM","2020","459","13","472","2023-01-02"
"79289","2022","COM","2020","1428","28","1456","2023-01-02"
"79290","2022","COM","2020","948","25","973","2023-01-02"
"79293","2022","COM","2020","1115","33","1148","2023-01-02"
"79294","2022","COM","2020","167","5","172","2023-01-02"
"79295","2022","COM","2020","711","18","729","2023-01-02"
"79297","2022","COM","2020","350","7","357","2023-01-02"
"79298","2022","COM","2020","1975","56","2031","2023-01-02"
"79299","2022","COM","2020","2397","47","2444","2023-01-02"
"79300","2022","COM","2020","1385","30","1415","2023-01-02"
"79301","2022","COM","2020","620","19","639","2023-01-02"
"79302","2022","COM","2020","1355","33","1388","2023-01-02"
"79303","2022","COM","2020","326","7","333","2023-01-02"
"79304","2022","COM","2020","765","50","815","2023-01-02"
"79306","2022","COM","2020","189","2","191","2023-01-02"
"79307","2022","COM","2020","1505","26","1531","2023-01-02"
"79308","2022","COM","2020","646","9","655","2023-01-02"
"79309","2022","COM","2020","347","7","354","2023-01-02"
"79310","2022","COM","2020","498","13","511","2023-01-02"
"79311","2022","COM","2020","1790","80","1870","2023-01-02"
"79312","2022","COM","2020","117","3","120","2023-01-02"
"79313","2022","COM","2020","632","15","647","2023-01-02"
"79316","2022","COM","2020","431","14","445","2023-01-02"
"79319","2022","COM","2020","862","28","890","2023-01-02"
"79320","2022","COM","2020","659","12","671","2023-01-02"
"79322","2022","COM","2020","1989","59","2048","2023-01-02"
"79326","2022","COM","2020","1408","27","1435","2023-01-02"
"79329","2022","COM","2020","13917","308","14225","2023-01-02"
"79331","2022","COM","2020","127","6","133","2023-01-02"
"79332","2022","COM","2020","122","4","126","2023-01-02"
"79334","2022","COM","2020","1077","21","1098","2023-01-02"
"79335","2022","COM","2020","790","20","810","2023-01-02"
"79336","2022","COM","2020","229","2","231","2023-01-02"
"79337","2022","COM","2020","864","24","888","2023-01-02"
"79338","2022","COM","2020","258","0","258","2023-01-02"
"79339","2022","COM","2020","1676","29","1705","2023-01-02"
"79340","2022","COM","2020","322","6","328","2023-01-02"
"79341","2022","COM","2020","118","3","121","2023-01-02"
"79342","2022","COM","2020","573","13","586","2023-01-02"
"79343","2022","COM","2020","209","2","211","2023-01-02"
"79345","2022","COM","2020","896","23","919","2023-01-02"
"79346","2022","COM","2020","125","5","130","2023-01-02"
"79347","2022","COM","2020","1107","21","1128","2023-01-02"
"79348","2022","COM","2020","216","3","219","2023-01-02"
"79349","2022","COM","2020","146","2","148","2023-01-02"
"79350","2022","COM","2020","118","3","121","2023-01-02"
"79351","2022","COM","2020","1798","31","1829","2023-01-02"
"79352","2022","COM","2020","155","6","161","2023-01-02"
"79354","2022","COM","2020","359","10","369","2023-01-02"
"79355","2022","COM","2020","3369","99","3468","2023-01-02"
"79357","2022","COM","2020","237","2","239","2023-01-02"
"80001","2022","COM","2020","22895","423","23318","2023-01-02"
"80002","2022","COM","2020","267","3","270","2023-01-02"
"80003","2022","COM","2020","573","11","584","2023-01-02"
"80004","2022","COM","2020","502","3","505","2023-01-02"
"80005","2022","COM","2020","81","2","83","2023-01-02"
"80006","2022","COM","2020","263","4","267","2023-01-02"
"80008","2022","COM","2020","899","14","913","2023-01-02"
"80009","2022","COM","2020","1002","24","1026","2023-01-02"
"80010","2022","COM","2020","2778","39","2817","2023-01-02"
"80011","2022","COM","2020","2914","26","2940","2023-01-02"
"80013","2022","COM","2020","2331","30","2361","2023-01-02"
"80014","2022","COM","2020","57","0","57","2023-01-02"
"80015","2022","COM","2020","65","2","67","2023-01-02"
"80016","2022","COM","2020","9814","169","9983","2023-01-02"
"80017","2022","COM","2020","430","5","435","2023-01-02"
"80018","2022","COM","2020","249","5","254","2023-01-02"
"80019","2022","COM","2020","792","14","806","2023-01-02"
"80020","2022","COM","2020","774","18","792","2023-01-02"
"80021","2022","COM","2020","134167","2641","136808","2023-01-02"
"80022","2022","COM","2020","267","3","270","2023-01-02"
"80023","2022","COM","2020","283","4","287","2023-01-02"
"80024","2022","COM","2020","546","6","552","2023-01-02"
"80025","2022","COM","2020","329","3","332","2023-01-02"
"80026","2022","COM","2020","30","1","31","2023-01-02"
"80027","2022","COM","2020","30","0","30","2023-01-02"
"80028","2022","COM","2020","153","1","154","2023-01-02"
"80029","2022","COM","2020","828","23","851","2023-01-02"
"80030","2022","COM","2020","220","8","228","2023-01-02"
"80031","2022","COM","2020","773","9","782","2023-01-02"
"80032","2022","COM","2020","114","2","116","2023-01-02"
"80033","2022","COM","2020","307","3","310","2023-01-02"
"80034","2022","COM","2020","596","7","603","2023-01-02"
"80035","2022","COM","2020","77","0","77","2023-01-02"
"80036","2022","COM","2020","544","4","548","2023-01-02"
"80037","2022","COM","2020","159","1","160","2023-01-02"
"80038","2022","COM","2020","136","1","137","2023-01-02"
"80039","2022","COM","2020","1383","16","1399","2023-01-02"
"80040","2022","COM","2020","172","5","177","2023-01-02"
"80041","2022","COM","2020","147","3","150","2023-01-02"
"80042","2022","COM","2020","123","1","124","2023-01-02"
"80043","2022","COM","2020","265","11","276","2023-01-02"
"80044","2022","COM","2020","406","6","412","2023-01-02"
"80045","2022","COM","2020","161","2","163","2023-01-02"
"80046","2022","COM","2020","54","0","54","2023-01-02"
"80047","2022","COM","2020","528","5","533","2023-01-02"
"80048","2022","COM","2020","64","3","67","2023-01-02"
"80049","2022","COM","2020","155","6","161","2023-01-02"
"80050","2022","COM","2020","477","10","487","2023-01-02"
"80051","2022","COM","2020","253","3","256","2023-01-02"
"80052","2022","COM","2020","222","3","225","2023-01-02"
"80053","2022","COM","2020","69","1","70","2023-01-02"
"80054","2022","COM","2020","232","5","237","2023-01-02"
"80055","2022","COM","2020","164","1","165","2023-01-02"
"80056","2022","COM","2020","93","1","94","2023-01-02"
"80057","2022","COM","2020","76","3","79","2023-01-02"
"80058","2022","COM","2020","330","4","334","2023-01-02"
"80059","2022","COM","2020","77","1","78","2023-01-02"
"80060","2022","COM","2020","105","0","105","2023-01-02"
"80061","2022","COM","2020","183","3","186","2023-01-02"
"80062","2022","COM","2020","1452","18","1470","2023-01-02"
"80063","2022","COM","2020","973","15","988","2023-01-02"
"80064","2022","COM","2020","168","3","171","2023-01-02"
"80065","2022","COM","2020","88","3","91","2023-01-02"
"80066","2022","COM","2020","272","6","278","2023-01-02"
"80067","2022","COM","2020","191","2","193","2023-01-02"
"80068","2022","COM","2020","220","1","221","2023-01-02"
"80069","2022","COM","2020","204","0","204","2023-01-02"
"80070","2022","COM","2020","1337","53","1390","2023-01-02"
"80071","2022","COM","2020","2007","21","2028","2023-01-02"
"80073","2022","COM","2020","155","2","157","2023-01-02"
"80074","2022","COM","2020","129","1","130","2023-01-02"
"80076","2022","COM","2020","524","3","527","2023-01-02"
"80077","2022","COM","2020","317","3","320","2023-01-02"
"80078","2022","COM","2020","517","11","528","2023-01-02"
"80079","2022","COM","2020","310","4","314","2023-01-02"
"80080","2022","COM","2020","148","5","153","2023-01-02"
"80081","2022","COM","2020","89","2","91","2023-01-02"
"80082","2022","COM","2020","735","9","744","2023-01-02"
"80083","2022","COM","2020","138","4","142","2023-01-02"
"80084","2022","COM","2020","209","4","213","2023-01-02"
"80085","2022","COM","2020","37","2","39","2023-01-02"
"80086","2022","COM","2020","1054","15","1069","2023-01-02"
"80087","2022","COM","2020","240","6","246","2023-01-02"
"80088","2022","COM","2020","355","2","357","2023-01-02"
"80089","2022","COM","2020","263","1","264","2023-01-02"
"80090","2022","COM","2020","151","3","154","2023-01-02"
"80092","2022","COM","2020","747","7","754","2023-01-02"
"80093","2022","COM","2020","1074","10","1084","2023-01-02"
"80094","2022","COM","2020","458","7","465","2023-01-02"
"80095","2022","COM","2020","213","3","216","2023-01-02"
"80096","2022","COM","2020","927","17","944","2023-01-02"
"80097","2022","COM","2020","128","3","131","2023-01-02"
"80098","2022","COM","2020","107","3","110","2023-01-02"
"80099","2022","COM","2020","222","5","227","2023-01-02"
"80100","2022","COM","2020","619","4","623","2023-01-02"
"80101","2022","COM","2020","863","6","869","2023-01-02"
"80102","2022","COM","2020","384","8","392","2023-01-02"
"80103","2022","COM","2020","63","0","63","2023-01-02"
"80104","2022","COM","2020","137","3","140","2023-01-02"
"80105","2022","COM","2020","171","2","173","2023-01-02"
"80106","2022","COM","2020","173","3","176","2023-01-02"
"80107","2022","COM","2020","629","11","640","2023-01-02"
"80108","2022","COM","2020","71","0","71","2023-01-02"
"80109","2022","COM","2020","333","4","337","2023-01-02"
"80110","2022","COM","2020","474","16","490","2023-01-02"
"80112","2022","COM","2020","241","1","242","2023-01-02"
"80113","2022","COM","2020","337","7","344","2023-01-02"
"80114","2022","COM","2020","341","6","347","2023-01-02"
"80115","2022","COM","2020","284","1","285","2023-01-02"
"80116","2022","COM","2020","262","3","265","2023-01-02"
"80117","2022","COM","2020","159","5","164","2023-01-02"
"80118","2022","COM","2020","118","1","119","2023-01-02"
"80119","2022","COM","2020","409","8","417","2023-01-02"
"80120","2022","COM","2020","533","11","544","2023-01-02"
"80121","2022","COM","2020","152","3","155","2023-01-02"
"80122","2022","COM","2020","490","3","493","2023-01-02"
"80123","2022","COM","2020","373","8","381","2023-01-02"
"80124","2022","COM","2020","708","14","722","2023-01-02"
"80125","2022","COM","2020","86","0","86","2023-01-02"
"80126","2022","COM","2020","928","13","941","2023-01-02"
"80127","2022","COM","2020","833","9","842","2023-01-02"
"80128","2022","COM","2020","144","3","147","2023-01-02"
"80129","2022","COM","2020","539","13","552","2023-01-02"
"80130","2022","COM","2020","422","6","428","2023-01-02"
"80131","2022","COM","2020","3335","51","3386","2023-01-02"
"80132","2022","COM","2020","216","3","219","2023-01-02"
"80133","2022","COM","2020","230","3","233","2023-01-02"
"80134","2022","COM","2020","81","2","83","2023-01-02"
"80135","2022","COM","2020","244","6","250","2023-01-02"
"80136","2022","COM","2020","1247","11","1258","2023-01-02"
"80137","2022","COM","2020","758","4","762","2023-01-02"
"80138","2022","COM","2020","123","1","124","2023-01-02"
"80139","2022","COM","2020","44","0","44","2023-01-02"
"80140","2022","COM","2020","110","2","112","2023-01-02"
"80141","2022","COM","2020","324","1","325","2023-01-02"
"80142","2022","COM","2020","335","4","339","2023-01-02"
"80143","2022","COM","2020","103","1","104","2023-01-02"
"80144","2022","COM","2020","491","6","497","2023-01-02"
"80145","2022","COM","2020","139","1","140","2023-01-02"
"80146","2022","COM","2020","204","6","210","2023-01-02"
"80147","2022","COM","2020","333","7","340","2023-01-02"
"80148","2022","COM","2020","397","6","403","2023-01-02"
"80149","2022","COM","2020","527","11","538","2023-01-02"
"80150","2022","COM","2020","217","7","224","2023-01-02"
"80151","2022","COM","2020","304","4","308","2023-01-02"
"80152","2022","COM","2020","147","1","148","2023-01-02"
"80153","2022","COM","2020","133","0","133","2023-01-02"
"80154","2022","COM","2020","214","7","221","2023-01-02"
"80155","2022","COM","2020","297","5","302","2023-01-02"
"80156","2022","COM","2020","408","3","411","2023-01-02"
"80157","2022","COM","2020","94","5","99","2023-01-02"
"80158","2022","COM","2020","52","0","52","2023-01-02"
"80159","2022","COM","2020","279","6","285","2023-01-02"
"80160","2022","COM","2020","1208","20","1228","2023-01-02"
"80161","2022","COM","2020","208","7","215","2023-01-02"
"80162","2022","COM","2020","701","14","715","2023-01-02"
"80163","2022","COM","2020","774","12","786","2023-01-02"
"80164","2022","COM","2020","4441","53","4494","2023-01-02"
"80165","2022","COM","2020","187","3","190","2023-01-02"
"80166","2022","COM","2020","703","4","707","2023-01-02"
"80167","2022","COM","2020","334","11","345","2023-01-02"
"80168","2022","COM","2020","1086","17","1103","2023-01-02"
"80169","2022","COM","2020","64","0","64","2023-01-02"
"80170","2022","COM","2020","110","1","111","2023-01-02"
"80171","2022","COM","2020","598","21","619","2023-01-02"
"80172","2022","COM","2020","548","5","553","2023-01-02"
"80173","2022","COM","2020","530","7","537","2023-01-02"
"80174","2022","COM","2020","76","3","79","2023-01-02"
"80176","2022","COM","2020","267","4","271","2023-01-02"
"80177","2022","COM","2020","704","22","726","2023-01-02"
"80179","2022","COM","2020","222","4","226","2023-01-02"
"80180","2022","COM","2020","100","2","102","2023-01-02"
"80181","2022","COM","2020","122","0","122","2023-01-02"
"80182","2022","COM","2020","2411","32","2443","2023-01-02"
"80183","2022","COM","2020","267","5","272","2023-01-02"
"80184","2022","COM","2020","535","5","540","2023-01-02"
"80185","2022","COM","2020","285","10","295","2023-01-02"
"80186","2022","COM","2020","1997","27","2024","2023-01-02"
"80187","2022","COM","2020","664","10","674","2023-01-02"
"80188","2022","COM","2020","589","7","596","2023-01-02"
"80189","2022","COM","2020","72","1","73","2023-01-02"
"80190","2022","COM","2020","1231","18","1249","2023-01-02"
"80191","2022","COM","2020","170","5","175","2023-01-02"
"80192","2022","COM","2020","166","2","168","2023-01-02"
"80193","2022","COM","2020","145","3","148","2023-01-02"
"80194","2022","COM","2020","142","1","143","2023-01-02"
"80195","2022","COM","2020","148","2","150","2023-01-02"
"80196","2022","COM","2020","247","8","255","2023-01-02"
"80197","2022","COM","2020","29","0","29","2023-01-02"
"80198","2022","COM","2020","379","3","382","2023-01-02"
"80199","2022","COM","2020","523","10","533","2023-01-02"
"80200","2022","COM","2020","219","2","221","2023-01-02"
"80201","2022","COM","2020","49","2","51","2023-01-02"
"80202","2022","COM","2020","378","3","381","2023-01-02"
"80203","2022","COM","2020","87","2","89","2023-01-02"
"80204","2022","COM","2020","739","11","750","2023-01-02"
"80205","2022","COM","2020","900","11","911","2023-01-02"
"80206","2022","COM","2020","118","2","120","2023-01-02"
"80207","2022","COM","2020","346","4","350","2023-01-02"
"80208","2022","COM","2020","222","3","225","2023-01-02"
"80210","2022","COM","2020","144","7","151","2023-01-02"
"80211","2022","COM","2020","1815","50","1865","2023-01-02"
"80212","2022","COM","2020","6276","80","6356","2023-01-02"
"80213","2022","COM","2020","573","171","744","2023-01-02"
"80214","2022","COM","2020","314","1","315","2023-01-02"
"80215","2022","COM","2020","216","8","224","2023-01-02"
"80216","2022","COM","2020","154","2","156","2023-01-02"
"80217","2022","COM","2020","72","0","72","2023-01-02"
"80218","2022","COM","2020","147","3","150","2023-01-02"
"80219","2022","COM","2020","67","1","68","2023-01-02"
"80220","2022","COM","2020","99","3","102","2023-01-02"
"80221","2022","COM","2020","303","5","308","2023-01-02"
"80222","2022","COM","2020","1366","26","1392","2023-01-02"
"80223","2022","COM","2020","137","0","137","2023-01-02"
"80224","2022","COM","2020","124","1","125","2023-01-02"
"80225","2022","COM","2020","193","4","197","2023-01-02"
"80226","2022","COM","2020","269","5","274","2023-01-02"
"80227","2022","COM","2020","449","10","459","2023-01-02"
"80228","2022","COM","2020","1979","35","2014","2023-01-02"
"80229","2022","COM","2020","351","3","354","2023-01-02"
"80230","2022","COM","2020","303","8","311","2023-01-02"
"80231","2022","COM","2020","173","2","175","2023-01-02"
"80232","2022","COM","2020","233","5","238","2023-01-02"
"80233","2022","COM","2020","154","3","157","2023-01-02"
"80234","2022","COM","2020","773","15","788","2023-01-02"
"80235","2022","COM","2020","1184","19","1203","2023-01-02"
"80236","2022","COM","2020","566","5","571","2023-01-02"
"80237","2022","COM","2020","525","10","535","2023-01-02"
"80238","2022","COM","2020","549","12","561","2023-01-02"
"80239","2022","COM","2020","55","2","57","2023-01-02"
"80240","2022","COM","2020","1388","43","1431","2023-01-02"
"80241","2022","COM","2020","1059","11","1070","2023-01-02"
"80242","2022","COM","2020","407","9","416","2023-01-02"
"80243","2022","COM","2020","43","0","43","2023-01-02"
"80244","2022","COM","2020","173","3","176","2023-01-02"
"80245","2022","COM","2020","303","3","306","2023-01-02"
"80246","2022","COM","2020","346","5","351","2023-01-02"
"80247","2022","COM","2020","718","6","724","2023-01-02"
"80248","2022","COM","2020","427","7","434","2023-01-02"
"80249","2022","COM","2020","310","9","319","2023-01-02"
"80250","2022","COM","2020","348","4","352","2023-01-02"
"80251","2022","COM","2020","359","8","367","2023-01-02"
"80252","2022","COM","2020","251","1","252","2023-01-02"
"80253","2022","COM","2020","5870","172","6042","2023-01-02"
"80256","2022","COM","2020","1620","9","1629","2023-01-02"
"80258","2022","COM","2020","85","3","88","2023-01-02"
"80259","2022","COM","2020","86","1","87","2023-01-02"
"80260","2022","COM","2020","931","24","955","2023-01-02"
"80261","2022","COM","2020","1452","58","1510","2023-01-02"
"80262","2022","COM","2020","376","13","389","2023-01-02"
"80263","2022","COM","2020","48","2","50","2023-01-02"
"80264","2022","COM","2020","85","33","118","2023-01-02"
"80265","2022","COM","2020","563","7","570","2023-01-02"
"80266","2022","COM","2020","311","0","311","2023-01-02"
"80267","2022","COM","2020","269","5","274","2023-01-02"
"80268","2022","COM","2020","525","14","539","2023-01-02"
"80269","2022","COM","2020","112","2","114","2023-01-02"
"80270","2022","COM","2020","6","0","6","2023-01-02"
"80271","2022","COM","2020","1125","15","1140","2023-01-02"
"80272","2022","COM","2020","124","2","126","2023-01-02"
"80273","2022","COM","2020","347","5","352","2023-01-02"
"80274","2022","COM","2020","1766","25","1791","2023-01-02"
"80275","2022","COM","2020","297","2","299","2023-01-02"
"80276","2022","COM","2020","287","7","294","2023-01-02"
"80278","2022","COM","2020","189","2","191","2023-01-02"
"80279","2022","COM","2020","761","10","771","2023-01-02"
"80280","2022","COM","2020","122","2","124","2023-01-02"
"80281","2022","COM","2020","173","2","175","2023-01-02"
"80282","2022","COM","2020","513","4","517","2023-01-02"
"80283","2022","COM","2020","164","0","164","2023-01-02"
"80284","2022","COM","2020","730","33","763","2023-01-02"
"80285","2022","COM","2020","261","3","264","2023-01-02"
"80287","2022","COM","2020","239","4","243","2023-01-02"
"80288","2022","COM","2020","344","1","345","2023-01-02"
"80290","2022","COM","2020","391","6","397","2023-01-02"
"80291","2022","COM","2020","268","3","271","2023-01-02"
"80292","2022","COM","2020","133","6","139","2023-01-02"
"80293","2022","COM","2020","354","3","357","2023-01-02"
"80294","2022","COM","2020","162","3","165","2023-01-02"
"80295","2022","COM","2020","593","10","603","2023-01-02"
"80296","2022","COM","2020","1175","11","1186","2023-01-02"
"80297","2022","COM","2020","40","1","41","2023-01-02"
"80298","2022","COM","2020","528","3","531","2023-01-02"
"80299","2022","COM","2020","238","1","239","2023-01-02"
"80300","2022","COM","2020","159","0","159","2023-01-02"
"80301","2022","COM","2020","278","2","280","2023-01-02"
"80302","2022","COM","2020","171","3","174","2023-01-02"
"80303","2022","COM","2020","457","6","463","2023-01-02"
"80304","2022","COM","2020","98","2","100","2023-01-02"
"80305","2022","COM","2020","472","11","483","2023-01-02"
"80306","2022","COM","2020","130","5","135","2023-01-02"
"80307","2022","COM","2020","156","2","158","2023-01-02"
"80308","2022","COM","2020","2466","43","2509","2023-01-02"
"80310","2022","COM","2020","678","3","681","2023-01-02"
"80311","2022","COM","2020","150","4","154","2023-01-02"
"80312","2022","COM","2020","280","1","281","2023-01-02"
"80313","2022","COM","2020","291","5","296","2023-01-02"
"80314","2022","COM","2020","201","3","204","2023-01-02"
"80315","2022","COM","2020","507","10","517","2023-01-02"
"80316","2022","COM","2020","1993","24","2017","2023-01-02"
"80317","2022","COM","2020","209","3","212","2023-01-02"
"80318","2022","COM","2020","3249","75","3324","2023-01-02"
"80319","2022","COM","2020","333","5","338","2023-01-02"
"80320","2022","COM","2020","157","1","158","2023-01-02"
"80321","2022","COM","2020","141","2","143","2023-01-02"
"80322","2022","COM","2020","171","0","171","2023-01-02"
"80324","2022","COM","2020","140","4","144","2023-01-02"
"80325","2022","COM","2020","52","1","53","2023-01-02"
"80326","2022","COM","2020","105","2","107","2023-01-02"
"80327","2022","COM","2020","158","4","162","2023-01-02"
"80328","2022","COM","2020","518","7","525","2023-01-02"
"80329","2022","COM","2020","174","2","176","2023-01-02"
"80330","2022","COM","2020","237","5","242","2023-01-02"
"80331","2022","COM","2020","311","13","324","2023-01-02"
"80332","2022","COM","2020","395","8","403","2023-01-02"
"80333","2022","COM","2020","1297","14","1311","2023-01-02"
"80334","2022","COM","2020","98","3","101","2023-01-02"
"80335","2022","COM","2020","240","3","243","2023-01-02"
"80336","2022","COM","2020","80","3","83","2023-01-02"
"80337","2022","COM","2020","201","3","204","2023-01-02"
"80338","2022","COM","2020","1815","17","1832","2023-01-02"
"80339","2022","COM","2020","152","4","156","2023-01-02"
"80340","2022","COM","2020","200","2","202","2023-01-02"
"80341","2022","COM","2020","393","7","400","2023-01-02"
"80342","2022","COM","2020","455","8","463","2023-01-02"
"80343","2022","COM","2020","167","2","169","2023-01-02"
"80344","2022","COM","2020","178","8","186","2023-01-02"
"80345","2022","COM","2020","519","4","523","2023-01-02"
"80346","2022","COM","2020","164","1","165","2023-01-02"
"80347","2022","COM","2020","159","2","161","2023-01-02"
"80348","2022","COM","2020","183","4","187","2023-01-02"
"80349","2022","COM","2020","132","2","134","2023-01-02"
"80350","2022","COM","2020","522","4","526","2023-01-02"
"80351","2022","COM","2020","259","2","261","2023-01-02"
"80352","2022","COM","2020","160","1","161","2023-01-02"
"80353","2022","COM","2020","157","1","158","2023-01-02"
"80354","2022","COM","2020","204","3","207","2023-01-02"
"80355","2022","COM","2020","101","2","103","2023-01-02"
"80356","2022","COM","2020","92","9","101","2023-01-02"
"80357","2022","COM","2020","230","6","236","2023-01-02"
"80358","2022","COM","2020","138","2","140","2023-01-02"
"80359","2022","COM","2020","284","9","293","2023-01-02"
"80360","2022","COM","2020","2168","39","2207","2023-01-02"
"80361","2022","COM","2020","73","4","77","2023-01-02"
"80362","2022","COM","2020","300","7","307","2023-01-02"
"80364","2022","COM","2020","697","12","709","2023-01-02"
"80365","2022","COM","2020","183","3","186","2023-01-02"
"80366","2022","COM","2020","492","4","496","2023-01-02"
"80367","2022","COM","2020","178","5","183","2023-01-02"
"80368","2022","COM","2020","4492","97","4589","2023-01-02"
"80369","2022","COM","2020","237","7","244","2023-01-02"
"80371","2022","COM","2020","94","4","98","2023-01-02"
"80372","2022","COM","2020","122","3","125","2023-01-02"
"80373","2022","COM","2020","2461","79","2540","2023-01-02"
"80374","2022","COM","2020","278","3","281","2023-01-02"
"80375","2022","COM","2020","339","7","346","2023-01-02"
"80376","2022","COM","2020","646","6","652","2023-01-02"
"80377","2022","COM","2020","399","5","404","2023-01-02"
"80378","2022","COM","2020","68","1","69","2023-01-02"
"80379","2022","COM","2020","838","1","839","2023-01-02"
"80380","2022","COM","2020","238","5","243","2023-01-02"
"80381","2022","COM","2020","38","1","39","2023-01-02"
"80383","2022","COM","2020","93","0","93","2023-01-02"
"80384","2022","COM","2020","177","1","178","2023-01-02"
"80385","2022","COM","2020","465","15","480","2023-01-02"
"80386","2022","COM","2020","178","3","181","2023-01-02"
"80387","2022","COM","2020","323","5","328","2023-01-02"
"80388","2022","COM","2020","210","2","212","2023-01-02"
"80390","2022","COM","2020","411","3","414","2023-01-02"
"80391","2022","COM","2020","90","0","90","2023-01-02"
"80392","2022","COM","2020","572","14","586","2023-01-02"
"80393","2022","COM","2020","311","6","317","2023-01-02"
"80395","2022","COM","2020","275","5","280","2023-01-02"
"80396","2022","COM","2020","371","3","374","2023-01-02"
"80397","2022","COM","2020","92","4","96","2023-01-02"
"80399","2022","COM","2020","403","3","406","2023-01-02"
"80400","2022","COM","2020","400","5","405","2023-01-02"
"80401","2022","COM","2020","126","1","127","2023-01-02"
"80402","2022","COM","2020","138","1","139","2023-01-02"
"80403","2022","COM","2020","176","1","177","2023-01-02"
"80404","2022","COM","2020","142","3","145","2023-01-02"
"80405","2022","COM","2020","421","3","424","2023-01-02"
"80406","2022","COM","2020","1295","15","1310","2023-01-02"
"80407","2022","COM","2020","139","6","145","2023-01-02"
"80408","2022","COM","2020","330","1","331","2023-01-02"
"80409","2022","COM","2020","148","4","152","2023-01-02"
"80410","2022","COM","2020","4510","85","4595","2023-01-02"
"80411","2022","COM","2020","488","6","494","2023-01-02"
"80412","2022","COM","2020","638","6","644","2023-01-02"
"80413","2022","COM","2020","89","1","90","2023-01-02"
"80414","2022","COM","2020","122","3","125","2023-01-02"
"80415","2022","COM","2020","1010","8","1018","2023-01-02"
"80416","2022","COM","2020","768","9","777","2023-01-02"
"80417","2022","COM","2020","1642","12","1654","2023-01-02"
"80418","2022","COM","2020","85","0","85","2023-01-02"
"80420","2022","COM","2020","175","1","176","2023-01-02"
"80421","2022","COM","2020","296","4","300","2023-01-02"
"80422","2022","COM","2020","574","10","584","2023-01-02"
"80423","2022","COM","2020","377","5","382","2023-01-02"
"80424","2022","COM","2020","540","18","558","2023-01-02"
"80425","2022","COM","2020","111","1","112","2023-01-02"
"80426","2022","COM","2020","436","8","444","2023-01-02"
"80427","2022","COM","2020","379","7","386","2023-01-02"
"80428","2022","COM","2020","132","2","134","2023-01-02"
"80429","2022","COM","2020","193","1","194","2023-01-02"
"80430","2022","COM","2020","191","7","198","2023-01-02"
"80431","2022","COM","2020","717","9","726","2023-01-02"
"80432","2022","COM","2020","193","1","194","2023-01-02"
"80433","2022","COM","2020","43","0","43","2023-01-02"
"80434","2022","COM","2020","192","4","196","2023-01-02"
"80435","2022","COM","2020","57","0","57","2023-01-02"
"80436","2022","COM","2020","525","13","538","2023-01-02"
"80437","2022","COM","2020","109","4","113","2023-01-02"
"80438","2022","COM","2020","508","6","514","2023-01-02"
"80439","2022","COM","2020","163","1","164","2023-01-02"
"80440","2022","COM","2020","152","3","155","2023-01-02"
"80442","2022","COM","2020","1158","11","1169","2023-01-02"
"80443","2022","COM","2020","1679","26","1705","2023-01-02"
"80444","2022","COM","2020","668","14","682","2023-01-02"
"80445","2022","COM","2020","266","3","269","2023-01-02"
"80446","2022","COM","2020","745","18","763","2023-01-02"
"80449","2022","COM","2020","65","2","67","2023-01-02"
"80450","2022","COM","2020","113","2","115","2023-01-02"
"80451","2022","COM","2020","126","0","126","2023-01-02"
"80452","2022","COM","2020","526","3","529","2023-01-02"
"80453","2022","COM","2020","140","0","140","2023-01-02"
"80455","2022","COM","2020","92","2","94","2023-01-02"
"80456","2022","COM","2020","555","10","565","2023-01-02"
"80458","2022","COM","2020","450","10","460","2023-01-02"
"80459","2022","COM","2020","104","0","104","2023-01-02"
"80460","2022","COM","2020","66","1","67","2023-01-02"
"80461","2022","COM","2020","212","4","216","2023-01-02"
"80462","2022","COM","2020","348","11","359","2023-01-02"
"80463","2022","COM","2020","706","10","716","2023-01-02"
"80464","2022","COM","2020","920","14","934","2023-01-02"
"80465","2022","COM","2020","194","4","198","2023-01-02"
"80466","2022","COM","2020","132","3","135","2023-01-02"
"80467","2022","COM","2020","190","1","191","2023-01-02"
"80468","2022","COM","2020","169","3","172","2023-01-02"
"80469","2022","COM","2020","160","1","161","2023-01-02"
"80470","2022","COM","2020","163","2","165","2023-01-02"
"80472","2022","COM","2020","168","5","173","2023-01-02"
"80473","2022","COM","2020","292","2","294","2023-01-02"
"80474","2022","COM","2020","401","3","404","2023-01-02"
"80475","2022","COM","2020","215","7","222","2023-01-02"
"80476","2022","COM","2020","359","4","363","2023-01-02"
"80477","2022","COM","2020","221","3","224","2023-01-02"
"80478","2022","COM","2020","145","2","147","2023-01-02"
"80479","2022","COM","2020","343","5","348","2023-01-02"
"80480","2022","COM","2020","113","2","115","2023-01-02"
"80481","2022","COM","2020","456","5","461","2023-01-02"
"80482","2022","COM","2020","140","2","142","2023-01-02"
"80484","2022","COM","2020","387","5","392","2023-01-02"
"80485","2022","COM","2020","1168","10","1178","2023-01-02"
"80486","2022","COM","2020","618","7","625","2023-01-02"
"80487","2022","COM","2020","77","2","79","2023-01-02"
"80488","2022","COM","2020","1550","28","1578","2023-01-02"
"80489","2022","COM","2020","5815","44","5859","2023-01-02"
"80490","2022","COM","2020","272","9","281","2023-01-02"
"80491","2022","COM","2020","75","1","76","2023-01-02"
"80493","2022","COM","2020","297","5","302","2023-01-02"
"80494","2022","COM","2020","199","3","202","2023-01-02"
"80495","2022","COM","2020","515","4","519","2023-01-02"
"80496","2022","COM","2020","152","1","153","2023-01-02"
"80497","2022","COM","2020","118","5","123","2023-01-02"
"80498","2022","COM","2020","643","5","648","2023-01-02"
"80499","2022","COM","2020","302","6","308","2023-01-02"
"80500","2022","COM","2020","513","8","521","2023-01-02"
"80501","2022","COM","2020","284","4","288","2023-01-02"
"80502","2022","COM","2020","100","2","102","2023-01-02"
"80503","2022","COM","2020","186","2","188","2023-01-02"
"80504","2022","COM","2020","76","0","76","2023-01-02"
"80505","2022","COM","2020","293","4","297","2023-01-02"
"80507","2022","COM","2020","1275","19","1294","2023-01-02"
"80508","2022","COM","2020","49","0","49","2023-01-02"
"80509","2022","COM","2020","592","6","598","2023-01-02"
"80511","2022","COM","2020","110","1","111","2023-01-02"
"80512","2022","COM","2020","832","10","842","2023-01-02"
"80513","2022","COM","2020","178","3","181","2023-01-02"
"80514","2022","COM","2020","132","1","133","2023-01-02"
"80515","2022","COM","2020","146","2","148","2023-01-02"
"80516","2022","COM","2020","191","1","192","2023-01-02"
"80517","2022","COM","2020","194","3","197","2023-01-02"
"80518","2022","COM","2020","427","3","430","2023-01-02"
"80519","2022","COM","2020","495","7","502","2023-01-02"
"80520","2022","COM","2020","188","3","191","2023-01-02"
"80521","2022","COM","2020","215","0","215","2023-01-02"
"80522","2022","COM","2020","107","2","109","2023-01-02"
"80523","2022","COM","2020","1262","22","1284","2023-01-02"
"80524","2022","COM","2020","576","7","583","2023-01-02"
"80525","2022","COM","2020","179","3","182","2023-01-02"
"80526","2022","COM","2020","153","3","156","2023-01-02"
"80527","2022","COM","2020","302","8","310","2023-01-02"
"80528","2022","COM","2020","9","0","9","2023-01-02"
"80529","2022","COM","2020","192","4","196","2023-01-02"
"80530","2022","COM","2020","604","4","608","2023-01-02"
"80531","2022","COM","2020","102","0","102","2023-01-02"
"80533","2022","COM","2020","2573","59","2632","2023-01-02"
"80535","2022","COM","2020","153","5","158","2023-01-02"
"80536","2022","COM","2020","287","3","290","2023-01-02"
"80537","2022","COM","2020","88","0","88","2023-01-02"
"80538","2022","COM","2020","117","2","119","2023-01-02"
"80540","2022","COM","2020","234","4","238","2023-01-02"
"80541","2022","COM","2020","200","3","203","2023-01-02"
"80542","2022","COM","2020","556","6","562","2023-01-02"
"80543","2022","COM","2020","117","3","120","2023-01-02"
"80544","2022","COM","2020","183","3","186","2023-01-02"
"80545","2022","COM","2020","540","7","547","2023-01-02"
"80546","2022","COM","2020","594","11","605","2023-01-02"
"80547","2022","COM","2020","206","4","210","2023-01-02"
"80548","2022","COM","2020","352","2","354","2023-01-02"
"80549","2022","COM","2020","649","15","664","2023-01-02"
"80550","2022","COM","2020","127","4","131","2023-01-02"
"80552","2022","COM","2020","1129","22","1151","2023-01-02"
"80553","2022","COM","2020","333","9","342","2023-01-02"
"80554","2022","COM","2020","961","12","973","2023-01-02"
"80555","2022","COM","2020","593","19","612","2023-01-02"
"80556","2022","COM","2020","561","13","574","2023-01-02"
"80557","2022","COM","2020","588","11","599","2023-01-02"
"80558","2022","COM","2020","219","3","222","2023-01-02"
"80559","2022","COM","2020","142","3","145","2023-01-02"
"80560","2022","COM","2020","214","1","215","2023-01-02"
"80561","2022","COM","2020","6051","101","6152","2023-01-02"
"80562","2022","COM","2020","206","2","208","2023-01-02"
"80563","2022","COM","2020","98","1","99","2023-01-02"
"80565","2022","COM","2020","83","2","85","2023-01-02"
"80566","2022","COM","2020","340","7","347","2023-01-02"
"80568","2022","COM","2020","345","4","349","2023-01-02"
"80569","2022","COM","2020","328","3","331","2023-01-02"
"80570","2022","COM","2020","3996","26","4022","2023-01-02"
"80571","2022","COM","2020","486","10","496","2023-01-02"
"80572","2022","COM","2020","369","2","371","2023-01-02"
"80573","2022","COM","2020","389","9","398","2023-01-02"
"80574","2022","COM","2020","95","1","96","2023-01-02"
"80575","2022","COM","2020","78","8","86","2023-01-02"
"80576","2022","COM","2020","323","0","323","2023-01-02"
"80577","2022","COM","2020","177","2","179","2023-01-02"
"80578","2022","COM","2020","718","10","728","2023-01-02"
"80579","2022","COM","2020","831","10","841","2023-01-02"
"80580","2022","COM","2020","255","2","257","2023-01-02"
"80582","2022","COM","2020","1010","14","1024","2023-01-02"
"80583","2022","COM","2020","289","7","296","2023-01-02"
"80584","2022","COM","2020","1072","10","1082","2023-01-02"
"80585","2022","COM","2020","2314","30","2344","2023-01-02"
"80586","2022","COM","2020","162","0","162","2023-01-02"
"80587","2022","COM","2020","83","3","86","2023-01-02"
"80588","2022","COM","2020","359","8","367","2023-01-02"
"80589","2022","COM","2020","100","0","100","2023-01-02"
"80590","2022","COM","2020","322","12","334","2023-01-02"
"80591","2022","COM","2020","149","2","151","2023-01-02"
"80592","2022","COM","2020","509","7","516","2023-01-02"
"80593","2022","COM","2020","253","3","256","2023-01-02"
"80595","2022","COM","2020","311","1","312","2023-01-02"
"80596","2022","COM","2020","218","9","227","2023-01-02"
"80597","2022","COM","2020","844","20","864","2023-01-02"
"80598","2022","COM","2020","1231","38","1269","2023-01-02"
"80599","2022","COM","2020","242","2","244","2023-01-02"
"80600","2022","COM","2020","663","9","672","2023-01-02"
"80601","2022","COM","2020","365","4","369","2023-01-02"
"80602","2022","COM","2020","130","3","133","2023-01-02"
"80603","2022","COM","2020","329","4","333","2023-01-02"
"80604","2022","COM","2020","83","3","86","2023-01-02"
"80605","2022","COM","2020","204","2","206","2023-01-02"
"80606","2022","COM","2020","1137","46","1183","2023-01-02"
"80607","2022","COM","2020","209","5","214","2023-01-02"
"80609","2022","COM","2020","424","6","430","2023-01-02"
"80611","2022","COM","2020","942","14","956","2023-01-02"
"80613","2022","COM","2020","618","16","634","2023-01-02"
"80614","2022","COM","2020","315","6","321","2023-01-02"
"80615","2022","COM","2020","433","3","436","2023-01-02"
"80616","2022","COM","2020","196","1","197","2023-01-02"
"80617","2022","COM","2020","233","3","236","2023-01-02"
"80618","2022","COM","2020","1049","14","1063","2023-01-02"
"80619","2022","COM","2020","724","8","732","2023-01-02"
"80620","2022","COM","2020","7444","184","7628","2023-01-02"
"80621","2022","COM","2020","715","11","726","2023-01-02"
"80622","2022","COM","2020","1297","14","1311","2023-01-02"
"80623","2022","COM","2020","373","7","380","2023-01-02"
"80624","2022","COM","2020","285","5","290","2023-01-02"
"80625","2022","COM","2020","1505","17","1522","2023-01-02"
"80626","2022","COM","2020","291","2","293","2023-01-02"
"80627","2022","COM","2020","816","20","836","2023-01-02"
"80628","2022","COM","2020","788","3","791","2023-01-02"
"80629","2022","COM","2020","107","2","109","2023-01-02"
"80630","2022","COM","2020","2332","38","2370","2023-01-02"
"80631","2022","COM","2020","98","3","101","2023-01-02"
"80632","2022","COM","2020","2375","36","2411","2023-01-02"
"80633","2022","COM","2020","606","9","615","2023-01-02"
"80634","2022","COM","2020","814","17","831","2023-01-02"
"80635","2022","COM","2020","1460","18","1478","2023-01-02"
"80637","2022","COM","2020","286","4","290","2023-01-02"
"80638","2022","COM","2020","110","6","116","2023-01-02"
"80639","2022","COM","2020","1290","22","1312","2023-01-02"
"80640","2022","COM","2020","265","0","265","2023-01-02"
"80642","2022","COM","2020","328","2","330","2023-01-02"
"80643","2022","COM","2020","562","6","568","2023-01-02"
"80644","2022","COM","2020","739","4","743","2023-01-02"
"80645","2022","COM","2020","556","3","559","2023-01-02"
"80646","2022","COM","2020","83","1","84","2023-01-02"
"80647","2022","COM","2020","289","3","292","2023-01-02"
"80648","2022","COM","2020","123","0","123","2023-01-02"
"80649","2022","COM","2020","1272","27","1299","2023-01-02"
"80650","2022","COM","2020","629","16","645","2023-01-02"
"80651","2022","COM","2020","263","3","266","2023-01-02"
"80652","2022","COM","2020","778","9","787","2023-01-02"
"80654","2022","COM","2020","535","18","553","2023-01-02"
"80655","2022","COM","2020","421","7","428","2023-01-02"
"80656","2022","COM","2020","1103","8","1111","2023-01-02"
"80657","2022","COM","2020","317","2","319","2023-01-02"
"80658","2022","COM","2020","143","3","146","2023-01-02"
"80659","2022","COM","2020","271","6","277","2023-01-02"
"80661","2022","COM","2020","1035","12","1047","2023-01-02"
"80662","2022","COM","2020","276","7","283","2023-01-02"
"80663","2022","COM","2020","352","7","359","2023-01-02"
"80664","2022","COM","2020","191","3","194","2023-01-02"
"80665","2022","COM","2020","122","3","125","2023-01-02"
"80666","2022","COM","2020","31","0","31","2023-01-02"
"80667","2022","COM","2020","133","2","135","2023-01-02"
"80668","2022","COM","2020","170","3","173","2023-01-02"
"80669","2022","COM","2020","343","6","349","2023-01-02"
"80670","2022","COM","2020","493","8","501","2023-01-02"
"80671","2022","COM","2020","231","7","238","2023-01-02"
"80672","2022","COM","2020","633","11","644","2023-01-02"
"80673","2022","COM","2020","178","2","180","2023-01-02"
"80674","2022","COM","2020","3623","33","3656","2023-01-02"
"80675","2022","COM","2020","132","4","136","2023-01-02"
"80676","2022","COM","2020","153","7","160","2023-01-02"
"80677","2022","COM","2020","1575","18","1593","2023-01-02"
"80678","2022","COM","2020","768","19","787","2023-01-02"
"80679","2022","COM","2020","586","5","591","2023-01-02"
"80680","2022","COM","2020","3005","26","3031","2023-01-02"
"80681","2022","COM","2020","310","8","318","2023-01-02"
"80682","2022","COM","2020","213","6","219","2023-01-02"
"80683","2022","COM","2020","102","0","102","2023-01-02"
"80684","2022","COM","2020","108","4","112","2023-01-02"
"80685","2022","COM","2020","5703","55","5758","2023-01-02"
"80686","2022","COM","2020","729","9","738","2023-01-02"
"80687","2022","COM","2020","133","2","135","2023-01-02"
"80688","2022","COM","2020","3115","90","3205","2023-01-02"
"80690","2022","COM","2020","644","8","652","2023-01-02"
"80691","2022","COM","2020","347","12","359","2023-01-02"
"80692","2022","COM","2020","1024","17","1041","2023-01-02"
"80693","2022","COM","2020","329","1","330","2023-01-02"
"80694","2022","COM","2020","350","5","355","2023-01-02"
"80695","2022","COM","2020","484","6","490","2023-01-02"
"80696","2022","COM","2020","1213","32","1245","2023-01-02"
"80697","2022","COM","2020","34","0","34","2023-01-02"
"80698","2022","COM","2020","218","4","222","2023-01-02"
"80699","2022","COM","2020","113","2","115","2023-01-02"
"80700","2022","COM","2020","878","16","894","2023-01-02"
"80701","2022","COM","2020","429","10","439","2023-01-02"
"80702","2022","COM","2020","1355","28","1383","2023-01-02"
"80703","2022","COM","2020","210","5","215","2023-01-02"
"80704","2022","COM","2020","383","5","388","2023-01-02"
"80705","2022","COM","2020","79","1","80","2023-01-02"
"80706","2022","COM","2020","1840","15","1855","2023-01-02"
"80707","2022","COM","2020","77","3","80","2023-01-02"
"80708","2022","COM","2020","156","1","157","2023-01-02"
"80709","2022","COM","2020","272","7","279","2023-01-02"
"80710","2022","COM","2020","395","6","401","2023-01-02"
"80711","2022","COM","2020","1788","14","1802","2023-01-02"
"80713","2022","COM","2020","281","5","286","2023-01-02"
"80714","2022","COM","2020","1275","33","1308","2023-01-02"
"80716","2022","COM","2020","1260","31","1291","2023-01-02"
"80717","2022","COM","2020","987","6","993","2023-01-02"
"80718","2022","COM","2020","1321","16","1337","2023-01-02"
"80719","2022","COM","2020","51","5","56","2023-01-02"
"80721","2022","COM","2020","2435","39","2474","2023-01-02"
"80722","2022","COM","2020","485","7","492","2023-01-02"
"80723","2022","COM","2020","244","4","248","2023-01-02"
"80724","2022","COM","2020","2787","29","2816","2023-01-02"
"80725","2022","COM","2020","4011","55","4066","2023-01-02"
"80726","2022","COM","2020","265","4","269","2023-01-02"
"80728","2022","COM","2020","76","0","76","2023-01-02"
"80729","2022","COM","2020","182","0","182","2023-01-02"
"80730","2022","COM","2020","1067","9","1076","2023-01-02"
"80732","2022","COM","2020","627","15","642","2023-01-02"
"80733","2022","COM","2020","313","3","316","2023-01-02"
"80734","2022","COM","2020","208","3","211","2023-01-02"
"80735","2022","COM","2020","167","2","169","2023-01-02"
"80736","2022","COM","2020","217","5","222","2023-01-02"
"80737","2022","COM","2020","161","1","162","2023-01-02"
"80738","2022","COM","2020","126","3","129","2023-01-02"
"80740","2022","COM","2020","349","2","351","2023-01-02"
"80741","2022","COM","2020","191","4","195","2023-01-02"
"80742","2022","COM","2020","69","2","71","2023-01-02"
"80743","2022","COM","2020","193","4","197","2023-01-02"
"80744","2022","COM","2020","56","2","58","2023-01-02"
"80746","2022","COM","2020","1074","22","1096","2023-01-02"
"80747","2022","COM","2020","135","3","138","2023-01-02"
"80748","2022","COM","2020","192","3","195","2023-01-02"
"80749","2022","COM","2020","321","4","325","2023-01-02"
"80750","2022","COM","2020","145","1","146","2023-01-02"
"80751","2022","COM","2020","582","6","588","2023-01-02"
"80752","2022","COM","2020","675","8","683","2023-01-02"
"80753","2022","COM","2020","124","2","126","2023-01-02"
"80754","2022","COM","2020","394","9","403","2023-01-02"
"80755","2022","COM","2020","145","1","146","2023-01-02"
"80756","2022","COM","2020","64","0","64","2023-01-02"
"80757","2022","COM","2020","144","2","146","2023-01-02"
"80758","2022","COM","2020","208","1","209","2023-01-02"
"80759","2022","COM","2020","346","9","355","2023-01-02"
"80760","2022","COM","2020","370","9","379","2023-01-02"
"80762","2022","COM","2020","343","4","347","2023-01-02"
"80763","2022","COM","2020","352","8","360","2023-01-02"
"80764","2022","COM","2020","299","7","306","2023-01-02"
"80765","2022","COM","2020","806","10","816","2023-01-02"
"80766","2022","COM","2020","434","5","439","2023-01-02"
"80767","2022","COM","2020","248","5","253","2023-01-02"
"80769","2022","COM","2020","224","0","224","2023-01-02"
"80770","2022","COM","2020","540","9","549","2023-01-02"
"80771","2022","COM","2020","30","0","30","2023-01-02"
"80773","2022","COM","2020","106","0","106","2023-01-02"
"80774","2022","COM","2020","290","3","293","2023-01-02"
"80775","2022","COM","2020","626","5","631","2023-01-02"
"80776","2022","COM","2020","218","1","219","2023-01-02"
"80777","2022","COM","2020","138","1","139","2023-01-02"
"80778","2022","COM","2020","125","4","129","2023-01-02"
"80779","2022","COM","2020","835","25","860","2023-01-02"
"80780","2022","COM","2020","411","5","416","2023-01-02"
"80781","2022","COM","2020","220","5","225","2023-01-02"
"80782","2022","COM","2020","424","7","431","2023-01-02"
"80783","2022","COM","2020","82","1","83","2023-01-02"
"80784","2022","COM","2020","295","2","297","2023-01-02"
"80785","2022","COM","2020","542","9","551","2023-01-02"
"80786","2022","COM","2020","146","3","149","2023-01-02"
"80787","2022","COM","2020","96","1","97","2023-01-02"
"80788","2022","COM","2020","175","2","177","2023-01-02"
"80789","2022","COM","2020","157","0","157","2023-01-02"
"80790","2022","COM","2020","168","3","171","2023-01-02"
"80791","2022","COM","2020","775","5","780","2023-01-02"
"80792","2022","COM","2020","246","4","250","2023-01-02"
"80793","2022","COM","2020","2323","36","2359","2023-01-02"
"80794","2022","COM","2020","54","0","54","2023-01-02"
"80795","2022","COM","2020","466","42","508","2023-01-02"
"80796","2022","COM","2020","178","5","183","2023-01-02"
"80797","2022","COM","2020","139","3","142","2023-01-02"
"80798","2022","COM","2020","1435","53","1488","2023-01-02"
"80799","2022","COM","2020","4637","56","4693","2023-01-02"
"80800","2022","COM","2020","139","7","146","2023-01-02"
"80801","2022","COM","2020","312","4","316","2023-01-02"
"80802","2022","COM","2020","554","9","563","2023-01-02"
"80803","2022","COM","2020","276","0","276","2023-01-02"
"80804","2022","COM","2020","181","5","186","2023-01-02"
"80805","2022","COM","2020","154","6","160","2023-01-02"
"80806","2022","COM","2020","469","8","477","2023-01-02"
"80807","2022","COM","2020","261","3","264","2023-01-02"
"80808","2022","COM","2020","501","9","510","2023-01-02"
"80809","2022","COM","2020","476","11","487","2023-01-02"
"80810","2022","COM","2020","135","1","136","2023-01-02"
"80811","2022","COM","2020","586","7","593","2023-01-02"
"80812","2022","COM","2020","137","2","139","2023-01-02"
"80813","2022","COM","2020","96","2","98","2023-01-02"
"80814","2022","COM","2020","452","9","461","2023-01-02"
"80815","2022","COM","2020","834","25","859","2023-01-02"
"80819","2022","COM","2020","83","2","85","2023-01-02"
"80820","2022","COM","2020","750","14","764","2023-01-02"
"80821","2022","COM","2020","221","2","223","2023-01-02"
"80822","2022","COM","2020","139","2","141","2023-01-02"
"80823","2022","COM","2020","126","9","135","2023-01-02"
"80824","2022","COM","2020","264","3","267","2023-01-02"
"80825","2022","COM","2020","112","1","113","2023-01-02"
"80826","2022","COM","2020","779","18","797","2023-01-02"
"80827","2022","COM","2020","1224","14","1238","2023-01-02"
"80828","2022","COM","2020","60","1","61","2023-01-02"
"80829","2022","COM","2020","90","2","92","2023-01-02"
"80830","2022","COM","2020","245","4","249","2023-01-02"
"80832","2022","COM","2020","305","4","309","2023-01-02"
"80833","2022","COM","2020","124","2","126","2023-01-02"
"80834","2022","COM","2020","512","42","554","2023-01-02"
"80835","2022","COM","2020","270","0","270","2023-01-02"
"80836","2022","COM","2020","226","10","236","2023-01-02"
"81001","2022","COM","2020","230","9","239","2023-01-02"
"81002","2022","COM","2020","2507","57","2564","2023-01-02"
"81003","2022","COM","2020","925","35","960","2023-01-02"
"81004","2022","COM","2020","49094","1689","50783","2023-01-02"
"81005","2022","COM","2020","515","5","520","2023-01-02"
"81006","2022","COM","2020","193","2","195","2023-01-02"
"81007","2022","COM","2020","97","2","99","2023-01-02"
"81008","2022","COM","2020","296","5","301","2023-01-02"
"81009","2022","COM","2020","69","0","69","2023-01-02"
"81010","2022","COM","2020","468","7","475","2023-01-02"
"81011","2022","COM","2020","1023","40","1063","2023-01-02"
"81012","2022","COM","2020","120","1","121","2023-01-02"
"81013","2022","COM","2020","408","8","416","2023-01-02"
"81014","2022","COM","2020","507","12","519","2023-01-02"
"81015","2022","COM","2020","74","1","75","2023-01-02"
"81016","2022","COM","2020","167","7","174","2023-01-02"
"81017","2022","COM","2020","149","2","151","2023-01-02"
"81018","2022","COM","2020","2517","52","2569","2023-01-02"
"81019","2022","COM","2020","146","4","150","2023-01-02"
"81020","2022","COM","2020","268","12","280","2023-01-02"
"81021","2022","COM","2020","5795","134","5929","2023-01-02"
"81022","2022","COM","2020","206","3","209","2023-01-02"
"81023","2022","COM","2020","208","2","210","2023-01-02"
"81024","2022","COM","2020","367","7","374","2023-01-02"
"81025","2022","COM","2020","246","9","255","2023-01-02"
"81026","2022","COM","2020","700","7","707","2023-01-02"
"81027","2022","COM","2020","155","2","157","2023-01-02"
"81028","2022","COM","2020","101","1","102","2023-01-02"
"81029","2022","COM","2020","183","5","188","2023-01-02"
"81030","2022","COM","2020","111","1","112","2023-01-02"
"81031","2022","COM","2020","848","17","865","2023-01-02"
"81032","2022","COM","2020","1123","18","1141","2023-01-02"
"81033","2022","COM","2020","2925","187","3112","2023-01-02"
"81034","2022","COM","2020","381","7","388","2023-01-02"
"81035","2022","COM","2020","226","7","233","2023-01-02"
"81036","2022","COM","2020","1272","24","1296","2023-01-02"
"81037","2022","COM","2020","1297","32","1329","2023-01-02"
"81038","2022","COM","2020","2367","66","2433","2023-01-02"
"81039","2022","COM","2020","2011","36","2047","2023-01-02"
"81040","2022","COM","2020","431","7","438","2023-01-02"
"81041","2022","COM","2020","116","1","117","2023-01-02"
"81042","2022","COM","2020","2014","43","2057","2023-01-02"
"81043","2022","COM","2020","728","12","740","2023-01-02"
"81044","2022","COM","2020","312","5","317","2023-01-02"
"81045","2022","COM","2020","367","9","376","2023-01-02"
"81046","2022","COM","2020","1528","45","1573","2023-01-02"
"81047","2022","COM","2020","220","7","227","2023-01-02"
"81048","2022","COM","2020","2580","31","2611","2023-01-02"
"81049","2022","COM","2020","357","3","360","2023-01-02"
"81050","2022","COM","2020","347","11","358","2023-01-02"
"81051","2022","COM","2020","1164","19","1183","2023-01-02"
"81052","2022","COM","2020","2126","57","2183","2023-01-02"
"81053","2022","COM","2020","334","3","337","2023-01-02"
"81054","2022","COM","2020","943","26","969","2023-01-02"
"81055","2022","COM","2020","366","4","370","2023-01-02"
"81056","2022","COM","2020","157","3","160","2023-01-02"
"81058","2022","COM","2020","233","7","240","2023-01-02"
"81059","2022","COM","2020","663","15","678","2023-01-02"
"81060","2022","COM","2020","9870","166","10036","2023-01-02"
"81061","2022","COM","2020","194","2","196","2023-01-02"
"81062","2022","COM","2020","927","20","947","2023-01-02"
"81063","2022","COM","2020","1619","35","1654","2023-01-02"
"81064","2022","COM","2020","1046","25","1071","2023-01-02"
"81065","2022","COM","2020","42394","1439","43833","2023-01-02"
"81066","2022","COM","2020","283","6","289","2023-01-02"
"81067","2022","COM","2020","471","16","487","2023-01-02"
"81068","2022","COM","2020","168","4","172","2023-01-02"
"81069","2022","COM","2020","817","39","856","2023-01-02"
"81070","2022","COM","2020","2971","56","3027","2023-01-02"
"81071","2022","COM","2020","79","3","82","2023-01-02"
"81072","2022","COM","2020","123","2","125","2023-01-02"
"81073","2022","COM","2020","180","1","181","2023-01-02"
"81074","2022","COM","2020","1614","62","1676","2023-01-02"
"81075","2022","COM","2020","501","11","512","2023-01-02"
"81076","2022","COM","2020","702","19","721","2023-01-02"
"81077","2022","COM","2020","393","9","402","2023-01-02"
"81078","2022","COM","2020","1040","15","1055","2023-01-02"
"81079","2022","COM","2020","809","33","842","2023-01-02"
"81080","2022","COM","2020","67","2","69","2023-01-02"
"81081","2022","COM","2020","1307","35","1342","2023-01-02"
"81082","2022","COM","2020","113","3","116","2023-01-02"
"81083","2022","COM","2020","244","1","245","2023-01-02"
"81084","2022","COM","2020","621","21","642","2023-01-02"
"81085","2022","COM","2020","44","1","45","2023-01-02"
"81086","2022","COM","2020","173","3","176","2023-01-02"
"81087","2022","COM","2020","364","10","374","2023-01-02"
"81088","2022","COM","2020","570","10","580","2023-01-02"
"81089","2022","COM","2020","134","5","139","2023-01-02"
"81090","2022","COM","2020","253","5","258","2023-01-02"
"81092","2022","COM","2020","926","15","941","2023-01-02"
"81093","2022","COM","2020","693","48","741","2023-01-02"
"81094","2022","COM","2020","93","4","97","2023-01-02"
"81095","2022","COM","2020","84","1","85","2023-01-02"
"81096","2022","COM","2020","419","5","424","2023-01-02"
"81097","2022","COM","2020","1334","35","1369","2023-01-02"
"81098","2022","COM","2020","719","20","739","2023-01-02"
"81099","2022","COM","2020","15245","327","15572","2023-01-02"
"81100","2022","COM","2020","401","10","411","2023-01-02"
"81101","2022","COM","2020","1272","18","1290","2023-01-02"
"81102","2022","COM","2020","287","6","293","2023-01-02"
"81103","2022","COM","2020","135","7","142","2023-01-02"
"81104","2022","COM","2020","1504","37","1541","2023-01-02"
"81105","2022","COM","2020","12914","239","13153","2023-01-02"
"81106","2022","COM","2020","625","11","636","2023-01-02"
"81108","2022","COM","2020","176","1","177","2023-01-02"
"81109","2022","COM","2020","443","7","450","2023-01-02"
"81110","2022","COM","2020","98","4","102","2023-01-02"
"81111","2022","COM","2020","76","0","76","2023-01-02"
"81112","2022","COM","2020","950","24","974","2023-01-02"
"81114","2022","COM","2020","521","11","532","2023-01-02"
"81115","2022","COM","2020","1413","25","1438","2023-01-02"
"81116","2022","COM","2020","1944","47","1991","2023-01-02"
"81117","2022","COM","2020","758","22","780","2023-01-02"
"81118","2022","COM","2020","158","4","162","2023-01-02"
"81119","2022","COM","2020","489","5","494","2023-01-02"
"81120","2022","COM","2020","6510","114","6624","2023-01-02"
"81121","2022","COM","2020","292","0","292","2023-01-02"
"81122","2022","COM","2020","77","3","80","2023-01-02"
"81123","2022","COM","2020","93","3","96","2023-01-02"
"81124","2022","COM","2020","2466","77","2543","2023-01-02"
"81125","2022","COM","2020","313","7","320","2023-01-02"
"81126","2022","COM","2020","183","8","191","2023-01-02"
"81127","2022","COM","2020","106","7","113","2023-01-02"
"81128","2022","COM","2020","1573","36","1609","2023-01-02"
"81129","2022","COM","2020","229","5","234","2023-01-02"
"81130","2022","COM","2020","1802","36","1838","2023-01-02"
"81131","2022","COM","2020","2247","45","2292","2023-01-02"
"81132","2022","COM","2020","835","12","847","2023-01-02"
"81133","2022","COM","2020","499","13","512","2023-01-02"
"81134","2022","COM","2020","57","0","57","2023-01-02"
"81135","2022","COM","2020","95","0","95","2023-01-02"
"81136","2022","COM","2020","149","3","152","2023-01-02"
"81137","2022","COM","2020","87","1","88","2023-01-02"
"81138","2022","COM","2020","558","9","567","2023-01-02"
"81139","2022","COM","2020","1706","50","1756","2023-01-02"
"81140","2022","COM","2020","10820","394","11214","2023-01-02"
"81141","2022","COM","2020","154","6","160","2023-01-02"
"81142","2022","COM","2020","894","14","908","2023-01-02"
"81143","2022","COM","2020","757","13","770","2023-01-02"
"81144","2022","COM","2020","4577","93","4670","2023-01-02"
"81145","2022","COM","2020","4693","83","4776","2023-01-02"
"81146","2022","COM","2020","237","5","242","2023-01-02"
"81147","2022","COM","2020","1122","29","1151","2023-01-02"
"81148","2022","COM","2020","81","1","82","2023-01-02"
"81149","2022","COM","2020","427","15","442","2023-01-02"
"81150","2022","COM","2020","427","13","440","2023-01-02"
"81151","2022","COM","2020","127","6","133","2023-01-02"
"81152","2022","COM","2020","320","3","323","2023-01-02"
"81154","2022","COM","2020","78","1","79","2023-01-02"
"81156","2022","COM","2020","3439","83","3522","2023-01-02"
"81157","2022","COM","2020","312","11","323","2023-01-02"
"81158","2022","COM","2020","259","6","265","2023-01-02"
"81159","2022","COM","2020","432","19","451","2023-01-02"
"81160","2022","COM","2020","355","8","363","2023-01-02"
"81161","2022","COM","2020","112","1","113","2023-01-02"
"81162","2022","COM","2020","149","2","151","2023-01-02"
"81163","2022","COM","2020","9953","408","10361","2023-01-02"
"81164","2022","COM","2020","516","10","526","2023-01-02"
"81165","2022","COM","2020","242","3","245","2023-01-02"
"81166","2022","COM","2020","94","3","97","2023-01-02"
"81167","2022","COM","2020","106","0","106","2023-01-02"
"81168","2022","COM","2020","1041","17","1058","2023-01-02"
"81169","2022","COM","2020","99","1","100","2023-01-02"
"81170","2022","COM","2020","1368","21","1389","2023-01-02"
"81171","2022","COM","2020","1534","32","1566","2023-01-02"
"81172","2022","COM","2020","60","0","60","2023-01-02"
"81173","2022","COM","2020","324","7","331","2023-01-02"
"81174","2022","COM","2020","620","10","630","2023-01-02"
"81175","2022","COM","2020","425","5","430","2023-01-02"
"81176","2022","COM","2020","104","5","109","2023-01-02"
"81177","2022","COM","2020","484","17","501","2023-01-02"
"81178","2022","COM","2020","359","13","372","2023-01-02"
"81179","2022","COM","2020","278","8","286","2023-01-02"
"81180","2022","COM","2020","255","3","258","2023-01-02"
"81181","2022","COM","2020","189","3","192","2023-01-02"
"81182","2022","COM","2020","2018","42","2060","2023-01-02"
"81183","2022","COM","2020","187","7","194","2023-01-02"
"81184","2022","COM","2020","35","0","35","2023-01-02"
"81185","2022","COM","2020","239","4","243","2023-01-02"
"81186","2022","COM","2020","257","4","261","2023-01-02"
"81187","2022","COM","2020","214","3","217","2023-01-02"
"81188","2022","COM","2020","316","3","319","2023-01-02"
"81189","2022","COM","2020","128","2","130","2023-01-02"
"81190","2022","COM","2020","548","10","558","2023-01-02"
"81191","2022","COM","2020","234","1","235","2023-01-02"
"81192","2022","COM","2020","867","12","879","2023-01-02"
"81193","2022","COM","2020","338","4","342","2023-01-02"
"81195","2022","COM","2020","689","23","712","2023-01-02"
"81196","2022","COM","2020","851","21","872","2023-01-02"
"81197","2022","COM","2020","212","4","216","2023-01-02"
"81198","2022","COM","2020","330","4","334","2023-01-02"
"81199","2022","COM","2020","178","3","181","2023-01-02"
"81200","2022","COM","2020","440","53","493","2023-01-02"
"81201","2022","COM","2020","880","20","900","2023-01-02"
"81202","2022","COM","2020","963","19","982","2023-01-02"
"81203","2022","COM","2020","541","14","555","2023-01-02"
"81204","2022","COM","2020","2181","38","2219","2023-01-02"
"81205","2022","COM","2020","190","6","196","2023-01-02"
"81206","2022","COM","2020","587","18","605","2023-01-02"
"81207","2022","COM","2020","79","29","108","2023-01-02"
"81208","2022","COM","2020","582","16","598","2023-01-02"
"81209","2022","COM","2020","2781","78","2859","2023-01-02"
"81210","2022","COM","2020","264","7","271","2023-01-02"
"81211","2022","COM","2020","494","10","504","2023-01-02"
"81212","2022","COM","2020","123","4","127","2023-01-02"
"81213","2022","COM","2020","91","2","93","2023-01-02"
"81214","2022","COM","2020","100","1","101","2023-01-02"
"81215","2022","COM","2020","644","10","654","2023-01-02"
"81216","2022","COM","2020","210","3","213","2023-01-02"
"81217","2022","COM","2020","452","11","463","2023-01-02"
"81218","2022","COM","2020","3534","82","3616","2023-01-02"
"81219","2022","COM","2020","3194","72","3266","2023-01-02"
"81220","2022","COM","2020","5748","147","5895","2023-01-02"
"81221","2022","COM","2020","234","1","235","2023-01-02"
"81222","2022","COM","2020","3501","57","3558","2023-01-02"
"81223","2022","COM","2020","57","1","58","2023-01-02"
"81224","2022","COM","2020","100","1","101","2023-01-02"
"81225","2022","COM","2020","1072","30","1102","2023-01-02"
"81227","2022","COM","2020","2185","40","2225","2023-01-02"
"81228","2022","COM","2020","468","10","478","2023-01-02"
"81229","2022","COM","2020","130","4","134","2023-01-02"
"81230","2022","COM","2020","725","13","738","2023-01-02"
"81231","2022","COM","2020","383","7","390","2023-01-02"
"81232","2022","COM","2020","626","14","640","2023-01-02"
"81233","2022","COM","2020","1730","28","1758","2023-01-02"
"81234","2022","COM","2020","87","3","90","2023-01-02"
"81235","2022","COM","2020","733","16","749","2023-01-02"
"81236","2022","COM","2020","276","9","285","2023-01-02"
"81237","2022","COM","2020","185","3","188","2023-01-02"
"81238","2022","COM","2020","1514","123","1637","2023-01-02"
"81239","2022","COM","2020","865","12","877","2023-01-02"
"81240","2022","COM","2020","102","4","106","2023-01-02"
"81242","2022","COM","2020","266","1","267","2023-01-02"
"81243","2022","COM","2020","132","2","134","2023-01-02"
"81244","2022","COM","2020","2058","32","2090","2023-01-02"
"81245","2022","COM","2020","122","6","128","2023-01-02"
"81246","2022","COM","2020","109","2","111","2023-01-02"
"81247","2022","COM","2020","208","3","211","2023-01-02"
"81248","2022","COM","2020","899","20","919","2023-01-02"
"81249","2022","COM","2020","899","17","916","2023-01-02"
"81250","2022","COM","2020","281","8","289","2023-01-02"
"81251","2022","COM","2020","928","28","956","2023-01-02"
"81252","2022","COM","2020","147","1","148","2023-01-02"
"81253","2022","COM","2020","456","7","463","2023-01-02"
"81254","2022","COM","2020","380","4","384","2023-01-02"
"81255","2022","COM","2020","525","14","539","2023-01-02"
"81256","2022","COM","2020","79","4","83","2023-01-02"
"81257","2022","COM","2020","6627","105","6732","2023-01-02"
"81258","2022","COM","2020","443","13","456","2023-01-02"
"81259","2022","COM","2020","224","1","225","2023-01-02"
"81261","2022","COM","2020","1157","19","1176","2023-01-02"
"81262","2022","COM","2020","211","2","213","2023-01-02"
"81263","2022","COM","2020","391","10","401","2023-01-02"
"81264","2022","COM","2020","89","2","91","2023-01-02"
"81265","2022","COM","2020","79","1","80","2023-01-02"
"81266","2022","COM","2020","1067","28","1095","2023-01-02"
"81267","2022","COM","2020","614","11","625","2023-01-02"
"81268","2022","COM","2020","72","4","76","2023-01-02"
"81269","2022","COM","2020","507","6","513","2023-01-02"
"81270","2022","COM","2020","168","3","171","2023-01-02"
"81271","2022","COM","2020","9480","271","9751","2023-01-02"
"81272","2022","COM","2020","219","1","220","2023-01-02"
"81273","2022","COM","2020","3630","73","3703","2023-01-02"
"81274","2022","COM","2020","832","18","850","2023-01-02"
"81275","2022","COM","2020","194","2","196","2023-01-02"
"81276","2022","COM","2020","1242","19","1261","2023-01-02"
"81277","2022","COM","2020","611","10","621","2023-01-02"
"81278","2022","COM","2020","169","2","171","2023-01-02"
"81279","2022","COM","2020","260","9","269","2023-01-02"
"81280","2022","COM","2020","261","7","268","2023-01-02"
"81281","2022","COM","2020","2006","54","2060","2023-01-02"
"81282","2022","COM","2020","34","0","34","2023-01-02"
"81283","2022","COM","2020","1123","34","1157","2023-01-02"
"81284","2022","COM","2020","1951","30","1981","2023-01-02"
"81285","2022","COM","2020","491","3","494","2023-01-02"
"81286","2022","COM","2020","599","20","619","2023-01-02"
"81287","2022","COM","2020","271","2","273","2023-01-02"
"81288","2022","COM","2020","2938","65","3003","2023-01-02"
"81289","2022","COM","2020","2627","38","2665","2023-01-02"
"81290","2022","COM","2020","166","1","167","2023-01-02"
"81291","2022","COM","2020","506","6","512","2023-01-02"
"81292","2022","COM","2020","539","19","558","2023-01-02"
"81293","2022","COM","2020","363","3","366","2023-01-02"
"81294","2022","COM","2020","1034","28","1062","2023-01-02"
"81295","2022","COM","2020","438","6","444","2023-01-02"
"81297","2022","COM","2020","1220","31","1251","2023-01-02"
"81298","2022","COM","2020","476","13","489","2023-01-02"
"81299","2022","COM","2020","378","16","394","2023-01-02"
"81300","2022","COM","2020","98","2","100","2023-01-02"
"81302","2022","COM","2020","56","1","57","2023-01-02"
"81303","2022","COM","2020","411","4","415","2023-01-02"
"81304","2022","COM","2020","190","3","193","2023-01-02"
"81305","2022","COM","2020","731","18","749","2023-01-02"
"81306","2022","COM","2020","834","23","857","2023-01-02"
"81307","2022","COM","2020","862","18","880","2023-01-02"
"81308","2022","COM","2020","1295","28","1323","2023-01-02"
"81309","2022","COM","2020","296","15","311","2023-01-02"
"81310","2022","COM","2020","157","2","159","2023-01-02"
"81311","2022","COM","2020","732","19","751","2023-01-02"
"81312","2022","COM","2020","1015","171","1186","2023-01-02"
"81313","2022","COM","2020","227","7","234","2023-01-02"
"81314","2022","COM","2020","533","38","571","2023-01-02"
"81315","2022","COM","2020","1401","47","1448","2023-01-02"
"81316","2022","COM","2020","227","3","230","2023-01-02"
"81317","2022","COM","2020","1244","20","1264","2023-01-02"
"81318","2022","COM","2020","142","2","144","2023-01-02"
"81319","2022","COM","2020","515","14","529","2023-01-02"
"81320","2022","COM","2020","147","4","151","2023-01-02"
"81321","2022","COM","2020","91","1","92","2023-01-02"
"81322","2022","COM","2020","251","6","257","2023-01-02"
"81323","2022","COM","2020","360","6","366","2023-01-02"
"81324","2022","COM","2020","239","5","244","2023-01-02"
"81325","2022","COM","2020","1976","50","2026","2023-01-02"
"81326","2022","COM","2020","399","9","408","2023-01-02"
"82001","2022","COM","2020","614","12","626","2023-01-02"
"82002","2022","COM","2020","3337","58","3395","2023-01-02"
"82003","2022","COM","2020","246","6","252","2023-01-02"
"82004","2022","COM","2020","136","0","136","2023-01-02"
"82005","2022","COM","2020","1531","19","1550","2023-01-02"
"82006","2022","COM","2020","78","2","80","2023-01-02"
"82007","2022","COM","2020","146","1","147","2023-01-02"
"82008","2022","COM","2020","910","41","951","2023-01-02"
"82009","2022","COM","2020","39","2","41","2023-01-02"
"82010","2022","COM","2020","242","5","247","2023-01-02"
"82011","2022","COM","2020","936","20","956","2023-01-02"
"82012","2022","COM","2020","571","8","579","2023-01-02"
"82013","2022","COM","2020","3778","173","3951","2023-01-02"
"82014","2022","COM","2020","262","8","270","2023-01-02"
"82015","2022","COM","2020","160","4","164","2023-01-02"
"82016","2022","COM","2020","217","2","219","2023-01-02"
"82017","2022","COM","2020","1478","25","1503","2023-01-02"
"82018","2022","COM","2020","1164","28","1192","2023-01-02"
"82019","2022","COM","2020","750","18","768","2023-01-02"
"82020","2022","COM","2020","588","13","601","2023-01-02"
"82021","2022","COM","2020","192","3","195","2023-01-02"
"82022","2022","COM","2020","380","9","389","2023-01-02"
"82023","2022","COM","2020","981","11","992","2023-01-02"
"82024","2022","COM","2020","249","3","252","2023-01-02"
"82025","2022","COM","2020","3700","104","3804","2023-01-02"
"82026","2022","COM","2020","614","11","625","2023-01-02"
"82027","2022","COM","2020","1429","23","1452","2023-01-02"
"82028","2022","COM","2020","806","11","817","2023-01-02"
"82029","2022","COM","2020","277","3","280","2023-01-02"
"82030","2022","COM","2020","491","11","502","2023-01-02"
"82031","2022","COM","2020","1212","17","1229","2023-01-02"
"82032","2022","COM","2020","540","13","553","2023-01-02"
"82033","2022","COM","2020","14131","273","14404","2023-01-02"
"82034","2022","COM","2020","107","3","110","2023-01-02"
"82035","2022","COM","2020","344","9","353","2023-01-02"
"82036","2022","COM","2020","134","5","139","2023-01-02"
"82037","2022","COM","2020","6819","203","7022","2023-01-02"
"82038","2022","COM","2020","1489","30","1519","2023-01-02"
"82039","2022","COM","2020","563","22","585","2023-01-02"
"82040","2022","COM","2020","280","9","289","2023-01-02"
"82041","2022","COM","2020","236","3","239","2023-01-02"
"82042","2022","COM","2020","1203","16","1219","2023-01-02"
"82043","2022","COM","2020","269","2","271","2023-01-02"
"82044","2022","COM","2020","1697","53","1750","2023-01-02"
"82045","2022","COM","2020","357","6","363","2023-01-02"
"82046","2022","COM","2020","115","0","115","2023-01-02"
"82047","2022","COM","2020","51","0","51","2023-01-02"
"82048","2022","COM","2020","1625","14","1639","2023-01-02"
"82049","2022","COM","2020","1032","11","1043","2023-01-02"
"82050","2022","COM","2020","1200","23","1223","2023-01-02"
"82051","2022","COM","2020","841","90","931","2023-01-02"
"82052","2022","COM","2020","1115","106","1221","2023-01-02"
"82053","2022","COM","2020","287","3","290","2023-01-02"
"82054","2022","COM","2020","386","7","393","2023-01-02"
"82055","2022","COM","2020","256","8","264","2023-01-02"
"82056","2022","COM","2020","185","3","188","2023-01-02"
"82057","2022","COM","2020","668","15","683","2023-01-02"
"82058","2022","COM","2020","101","2","103","2023-01-02"
"82059","2022","COM","2020","291","10","301","2023-01-02"
"82060","2022","COM","2020","190","4","194","2023-01-02"
"82061","2022","COM","2020","139","2","141","2023-01-02"
"82062","2022","COM","2020","1522","22","1544","2023-01-02"
"82063","2022","COM","2020","681","15","696","2023-01-02"
"82064","2022","COM","2020","125","0","125","2023-01-02"
"82065","2022","COM","2020","407","10","417","2023-01-02"
"82066","2022","COM","2020","609","13","622","2023-01-02"
"82067","2022","COM","2020","106","1","107","2023-01-02"
"82068","2022","COM","2020","243","6","249","2023-01-02"
"82069","2022","COM","2020","200","6","206","2023-01-02"
"82070","2022","COM","2020","71","2","73","2023-01-02"
"82071","2022","COM","2020","37","2","39","2023-01-02"
"82072","2022","COM","2020","1013","12","1025","2023-01-02"
"82073","2022","COM","2020","948","23","971","2023-01-02"
"82074","2022","COM","2020","131","5","136","2023-01-02"
"82075","2022","COM","2020","4187","81","4268","2023-01-02"
"82076","2022","COM","2020","1600","32","1632","2023-01-02"
"82077","2022","COM","2020","400","6","406","2023-01-02"
"82078","2022","COM","2020","128","0","128","2023-01-02"
"82079","2022","COM","2020","3803","78","3881","2023-01-02"
"82080","2022","COM","2020","1148","27","1175","2023-01-02"
"82081","2022","COM","2020","183","3","186","2023-01-02"
"82082","2022","COM","2020","195","6","201","2023-01-02"
"82083","2022","COM","2020","118","1","119","2023-01-02"
"82084","2022","COM","2020","169","2","171","2023-01-02"
"82085","2022","COM","2020","1261","11","1272","2023-01-02"
"82086","2022","COM","2020","225","3","228","2023-01-02"
"82087","2022","COM","2020","2843","61","2904","2023-01-02"
"82088","2022","COM","2020","620","6","626","2023-01-02"
"82089","2022","COM","2020","1182","20","1202","2023-01-02"
"82090","2022","COM","2020","1054","28","1082","2023-01-02"
"82091","2022","COM","2020","125","3","128","2023-01-02"
"82092","2022","COM","2020","289","4","293","2023-01-02"
"82093","2022","COM","2020","702","8","710","2023-01-02"
"82094","2022","COM","2020","1453","18","1471","2023-01-02"
"82095","2022","COM","2020","217","13","230","2023-01-02"
"82096","2022","COM","2020","3140","48","3188","2023-01-02"
"82097","2022","COM","2020","1625","18","1643","2023-01-02"
"82098","2022","COM","2020","1262","29","1291","2023-01-02"
"82099","2022","COM","2020","539","8","547","2023-01-02"
"82100","2022","COM","2020","126","7","133","2023-01-02"
"82101","2022","COM","2020","1219","17","1236","2023-01-02"
"82102","2022","COM","2020","302","4","306","2023-01-02"
"82103","2022","COM","2020","105","6","111","2023-01-02"
"82104","2022","COM","2020","183","6","189","2023-01-02"
"82105","2022","COM","2020","1344","20","1364","2023-01-02"
"82106","2022","COM","2020","137","1","138","2023-01-02"
"82107","2022","COM","2020","48","2","50","2023-01-02"
"82108","2022","COM","2020","1385","30","1415","2023-01-02"
"82109","2022","COM","2020","204","13","217","2023-01-02"
"82110","2022","COM","2020","1036","18","1054","2023-01-02"
"82111","2022","COM","2020","313","6","319","2023-01-02"
"82112","2022","COM","2020","13738","336","14074","2023-01-02"
"82113","2022","COM","2020","1215","14","1229","2023-01-02"
"82114","2022","COM","2020","647","6","653","2023-01-02"
"82115","2022","COM","2020","2014","37","2051","2023-01-02"
"82116","2022","COM","2020","193","4","197","2023-01-02"
"82117","2022","COM","2020","1300","24","1324","2023-01-02"
"82118","2022","COM","2020","97","1","98","2023-01-02"
"82119","2022","COM","2020","657","18","675","2023-01-02"
"82120","2022","COM","2020","292","5","297","2023-01-02"
"82121","2022","COM","2020","61677","1481","63158","2023-01-02"
"82122","2022","COM","2020","186","3","189","2023-01-02"
"82123","2022","COM","2020","1558","18","1576","2023-01-02"
"82124","2022","COM","2020","4238","90","4328","2023-01-02"
"82125","2022","COM","2020","6669","130","6799","2023-01-02"
"82126","2022","COM","2020","1366","104","1470","2023-01-02"
"82127","2022","COM","2020","754","18","772","2023-01-02"
"82128","2022","COM","2020","106","3","109","2023-01-02"
"82129","2022","COM","2020","149","4","153","2023-01-02"
"82130","2022","COM","2020","167","1","168","2023-01-02"
"82131","2022","COM","2020","1600","40","1640","2023-01-02"
"82132","2022","COM","2020","1175","27","1202","2023-01-02"
"82133","2022","COM","2020","90","1","91","2023-01-02"
"82134","2022","COM","2020","5740","81","5821","2023-01-02"
"82135","2022","COM","2020","1332","18","1350","2023-01-02"
"82136","2022","COM","2020","1720","24","1744","2023-01-02"
"82137","2022","COM","2020","555","11","566","2023-01-02"
"82138","2022","COM","2020","167","2","169","2023-01-02"
"82139","2022","COM","2020","121","3","124","2023-01-02"
"82140","2022","COM","2020","453","3","456","2023-01-02"
"82141","2022","COM","2020","551","4","555","2023-01-02"
"82142","2022","COM","2020","1632","24","1656","2023-01-02"
"82143","2022","COM","2020","86","0","86","2023-01-02"
"82144","2022","COM","2020","755","11","766","2023-01-02"
"82145","2022","COM","2020","373","8","381","2023-01-02"
"82146","2022","COM","2020","58","2","60","2023-01-02"
"82147","2022","COM","2020","332","10","342","2023-01-02"
"82148","2022","COM","2020","689","25","714","2023-01-02"
"82149","2022","COM","2020","1865","32","1897","2023-01-02"
"82150","2022","COM","2020","874","23","897","2023-01-02"
"82151","2022","COM","2020","401","6","407","2023-01-02"
"82152","2022","COM","2020","396","11","407","2023-01-02"
"82153","2022","COM","2020","226","1","227","2023-01-02"
"82154","2022","COM","2020","209","5","214","2023-01-02"
"82155","2022","COM","2020","1884","37","1921","2023-01-02"
"82156","2022","COM","2020","147","4","151","2023-01-02"
"82157","2022","COM","2020","101","1","102","2023-01-02"
"82158","2022","COM","2020","142","6","148","2023-01-02"
"82159","2022","COM","2020","565","17","582","2023-01-02"
"82160","2022","COM","2020","260","8","268","2023-01-02"
"82161","2022","COM","2020","3965","80","4045","2023-01-02"
"82162","2022","COM","2020","267","7","274","2023-01-02"
"82163","2022","COM","2020","51","1","52","2023-01-02"
"82164","2022","COM","2020","125","3","128","2023-01-02"
"82165","2022","COM","2020","535","4","539","2023-01-02"
"82166","2022","COM","2020","284","3","287","2023-01-02"
"82167","2022","COM","2020","1907","42","1949","2023-01-02"
"82168","2022","COM","2020","319","3","322","2023-01-02"
"82169","2022","COM","2020","2298","29","2327","2023-01-02"
"82170","2022","COM","2020","560","17","577","2023-01-02"
"82171","2022","COM","2020","1384","26","1410","2023-01-02"
"82172","2022","COM","2020","274","8","282","2023-01-02"
"82173","2022","COM","2020","1166","15","1181","2023-01-02"
"82174","2022","COM","2020","286","2","288","2023-01-02"
"82175","2022","COM","2020","277","4","281","2023-01-02"
"82176","2022","COM","2020","896","14","910","2023-01-02"
"82177","2022","COM","2020","157","2","159","2023-01-02"
"82178","2022","COM","2020","815","17","832","2023-01-02"
"82179","2022","COM","2020","2261","50","2311","2023-01-02"
"82180","2022","COM","2020","518","8","526","2023-01-02"
"82181","2022","COM","2020","205","4","209","2023-01-02"
"82182","2022","COM","2020","336","3","339","2023-01-02"
"82183","2022","COM","2020","237","10","247","2023-01-02"
"82184","2022","COM","2020","930","10","940","2023-01-02"
"82185","2022","COM","2020","251","6","257","2023-01-02"
"82186","2022","COM","2020","5233","148","5381","2023-01-02"
"82187","2022","COM","2020","654","10","664","2023-01-02"
"82188","2022","COM","2020","637","14","651","2023-01-02"
"82189","2022","COM","2020","748","14","762","2023-01-02"
"82190","2022","COM","2020","4831","69","4900","2023-01-02"
"82191","2022","COM","2020","426","4","430","2023-01-02"
"82192","2022","COM","2020","541","13","554","2023-01-02"
"82193","2022","COM","2020","137","3","140","2023-01-02"
"82194","2022","COM","2020","1359","34","1393","2023-01-02"
"82195","2022","COM","2020","796","13","809","2023-01-02"
"83001","2022","COM","2020","2803","74","2877","2023-01-02"
"83002","2022","COM","2020","271","5","276","2023-01-02"
"83003","2022","COM","2020","903","23","926","2023-01-02"
"83004","2022","COM","2020","7292","179","7471","2023-01-02"
"83005","2022","COM","2020","285","6","291","2023-01-02"
"83006","2022","COM","2020","283","8","291","2023-01-02"
"83007","2022","COM","2020","2303","39","2342","2023-01-02"
"83008","2022","COM","2020","2889","59","2948","2023-01-02"
"83009","2022","COM","2020","8359","124","8483","2023-01-02"
"83010","2022","COM","2020","228","1","229","2023-01-02"
"83011","2022","COM","2020","1367","16","1383","2023-01-02"
"83012","2022","COM","2020","3017","39","3056","2023-01-02"
"83013","2022","COM","2020","205","1","206","2023-01-02"
"83014","2022","COM","2020","241","9","250","2023-01-02"
"83015","2022","COM","2020","319","4","323","2023-01-02"
"83016","2022","COM","2020","9802","181","9983","2023-01-02"
"83017","2022","COM","2020","2411","45","2456","2023-01-02"
"83018","2022","COM","2020","3066","56","3122","2023-01-02"
"83019","2022","COM","2020","8162","115","8277","2023-01-02"
"83020","2022","COM","2020","42","1","43","2023-01-02"
"83021","2022","COM","2020","2625","49","2674","2023-01-02"
"83022","2022","COM","2020","23","0","23","2023-01-02"
"83023","2022","COM","2020","17652","312","17964","2023-01-02"
"83025","2022","COM","2020","1440","23","1463","2023-01-02"
"83026","2022","COM","2020","1934","36","1970","2023-01-02"
"83027","2022","COM","2020","5548","99","5647","2023-01-02"
"83028","2022","COM","2020","1961","37","1998","2023-01-02"
"83029","2022","COM","2020","3498","69","3567","2023-01-02"
"83030","2022","COM","2020","1893","47","1940","2023-01-02"
"83031","2022","COM","2020","4325","61","4386","2023-01-02"
"83032","2022","COM","2020","3388","82","3470","2023-01-02"
"83033","2022","COM","2020","3587","36","3623","2023-01-02"
"83034","2022","COM","2020","9462","165","9627","2023-01-02"
"83035","2022","COM","2020","4578","55","4633","2023-01-02"
"83036","2022","COM","2020","7642","93","7735","2023-01-02"
"83037","2022","COM","2020","1536","68","1604","2023-01-02"
"83038","2022","COM","2020","479","15","494","2023-01-02"
"83039","2022","COM","2020","147","5","152","2023-01-02"
"83040","2022","COM","2020","77","1","78","2023-01-02"
"83041","2022","COM","2020","720","10","730","2023-01-02"
"83042","2022","COM","2020","11794","213","12007","2023-01-02"
"83043","2022","COM","2020","1855","88","1943","2023-01-02"
"83044","2022","COM","2020","336","5","341","2023-01-02"
"83045","2022","COM","2020","902","13","915","2023-01-02"
"83046","2022","COM","2020","2105","40","2145","2023-01-02"
"83047","2022","COM","2020","19052","429","19481","2023-01-02"
"83048","2022","COM","2020","3780","93","3873","2023-01-02"
"83049","2022","COM","2020","12298","135","12433","2023-01-02"
"83050","2022","COM","2020","39434","928","40362","2023-01-02"
"83051","2022","COM","2020","1122","23","1145","2023-01-02"
"83052","2022","COM","2020","370","5","375","2023-01-02"
"83053","2022","COM","2020","2407","50","2457","2023-01-02"
"83054","2022","COM","2020","9605","120","9725","2023-01-02"
"83055","2022","COM","2020","5770","87","5857","2023-01-02"
"83056","2022","COM","2020","2623","55","2678","2023-01-02"
"83057","2022","COM","2020","3582","68","3650","2023-01-02"
"83058","2022","COM","2020","4195","103","4298","2023-01-02"
"83059","2022","COM","2020","3185","37","3222","2023-01-02"
"83060","2022","COM","2020","471","7","478","2023-01-02"
"83061","2022","COM","2020","55750","848","56598","2023-01-02"
"83062","2022","COM","2020","25563","313","25876","2023-01-02"
"83063","2022","COM","2020","1827","44","1871","2023-01-02"
"83064","2022","COM","2020","5307","99","5406","2023-01-02"
"83065","2022","COM","2020","2642","57","2699","2023-01-02"
"83066","2022","COM","2020","1930","30","1960","2023-01-02"
"83067","2022","COM","2020","4352","58","4410","2023-01-02"
"83068","2022","COM","2020","4607","64","4671","2023-01-02"
"83069","2022","COM","2020","54615","913","55528","2023-01-02"
"83070","2022","COM","2020","5980","68","6048","2023-01-02"
"83071","2022","COM","2020","11493","150","11643","2023-01-02"
"83072","2022","COM","2020","9280","309","9589","2023-01-02"
"83073","2022","COM","2020","11058","108","11166","2023-01-02"
"83074","2022","COM","2020","210","1","211","2023-01-02"
"83075","2022","COM","2020","625","7","632","2023-01-02"
"83076","2022","COM","2020","873","12","885","2023-01-02"
"83077","2022","COM","2020","2226","20","2246","2023-01-02"
"83078","2022","COM","2020","297","5","302","2023-01-02"
"83079","2022","COM","2020","1473","25","1498","2023-01-02"
"83080","2022","COM","2020","802","15","817","2023-01-02"
"83081","2022","COM","2020","6599","131","6730","2023-01-02"
"83082","2022","COM","2020","1591","9","1600","2023-01-02"
"83083","2022","COM","2020","1456","27","1483","2023-01-02"
"83084","2022","COM","2020","554","4","558","2023-01-02"
"83085","2022","COM","2020","2886","58","2944","2023-01-02"
"83086","2022","COM","2020","9468","249","9717","2023-01-02"
"83087","2022","COM","2020","4916","86","5002","2023-01-02"
"83088","2022","COM","2020","2887","69","2956","2023-01-02"
"83089","2022","COM","2020","647","24","671","2023-01-02"
"83090","2022","COM","2020","13991","269","14260","2023-01-02"
"83091","2022","COM","2020","6083","105","6188","2023-01-02"
"83092","2022","COM","2020","4658","47","4705","2023-01-02"
"83093","2022","COM","2020","2235","27","2262","2023-01-02"
"83094","2022","COM","2020","3046","54","3100","2023-01-02"
"83095","2022","COM","2020","727","19","746","2023-01-02"
"83096","2022","COM","2020","1570","20","1590","2023-01-02"
"83097","2022","COM","2020","5327","104","5431","2023-01-02"
"83098","2022","COM","2020","10496","160","10656","2023-01-02"
"83099","2022","COM","2020","8061","112","8173","2023-01-02"
"83100","2022","COM","2020","4409","47","4456","2023-01-02"
"83101","2022","COM","2020","2037","34","2071","2023-01-02"
"83102","2022","COM","2020","2562","45","2607","2023-01-02"
"83103","2022","COM","2020","4011","60","4071","2023-01-02"
"83104","2022","COM","2020","4301","83","4384","2023-01-02"
"83105","2022","COM","2020","51","0","51","2023-01-02"
"83106","2022","COM","2020","5323","73","5396","2023-01-02"
"83107","2022","COM","2020","14335","187","14522","2023-01-02"
"83108","2022","COM","2020","2184","40","2224","2023-01-02"
"83109","2022","COM","2020","248","2","250","2023-01-02"
"83110","2022","COM","2020","1672","27","1699","2023-01-02"
"83111","2022","COM","2020","2102","26","2128","2023-01-02"
"83112","2022","COM","2020","12058","245","12303","2023-01-02"
"83113","2022","COM","2020","2401","41","2442","2023-01-02"
"83114","2022","COM","2020","247","4","251","2023-01-02"
"83115","2022","COM","2020","14750","204","14954","2023-01-02"
"83116","2022","COM","2020","17468","538","18006","2023-01-02"
"83117","2022","COM","2020","1770","43","1813","2023-01-02"
"83118","2022","COM","2020","35881","579","36460","2023-01-02"
"83119","2022","COM","2020","3600","69","3669","2023-01-02"
"83120","2022","COM","2020","5985","73","6058","2023-01-02"
"83121","2022","COM","2020","3771","77","3848","2023-01-02"
"83122","2022","COM","2020","229","3","232","2023-01-02"
"83123","2022","COM","2020","17173","267","17440","2023-01-02"
"83124","2022","COM","2020","2674","33","2707","2023-01-02"
"83125","2022","COM","2020","2526","39","2565","2023-01-02"
"83126","2022","COM","2020","62232","767","62999","2023-01-02"
"83127","2022","COM","2020","2992","46","3038","2023-01-02"
"83128","2022","COM","2020","762","49","811","2023-01-02"
"83129","2022","COM","2020","35339","551","35890","2023-01-02"
"83130","2022","COM","2020","11974","184","12158","2023-01-02"
"83131","2022","COM","2020","5867","108","5975","2023-01-02"
"83132","2022","COM","2020","2523","46","2569","2023-01-02"
"83133","2022","COM","2020","1674","33","1707","2023-01-02"
"83134","2022","COM","2020","1791","31","1822","2023-01-02"
"83135","2022","COM","2020","1425","19","1444","2023-01-02"
"83136","2022","COM","2020","2598","49","2647","2023-01-02"
"83137","2022","COM","2020","179659","1847","181506","2023-01-02"
"83138","2022","COM","2020","2874","54","2928","2023-01-02"
"83139","2022","COM","2020","587","14","601","2023-01-02"
"83140","2022","COM","2020","5101","75","5176","2023-01-02"
"83141","2022","COM","2020","5983","136","6119","2023-01-02"
"83142","2022","COM","2020","206","5","211","2023-01-02"
"83143","2022","COM","2020","4287","93","4380","2023-01-02"
"83144","2022","COM","2020","24114","263","24377","2023-01-02"
"83145","2022","COM","2020","1165","15","1180","2023-01-02"
"83146","2022","COM","2020","1628","22","1650","2023-01-02"
"83147","2022","COM","2020","9","0","9","2023-01-02"
"83148","2022","COM","2020","12693","156","12849","2023-01-02"
"83149","2022","COM","2020","1483","28","1511","2023-01-02"
"83150","2022","COM","2020","4280","101","4381","2023-01-02"
"83151","2022","COM","2020","937","15","952","2023-01-02"
"83152","2022","COM","2020","646","13","659","2023-01-02"
"83153","2022","COM","2020","6100","70","6170","2023-01-02"
"83154","2022","COM","2020","735","14","749","2023-01-02"
"84001","2022","COM","2020","2824","45","2869","2023-01-02"
"84002","2022","COM","2020","1058","24","1082","2023-01-02"
"84003","2022","COM","2020","10889","227","11116","2023-01-02"
"84004","2022","COM","2020","5825","95","5920","2023-01-02"
"84005","2022","COM","2020","190","2","192","2023-01-02"
"84006","2022","COM","2020","71","4","75","2023-01-02"
"84007","2022","COM","2020","90597","1680","92277","2023-01-02"
"84008","2022","COM","2020","653","35","688","2023-01-02"
"84009","2022","COM","2020","1652","96","1748","2023-01-02"
"84010","2022","COM","2020","883","24","907","2023-01-02"
"84011","2022","COM","2020","355","9","364","2023-01-02"
"84012","2022","COM","2020","2379","47","2426","2023-01-02"
"84013","2022","COM","2020","293","4","297","2023-01-02"
"84014","2022","COM","2020","1129","17","1146","2023-01-02"
"84015","2022","COM","2020","304","5","309","2023-01-02"
"84016","2022","COM","2020","5358","74","5432","2023-01-02"
"84017","2022","COM","2020","3091","66","3157","2023-01-02"
"84018","2022","COM","2020","535","10","545","2023-01-02"
"84019","2022","COM","2020","13830","213","14043","2023-01-02"
"84020","2022","COM","2020","1190","25","1215","2023-01-02"
"84021","2022","COM","2020","89","0","89","2023-01-02"
"84022","2022","COM","2020","267","11","278","2023-01-02"
"84023","2022","COM","2020","96","3","99","2023-01-02"
"84024","2022","COM","2020","959","14","973","2023-01-02"
"84025","2022","COM","2020","1845","38","1883","2023-01-02"
"84026","2022","COM","2020","4219","78","4297","2023-01-02"
"84027","2022","COM","2020","2639","49","2688","2023-01-02"
"84028","2022","COM","2020","1090","20","1110","2023-01-02"
"84029","2022","COM","2020","4544","92","4636","2023-01-02"
"84030","2022","COM","2020","3448","57","3505","2023-01-02"
"84031","2022","COM","2020","29865","699","30564","2023-01-02"
"84032","2022","COM","2020","503","8","511","2023-01-02"
"84033","2022","COM","2020","114","1","115","2023-01-02"
"84034","2022","COM","2020","5094","103","5197","2023-01-02"
"84035","2022","COM","2020","25832","374","26206","2023-01-02"
"84036","2022","COM","2020","3379","73","3452","2023-01-02"
"84037","2022","COM","2020","2061","29","2090","2023-01-02"
"84038","2022","COM","2020","4300","73","4373","2023-01-02"
"84039","2022","COM","2020","6049","78","6127","2023-01-02"
"84040","2022","COM","2020","425","16","441","2023-01-02"
"84041","2022","COM","2020","479","13","492","2023-01-02"
"84042","2022","COM","2020","1777","33","1810","2023-01-02"
"84043","2022","COM","2020","8605","124","8729","2023-01-02"
"84044","2022","COM","2020","1138","33","1171","2023-01-02"
"84045","2022","COM","2020","449","11","460","2023-01-02"
"84046","2022","COM","2020","471","13","484","2023-01-02"
"84047","2022","COM","2020","3058","57","3115","2023-01-02"
"84048","2022","COM","2020","73","1","74","2023-01-02"
"84049","2022","COM","2020","432","11","443","2023-01-02"
"84050","2022","COM","2020","1666","34","1700","2023-01-02"
"84051","2022","COM","2020","1092","26","1118","2023-01-02"
"84052","2022","COM","2020","1225","28","1253","2023-01-02"
"84053","2022","COM","2020","1757","31","1788","2023-01-02"
"84054","2022","COM","2020","20029","502","20531","2023-01-02"
"84055","2022","COM","2020","1571","37","1608","2023-01-02"
"84056","2022","COM","2020","5384","68","5452","2023-01-02"
"84057","2022","COM","2020","351","4","355","2023-01-02"
"84058","2022","COM","2020","424","8","432","2023-01-02"
"84059","2022","COM","2020","122","1","123","2023-01-02"
"84060","2022","COM","2020","30","1","31","2023-01-02"
"84061","2022","COM","2020","325","12","337","2023-01-02"
"84062","2022","COM","2020","1638","33","1671","2023-01-02"
"84063","2022","COM","2020","394","1","395","2023-01-02"
"84064","2022","COM","2020","3842","79","3921","2023-01-02"
"84065","2022","COM","2020","3890","71","3961","2023-01-02"
"84066","2022","COM","2020","289","4","293","2023-01-02"
"84067","2022","COM","2020","2488","53","2541","2023-01-02"
"84068","2022","COM","2020","1042","21","1063","2023-01-02"
"84069","2022","COM","2020","2736","58","2794","2023-01-02"
"84070","2022","COM","2020","1919","24","1943","2023-01-02"
"84071","2022","COM","2020","1914","47","1961","2023-01-02"
"84072","2022","COM","2020","6235","160","6395","2023-01-02"
"84073","2022","COM","2020","992","22","1014","2023-01-02"
"84074","2022","COM","2020","2232","38","2270","2023-01-02"
"84075","2022","COM","2020","446","8","454","2023-01-02"
"84076","2022","COM","2020","1389","42","1431","2023-01-02"
"84077","2022","COM","2020","467","7","474","2023-01-02"
"84078","2022","COM","2020","3708","63","3771","2023-01-02"
"84079","2022","COM","2020","279","7","286","2023-01-02"
"84080","2022","COM","2020","12979","227","13206","2023-01-02"
"84081","2022","COM","2020","8848","130","8978","2023-01-02"
"84082","2022","COM","2020","1869","47","1916","2023-01-02"
"84083","2022","COM","2020","2450","47","2497","2023-01-02"
"84084","2022","COM","2020","1378","41","1419","2023-01-02"
"84085","2022","COM","2020","418","6","424","2023-01-02"
"84086","2022","COM","2020","1292","29","1321","2023-01-02"
"84087","2022","COM","2020","28454","649","29103","2023-01-02"
"84088","2022","COM","2020","10294","284","10578","2023-01-02"
"84089","2022","COM","2020","20498","269","20767","2023-01-02"
"84090","2022","COM","2020","673","14","687","2023-01-02"
"84091","2022","COM","2020","5465","95","5560","2023-01-02"
"84092","2022","COM","2020","17018","128","17146","2023-01-02"
"84093","2022","COM","2020","852","22","874","2023-01-02"
"84094","2022","COM","2020","583","11","594","2023-01-02"
"84095","2022","COM","2020","823","13","836","2023-01-02"
"84096","2022","COM","2020","795","20","815","2023-01-02"
"84097","2022","COM","2020","536","81","617","2023-01-02"
"84098","2022","COM","2020","626","9","635","2023-01-02"
"84099","2022","COM","2020","4688","85","4773","2023-01-02"
"84100","2022","COM","2020","54","0","54","2023-01-02"
"84101","2022","COM","2020","417","13","430","2023-01-02"
"84102","2022","COM","2020","1290","31","1321","2023-01-02"
"84103","2022","COM","2020","670","20","690","2023-01-02"
"84104","2022","COM","2020","1381","34","1415","2023-01-02"
"84105","2022","COM","2020","925","22","947","2023-01-02"
"84106","2022","COM","2020","2634","52","2686","2023-01-02"
"84107","2022","COM","2020","1429","20","1449","2023-01-02"
"84108","2022","COM","2020","2060","37","2097","2023-01-02"
"84109","2022","COM","2020","169","9","178","2023-01-02"
"84110","2022","COM","2020","31","0","31","2023-01-02"
"84111","2022","COM","2020","335","11","346","2023-01-02"
"84112","2022","COM","2020","702","6","708","2023-01-02"
"84113","2022","COM","2020","822","17","839","2023-01-02"
"84114","2022","COM","2020","194","3","197","2023-01-02"
"84115","2022","COM","2020","501","12","513","2023-01-02"
"84116","2022","COM","2020","808","12","820","2023-01-02"
"84117","2022","COM","2020","333","7","340","2023-01-02"
"84118","2022","COM","2020","2910","75","2985","2023-01-02"
"84119","2022","COM","2020","5027","82","5109","2023-01-02"
"84120","2022","COM","2020","120","1","121","2023-01-02"
"84121","2022","COM","2020","278","0","278","2023-01-02"
"84122","2022","COM","2020","6030","84","6114","2023-01-02"
"84123","2022","COM","2020","1356","22","1378","2023-01-02"
"84124","2022","COM","2020","926","15","941","2023-01-02"
"84125","2022","COM","2020","59","0","59","2023-01-02"
"84126","2022","COM","2020","830","17","847","2023-01-02"
"84127","2022","COM","2020","2856","78","2934","2023-01-02"
"84128","2022","COM","2020","46","1","47","2023-01-02"
"84129","2022","COM","2020","18930","246","19176","2023-01-02"
"84130","2022","COM","2020","111","3","114","2023-01-02"
"84131","2022","COM","2020","1917","40","1957","2023-01-02"
"84132","2022","COM","2020","8883","180","9063","2023-01-02"
"84133","2022","COM","2020","4327","139","4466","2023-01-02"
"84134","2022","COM","2020","712","13","725","2023-01-02"
"84135","2022","COM","2020","1674","50","1724","2023-01-02"
"84136","2022","COM","2020","1206","31","1237","2023-01-02"
"84137","2022","COM","2020","5892","127","6019","2023-01-02"
"84138","2022","COM","2020","9381","235","9616","2023-01-02"
"84139","2022","COM","2020","573","16","589","2023-01-02"
"84140","2022","COM","2020","553","19","572","2023-01-02"
"84141","2022","COM","2020","11423","357","11780","2023-01-02"
"84142","2022","COM","2020","3030","71","3101","2023-01-02"
"84143","2022","COM","2020","1032","22","1054","2023-01-02"
"84144","2022","COM","2020","635","16","651","2023-01-02"
"84145","2022","COM","2020","779","14","793","2023-01-02"
"84146","2022","COM","2020","483","14","497","2023-01-02"
"84147","2022","COM","2020","3295","82","3377","2023-01-02"
"84148","2022","COM","2020","1273","32","1305","2023-01-02"
"84149","2022","COM","2020","1727","29","1756","2023-01-02"
"84150","2022","COM","2020","1929","33","1962","2023-01-02"
"84151","2022","COM","2020","162","7","169","2023-01-02"
"85001","2022","COM","2020","2745","44","2789","2023-01-02"
"85002","2022","COM","2020","2067","24","2091","2023-01-02"
"85003","2022","COM","2020","10067","203","10270","2023-01-02"
"85004","2022","COM","2020","2905","36","2941","2023-01-02"
"85005","2022","COM","2020","1051","21","1072","2023-01-02"
"85006","2022","COM","2020","1867","13","1880","2023-01-02"
"85008","2022","COM","2020","7040","106","7146","2023-01-02"
"85009","2022","COM","2020","1149","21","1170","2023-01-02"
"85010","2022","COM","2020","1424","18","1442","2023-01-02"
"85011","2022","COM","2020","1721","50","1771","2023-01-02"
"85012","2022","COM","2020","2240","40","2280","2023-01-02"
"85013","2022","COM","2020","1481","28","1509","2023-01-02"
"85014","2022","COM","2020","1145","27","1172","2023-01-02"
"85015","2022","COM","2020","1565","23","1588","2023-01-02"
"85016","2022","COM","2020","2275","30","2305","2023-01-02"
"85017","2022","COM","2020","2446","49","2495","2023-01-02"
"85018","2022","COM","2020","3887","63","3950","2023-01-02"
"85019","2022","COM","2020","6193","127","6320","2023-01-02"
"85020","2022","COM","2020","4047","77","4124","2023-01-02"
"85021","2022","COM","2020","1877","34","1911","2023-01-02"
"85022","2022","COM","2020","1266","18","1284","2023-01-02"
"85023","2022","COM","2020","440","9","449","2023-01-02"
"85024","2022","COM","2020","2103","29","2132","2023-01-02"
"85025","2022","COM","2020","2276","52","2328","2023-01-02"
"85026","2022","COM","2020","1432","19","1451","2023-01-02"
"85028","2022","COM","2020","593","10","603","2023-01-02"
"85029","2022","COM","2020","2155","35","2190","2023-01-02"
"85031","2022","COM","2020","3208","67","3275","2023-01-02"
"85033","2022","COM","2020","728","18","746","2023-01-02"
"85034","2022","COM","2020","3431","98","3529","2023-01-02"
"85035","2022","COM","2020","5093","87","5180","2023-01-02"
"85036","2022","COM","2020","578","17","595","2023-01-02"
"85037","2022","COM","2020","579","16","595","2023-01-02"
"85038","2022","COM","2020","2883","44","2927","2023-01-02"
"85039","2022","COM","2020","4074","62","4136","2023-01-02"
"85040","2022","COM","2020","1113","20","1133","2023-01-02"
"85041","2022","COM","2020","296","12","308","2023-01-02"
"85042","2022","COM","2020","1884","24","1908","2023-01-02"
"85045","2022","COM","2020","1095","14","1109","2023-01-02"
"85046","2022","COM","2020","3838","59","3897","2023-01-02"
"85047","2022","COM","2020","21900","790","22690","2023-01-02"
"85049","2022","COM","2020","1797","21","1818","2023-01-02"
"85050","2022","COM","2020","1852","22","1874","2023-01-02"
"85051","2022","COM","2020","8434","493","8927","2023-01-02"
"85053","2022","COM","2020","259","3","262","2023-01-02"
"85054","2022","COM","2020","961","11","972","2023-01-02"
"85055","2022","COM","2020","992","27","1019","2023-01-02"
"85056","2022","COM","2020","389","9","398","2023-01-02"
"85058","2022","COM","2020","757","21","778","2023-01-02"
"85059","2022","COM","2020","2601","37","2638","2023-01-02"
"85061","2022","COM","2020","1506","34","1540","2023-01-02"
"85062","2022","COM","2020","1118","20","1138","2023-01-02"
"85064","2022","COM","2020","2485","35","2520","2023-01-02"
"85065","2022","COM","2020","3572","102","3674","2023-01-02"
"85066","2022","COM","2020","829","17","846","2023-01-02"
"85067","2022","COM","2020","1002","21","1023","2023-01-02"
"85070","2022","COM","2020","3339","38","3377","2023-01-02"
"85071","2022","COM","2020","3657","59","3716","2023-01-02"
"85072","2022","COM","2020","1046","11","1057","2023-01-02"
"85073","2022","COM","2020","1015","18","1033","2023-01-02"
"85074","2022","COM","2020","225","3","228","2023-01-02"
"85076","2022","COM","2020","3633","88","3721","2023-01-02"
"85077","2022","COM","2020","523","8","531","2023-01-02"
"85078","2022","COM","2020","735","17","752","2023-01-02"
"85080","2022","COM","2020","1740","33","1773","2023-01-02"
"85081","2022","COM","2020","4394","117","4511","2023-01-02"
"85082","2022","COM","2020","2941","56","2997","2023-01-02"
"85083","2022","COM","2020","1644","39","1683","2023-01-02"
"85084","2022","COM","2020","9300","164","9464","2023-01-02"
"85086","2022","COM","2020","1667","15","1682","2023-01-02"
"85087","2022","COM","2020","197","4","201","2023-01-02"
"85088","2022","COM","2020","4897","128","5025","2023-01-02"
"85089","2022","COM","2020","5363","157","5520","2023-01-02"
"85090","2022","COM","2020","6417","255","6672","2023-01-02"
"85092","2022","COM","2020","13138","690","13828","2023-01-02"
"85093","2022","COM","2020","1230","20","1250","2023-01-02"
"85094","2022","COM","2020","1173","32","1205","2023-01-02"
"85095","2022","COM","2020","1969","20","1989","2023-01-02"
"85096","2022","COM","2020","5220","106","5326","2023-01-02"
"85097","2022","COM","2020","3117","66","3183","2023-01-02"
"85098","2022","COM","2020","1977","39","2016","2023-01-02"
"85099","2022","COM","2020","1120","21","1141","2023-01-02"
"85100","2022","COM","2020","2236","52","2288","2023-01-02"
"85101","2022","COM","2020","487","5","492","2023-01-02"
"85102","2022","COM","2020","700","8","708","2023-01-02"
"85103","2022","COM","2020","2225","39","2264","2023-01-02"
"85104","2022","COM","2020","897","9","906","2023-01-02"
"85105","2022","COM","2020","527","16","543","2023-01-02"
"85106","2022","COM","2020","1331","36","1367","2023-01-02"
"85108","2022","COM","2020","3344","110","3454","2023-01-02"
"85109","2022","COM","2020","16266","535","16801","2023-01-02"
"85110","2022","COM","2020","923","13","936","2023-01-02"
"85111","2022","COM","2020","1506","23","1529","2023-01-02"
"85112","2022","COM","2020","2826","59","2885","2023-01-02"
"85113","2022","COM","2020","4870","138","5008","2023-01-02"
"85114","2022","COM","2020","2670","31","2701","2023-01-02"
"85115","2022","COM","2020","600","12","612","2023-01-02"
"85116","2022","COM","2020","463","8","471","2023-01-02"
"85117","2022","COM","2020","616","9","625","2023-01-02"
"85118","2022","COM","2020","2336","46","2382","2023-01-02"
"85119","2022","COM","2020","2431","42","2473","2023-01-02"
"85120","2022","COM","2020","1479","38","1517","2023-01-02"
"85121","2022","COM","2020","1012","19","1031","2023-01-02"
"85123","2022","COM","2020","284","4","288","2023-01-02"
"85125","2022","COM","2020","402","4","406","2023-01-02"
"85126","2022","COM","2020","1334","50","1384","2023-01-02"
"85127","2022","COM","2020","2412","25","2437","2023-01-02"
"85128","2022","COM","2020","9541","377","9918","2023-01-02"
"85129","2022","COM","2020","3580","74","3654","2023-01-02"
"85130","2022","COM","2020","1601","19","1620","2023-01-02"
"85131","2022","COM","2020","1484","39","1523","2023-01-02"
"85132","2022","COM","2020","751","11","762","2023-01-02"
"85133","2022","COM","2020","906","23","929","2023-01-02"
"85134","2022","COM","2020","242","9","251","2023-01-02"
"85135","2022","COM","2020","2789","121","2910","2023-01-02"
"85136","2022","COM","2020","123","0","123","2023-01-02"
"85137","2022","COM","2020","472","14","486","2023-01-02"
"85138","2022","COM","2020","1183","12","1195","2023-01-02"
"85139","2022","COM","2020","443","15","458","2023-01-02"
"85140","2022","COM","2020","1498","31","1529","2023-01-02"
"85141","2022","COM","2020","677","12","689","2023-01-02"
"85142","2022","COM","2020","1013","15","1028","2023-01-02"
"85143","2022","COM","2020","1057","18","1075","2023-01-02"
"85144","2022","COM","2020","1538","27","1565","2023-01-02"
"85145","2022","COM","2020","967","17","984","2023-01-02"
"85146","2022","COM","2020","20578","628","21206","2023-01-02"
"85147","2022","COM","2020","1630","50","1680","2023-01-02"
"85148","2022","COM","2020","822","23","845","2023-01-02"
"85149","2022","COM","2020","410","5","415","2023-01-02"
"85151","2022","COM","2020","6063","136","6199","2023-01-02"
"85152","2022","COM","2020","5331","114","5445","2023-01-02"
"85153","2022","COM","2020","2923","43","2966","2023-01-02"
"85154","2022","COM","2020","1786","90","1876","2023-01-02"
"85155","2022","COM","2020","4996","125","5121","2023-01-02"
"85156","2022","COM","2020","2255","38","2293","2023-01-02"
"85157","2022","COM","2020","782","12","794","2023-01-02"
"85158","2022","COM","2020","1190","26","1216","2023-01-02"
"85159","2022","COM","2020","2333","33","2366","2023-01-02"
"85160","2022","COM","2020","2961","44","3005","2023-01-02"
"85161","2022","COM","2020","2525","36","2561","2023-01-02"
"85162","2022","COM","2020","2082","61","2143","2023-01-02"
"85163","2022","COM","2020","4486","102","4588","2023-01-02"
"85164","2022","COM","2020","2158","48","2206","2023-01-02"
"85167","2022","COM","2020","788","17","805","2023-01-02"
"85169","2022","COM","2020","1106","17","1123","2023-01-02"
"85171","2022","COM","2020","611","23","634","2023-01-02"
"85172","2022","COM","2020","2068","34","2102","2023-01-02"
"85174","2022","COM","2020","681","18","699","2023-01-02"
"85175","2022","COM","2020","658","5","663","2023-01-02"
"85176","2022","COM","2020","1164","35","1199","2023-01-02"
"85177","2022","COM","2020","1377","31","1408","2023-01-02"
"85178","2022","COM","2020","8616","270","8886","2023-01-02"
"85179","2022","COM","2020","1192","12","1204","2023-01-02"
"85181","2022","COM","2020","641","17","658","2023-01-02"
"85182","2022","COM","2020","5565","199","5764","2023-01-02"
"85184","2022","COM","2020","324","7","331","2023-01-02"
"85185","2022","COM","2020","653","6","659","2023-01-02"
"85186","2022","COM","2020","1007","17","1024","2023-01-02"
"85187","2022","COM","2020","862","15","877","2023-01-02"
"85188","2022","COM","2020","1114","14","1128","2023-01-02"
"85189","2022","COM","2020","2162","45","2207","2023-01-02"
"85190","2022","COM","2020","3467","63","3530","2023-01-02"
"85191","2022","COM","2020","55213","2955","58168","2023-01-02"
"85192","2022","COM","2020","986","17","1003","2023-01-02"
"85193","2022","COM","2020","652","17","669","2023-01-02"
"85194","2022","COM","2020","46941","1460","48401","2023-01-02"
"85196","2022","COM","2020","1916","16","1932","2023-01-02"
"85197","2022","COM","2020","3790","60","3850","2023-01-02"
"85198","2022","COM","2020","1369","18","1387","2023-01-02"
"85199","2022","COM","2020","542","4","546","2023-01-02"
"85200","2022","COM","2020","1106","18","1124","2023-01-02"
"85201","2022","COM","2020","500","6","506","2023-01-02"
"85202","2022","COM","2020","1588","113","1701","2023-01-02"
"85204","2022","COM","2020","2620","44","2664","2023-01-02"
"85205","2022","COM","2020","539","8","547","2023-01-02"
"85206","2022","COM","2020","402","13","415","2023-01-02"
"85207","2022","COM","2020","391","9","400","2023-01-02"
"85208","2022","COM","2020","2392","40","2432","2023-01-02"
"85209","2022","COM","2020","632","11","643","2023-01-02"
"85210","2022","COM","2020","2144","24","2168","2023-01-02"
"85211","2022","COM","2020","2490","24","2514","2023-01-02"
"85213","2022","COM","2020","4238","172","4410","2023-01-02"
"85214","2022","COM","2020","2422","48","2470","2023-01-02"
"85215","2022","COM","2020","3839","137","3976","2023-01-02"
"85216","2022","COM","2020","2077","214","2291","2023-01-02"
"85218","2022","COM","2020","1721","14","1735","2023-01-02"
"85220","2022","COM","2020","1600","26","1626","2023-01-02"
"85221","2022","COM","2020","2694","38","2732","2023-01-02"
"85222","2022","COM","2020","7922","248","8170","2023-01-02"
"85223","2022","COM","2020","2949","59","3008","2023-01-02"
"85226","2022","COM","2020","12137","245","12382","2023-01-02"
"85227","2022","COM","2020","1911","52","1963","2023-01-02"
"85229","2022","COM","2020","580","12","592","2023-01-02"
"85231","2022","COM","2020","799","15","814","2023-01-02"
"85232","2022","COM","2020","1094","24","1118","2023-01-02"
"85233","2022","COM","2020","613","10","623","2023-01-02"
"85234","2022","COM","2020","8725","229","8954","2023-01-02"
"85235","2022","COM","2020","428","13","441","2023-01-02"
"85236","2022","COM","2020","1926","25","1951","2023-01-02"
"85237","2022","COM","2020","389","10","399","2023-01-02"
"85238","2022","COM","2020","3724","443","4167","2023-01-02"
"85239","2022","COM","2020","1149","5","1154","2023-01-02"
"85240","2022","COM","2020","1616","53","1669","2023-01-02"
"85242","2022","COM","2020","1009","20","1029","2023-01-02"
"85243","2022","COM","2020","2855","48","2903","2023-01-02"
"85244","2022","COM","2020","820","58","878","2023-01-02"
"85245","2022","COM","2020","170","2","172","2023-01-02"
"85246","2022","COM","2020","2512","39","2551","2023-01-02"
"85247","2022","COM","2020","1095","18","1113","2023-01-02"
"85248","2022","COM","2020","420","12","432","2023-01-02"
"85250","2022","COM","2020","2340","34","2374","2023-01-02"
"85251","2022","COM","2020","628","19","647","2023-01-02"
"85252","2022","COM","2020","594","24","618","2023-01-02"
"85254","2022","COM","2020","1750","43","1793","2023-01-02"
"85255","2022","COM","2020","2339","80","2419","2023-01-02"
"85256","2022","COM","2020","1283","32","1315","2023-01-02"
"85259","2022","COM","2020","1324","35","1359","2023-01-02"
"85260","2022","COM","2020","831","10","841","2023-01-02"
"85261","2022","COM","2020","284","12","296","2023-01-02"
"85262","2022","COM","2020","3565","40","3605","2023-01-02"
"85264","2022","COM","2020","1330","18","1348","2023-01-02"
"85265","2022","COM","2020","930","21","951","2023-01-02"
"85266","2022","COM","2020","1680","29","1709","2023-01-02"
"85267","2022","COM","2020","952","21","973","2023-01-02"
"85268","2022","COM","2020","1472","31","1503","2023-01-02"
"85269","2022","COM","2020","421","7","428","2023-01-02"
"85271","2022","COM","2020","435","13","448","2023-01-02"
"85273","2022","COM","2020","1916","35","1951","2023-01-02"
"85274","2022","COM","2020","533","13","546","2023-01-02"
"85276","2022","COM","2020","746","13","759","2023-01-02"
"85277","2022","COM","2020","1554","25","1579","2023-01-02"
"85278","2022","COM","2020","1324","21","1345","2023-01-02"
"85280","2022","COM","2020","3232","72","3304","2023-01-02"
"85281","2022","COM","2020","999","31","1030","2023-01-02"
"85282","2022","COM","2020","914","14","928","2023-01-02"
"85284","2022","COM","2020","4297","95","4392","2023-01-02"
"85285","2022","COM","2020","748","15","763","2023-01-02"
"85286","2022","COM","2020","551","5","556","2023-01-02"
"85287","2022","COM","2020","453","8","461","2023-01-02"
"85288","2022","COM","2020","7933","186","8119","2023-01-02"
"85289","2022","COM","2020","1332","26","1358","2023-01-02"
"85290","2022","COM","2020","544","13","557","2023-01-02"
"85291","2022","COM","2020","1235","19","1254","2023-01-02"
"85292","2022","COM","2020","778","9","787","2023-01-02"
"85293","2022","COM","2020","1581","38","1619","2023-01-02"
"85294","2022","COM","2020","2980","60","3040","2023-01-02"
"85295","2022","COM","2020","3281","81","3362","2023-01-02"
"85296","2022","COM","2020","1247","24","1271","2023-01-02"
"85297","2022","COM","2020","1011","12","1023","2023-01-02"
"85298","2022","COM","2020","1814","21","1835","2023-01-02"
"85300","2022","COM","2020","4698","180","4878","2023-01-02"
"85301","2022","COM","2020","1779","46","1825","2023-01-02"
"85302","2022","COM","2020","5468","135","5603","2023-01-02"
"85303","2022","COM","2020","1821","28","1849","2023-01-02"
"85304","2022","COM","2020","755","10","765","2023-01-02"
"85305","2022","COM","2020","846","66","912","2023-01-02"
"85306","2022","COM","2020","733","9","742","2023-01-02"
"86001","2022","COM","2020","711","8","719","2023-01-02"
"86002","2022","COM","2020","575","14","589","2023-01-02"
"86003","2022","COM","2020","340","7","347","2023-01-02"
"86004","2022","COM","2020","345","13","358","2023-01-02"
"86005","2022","COM","2020","612","22","634","2023-01-02"
"86006","2022","COM","2020","541","17","558","2023-01-02"
"86007","2022","COM","2020","1157","33","1190","2023-01-02"
"86008","2022","COM","2020","337","7","344","2023-01-02"
"86009","2022","COM","2020","1063","15","1078","2023-01-02"
"86010","2022","COM","2020","1115","21","1136","2023-01-02"
"86011","2022","COM","2020","180","4","184","2023-01-02"
"86012","2022","COM","2020","153","4","157","2023-01-02"
"86013","2022","COM","2020","96","3","99","2023-01-02"
"86014","2022","COM","2020","1740","40","1780","2023-01-02"
"86015","2022","COM","2020","1237","25","1262","2023-01-02"
"86016","2022","COM","2020","2213","39","2252","2023-01-02"
"86017","2022","COM","2020","1096","16","1112","2023-01-02"
"86018","2022","COM","2020","322","2","324","2023-01-02"
"86019","2022","COM","2020","2954","40","2994","2023-01-02"
"86020","2022","COM","2020","252","4","256","2023-01-02"
"86022","2022","COM","2020","254","4","258","2023-01-02"
"86023","2022","COM","2020","267","6","273","2023-01-02"
"86024","2022","COM","2020","1561","25","1586","2023-01-02"
"86025","2022","COM","2020","475","5","480","2023-01-02"
"86026","2022","COM","2020","543","5","548","2023-01-02"
"86027","2022","COM","2020","1860","38","1898","2023-01-02"
"86028","2022","COM","2020","1072","18","1090","2023-01-02"
"86029","2022","COM","2020","789","23","812","2023-01-02"
"86031","2022","COM","2020","1715","24","1739","2023-01-02"
"86032","2022","COM","2020","2091","93","2184","2023-01-02"
"86034","2022","COM","2020","607","13","620","2023-01-02"
"86035","2022","COM","2020","180","1","181","2023-01-02"
"86036","2022","COM","2020","897","20","917","2023-01-02"
"86037","2022","COM","2020","491","7","498","2023-01-02"
"86038","2022","COM","2020","215","8","223","2023-01-02"
"86039","2022","COM","2020","740","10","750","2023-01-02"
"86040","2022","COM","2020","310","11","321","2023-01-02"
"86041","2022","COM","2020","10001","126","10127","2023-01-02"
"86042","2022","COM","2020","913","11","924","2023-01-02"
"86044","2022","COM","2020","546","11","557","2023-01-02"
"86045","2022","COM","2020","1352","17","1369","2023-01-02"
"86046","2022","COM","2020","1720","26","1746","2023-01-02"
"86047","2022","COM","2020","488","14","502","2023-01-02"
"86048","2022","COM","2020","1188","18","1206","2023-01-02"
"86049","2022","COM","2020","494","16","510","2023-01-02"
"86050","2022","COM","2020","844","13","857","2023-01-02"
"86051","2022","COM","2020","202","2","204","2023-01-02"
"86052","2022","COM","2020","992","19","1011","2023-01-02"
"86053","2022","COM","2020","1938","45","1983","2023-01-02"
"86054","2022","COM","2020","353","6","359","2023-01-02"
"86055","2022","COM","2020","354","9","363","2023-01-02"
"86058","2022","COM","2020","728","20","748","2023-01-02"
"86059","2022","COM","2020","590","4","594","2023-01-02"
"86061","2022","COM","2020","1099","20","1119","2023-01-02"
"86062","2022","COM","2020","4699","49","4748","2023-01-02"
"86063","2022","COM","2020","247","3","250","2023-01-02"
"86064","2022","COM","2020","612","10","622","2023-01-02"
"86065","2022","COM","2020","1048","17","1065","2023-01-02"
"86066","2022","COM","2020","31573","772","32345","2023-01-02"
"86068","2022","COM","2020","1216","21","1237","2023-01-02"
"86069","2022","COM","2020","182","1","183","2023-01-02"
"86070","2022","COM","2020","7084","114","7198","2023-01-02"
"86072","2022","COM","2020","451","11","462","2023-01-02"
"86073","2022","COM","2020","523","11","534","2023-01-02"
"86074","2022","COM","2020","921","15","936","2023-01-02"
"86075","2022","COM","2020","766","11","777","2023-01-02"
"86076","2022","COM","2020","2849","49","2898","2023-01-02"
"86077","2022","COM","2020","1208","17","1225","2023-01-02"
"86078","2022","COM","2020","2574","134","2708","2023-01-02"
"86079","2022","COM","2020","559","36","595","2023-01-02"
"86080","2022","COM","2020","496","5","501","2023-01-02"
"86081","2022","COM","2020","1428","28","1456","2023-01-02"
"86082","2022","COM","2020","4412","129","4541","2023-01-02"
"86083","2022","COM","2020","1131","13","1144","2023-01-02"
"86084","2022","COM","2020","234","4","238","2023-01-02"
"86085","2022","COM","2020","248","8","256","2023-01-02"
"86086","2022","COM","2020","929","17","946","2023-01-02"
"86087","2022","COM","2020","183","3","186","2023-01-02"
"86088","2022","COM","2020","889","13","902","2023-01-02"
"86089","2022","COM","2020","389","6","395","2023-01-02"
"86090","2022","COM","2020","217","1","218","2023-01-02"
"86091","2022","COM","2020","383","7","390","2023-01-02"
"86092","2022","COM","2020","2963","55","3018","2023-01-02"
"86093","2022","COM","2020","159","3","162","2023-01-02"
"86094","2022","COM","2020","581","12","593","2023-01-02"
"86095","2022","COM","2020","3264","50","3314","2023-01-02"
"86096","2022","COM","2020","660","8","668","2023-01-02"
"86097","2022","COM","2020","331","5","336","2023-01-02"
"86098","2022","COM","2020","144","2","146","2023-01-02"
"86099","2022","COM","2020","1051","8","1059","2023-01-02"
"86100","2022","COM","2020","3971","75","4046","2023-01-02"
"86102","2022","COM","2020","593","8","601","2023-01-02"
"86103","2022","COM","2020","1743","64","1807","2023-01-02"
"86104","2022","COM","2020","494","5","499","2023-01-02"
"86105","2022","COM","2020","363","1","364","2023-01-02"
"86106","2022","COM","2020","96","2","98","2023-01-02"
"86107","2022","COM","2020","467","8","475","2023-01-02"
"86108","2022","COM","2020","405","7","412","2023-01-02"
"86109","2022","COM","2020","219","8","227","2023-01-02"
"86110","2022","COM","2020","230","4","234","2023-01-02"
"86111","2022","COM","2020","1724","68","1792","2023-01-02"
"86112","2022","COM","2020","1169","11","1180","2023-01-02"
"86113","2022","COM","2020","2974","55","3029","2023-01-02"
"86114","2022","COM","2020","1269","29","1298","2023-01-02"
"86115","2022","COM","2020","7664","255","7919","2023-01-02"
"86116","2022","COM","2020","788","22","810","2023-01-02"
"86117","2022","COM","2020","526","7","533","2023-01-02"
"86118","2022","COM","2020","371","9","380","2023-01-02"
"86119","2022","COM","2020","305","1","306","2023-01-02"
"86120","2022","COM","2020","1217","15","1232","2023-01-02"
"86121","2022","COM","2020","1460","29","1489","2023-01-02"
"86122","2022","COM","2020","67","2","69","2023-01-02"
"86123","2022","COM","2020","3079","52","3131","2023-01-02"
"86124","2022","COM","2020","1183","15","1198","2023-01-02"
"86125","2022","COM","2020","595","13","608","2023-01-02"
"86126","2022","COM","2020","647","13","660","2023-01-02"
"86127","2022","COM","2020","462","3","465","2023-01-02"
"86128","2022","COM","2020","2474","39","2513","2023-01-02"
"86129","2022","COM","2020","522","8","530","2023-01-02"
"86130","2022","COM","2020","378","3","381","2023-01-02"
"86131","2022","COM","2020","892","24","916","2023-01-02"
"86132","2022","COM","2020","309","3","312","2023-01-02"
"86133","2022","COM","2020","3394","58","3452","2023-01-02"
"86134","2022","COM","2020","219","0","219","2023-01-02"
"86135","2022","COM","2020","577","14","591","2023-01-02"
"86136","2022","COM","2020","387","8","395","2023-01-02"
"86137","2022","COM","2020","6702","350","7052","2023-01-02"
"86138","2022","COM","2020","251","3","254","2023-01-02"
"86139","2022","COM","2020","2622","58","2680","2023-01-02"
"86140","2022","COM","2020","2271","47","2318","2023-01-02"
"86141","2022","COM","2020","672","14","686","2023-01-02"
"86142","2022","COM","2020","640","12","652","2023-01-02"
"86143","2022","COM","2020","175","4","179","2023-01-02"
"86144","2022","COM","2020","322","7","329","2023-01-02"
"86145","2022","COM","2020","1192","26","1218","2023-01-02"
"86147","2022","COM","2020","604","8","612","2023-01-02"
"86148","2022","COM","2020","713","12","725","2023-01-02"
"86149","2022","COM","2020","371","10","381","2023-01-02"
"86150","2022","COM","2020","269","7","276","2023-01-02"
"86151","2022","COM","2020","172","7","179","2023-01-02"
"86152","2022","COM","2020","579","15","594","2023-01-02"
"86153","2022","COM","2020","865","13","878","2023-01-02"
"86154","2022","COM","2020","257","2","259","2023-01-02"
"86156","2022","COM","2020","239","5","244","2023-01-02"
"86157","2022","COM","2020","5031","178","5209","2023-01-02"
"86158","2022","COM","2020","6183","115","6298","2023-01-02"
"86159","2022","COM","2020","524","4","528","2023-01-02"
"86160","2022","COM","2020","2147","33","2180","2023-01-02"
"86161","2022","COM","2020","993","18","1011","2023-01-02"
"86162","2022","COM","2020","112","1","113","2023-01-02"
"86163","2022","COM","2020","3685","67","3752","2023-01-02"
"86164","2022","COM","2020","667","5","672","2023-01-02"
"86165","2022","COM","2020","5914","458","6372","2023-01-02"
"86167","2022","COM","2020","916","6","922","2023-01-02"
"86169","2022","COM","2020","359","5","364","2023-01-02"
"86170","2022","COM","2020","367","12","379","2023-01-02"
"86171","2022","COM","2020","437","14","451","2023-01-02"
"86172","2022","COM","2020","160","4","164","2023-01-02"
"86173","2022","COM","2020","659","13","672","2023-01-02"
"86174","2022","COM","2020","5933","116","6049","2023-01-02"
"86175","2022","COM","2020","308","12","320","2023-01-02"
"86176","2022","COM","2020","123","5","128","2023-01-02"
"86177","2022","COM","2020","5376","83","5459","2023-01-02"
"86178","2022","COM","2020","2777","39","2816","2023-01-02"
"86180","2022","COM","2020","2895","52","2947","2023-01-02"
"86181","2022","COM","2020","212","9","221","2023-01-02"
"86182","2022","COM","2020","362","8","370","2023-01-02"
"86183","2022","COM","2020","1611","20","1631","2023-01-02"
"86184","2022","COM","2020","949","12","961","2023-01-02"
"86186","2022","COM","2020","956","18","974","2023-01-02"
"86187","2022","COM","2020","461","13","474","2023-01-02"
"86189","2022","COM","2020","468","6","474","2023-01-02"
"86190","2022","COM","2020","720","13","733","2023-01-02"
"86191","2022","COM","2020","246","5","251","2023-01-02"
"86192","2022","COM","2020","176","3","179","2023-01-02"
"86193","2022","COM","2020","1203","12","1215","2023-01-02"
"86194","2022","COM","2020","90033","2263","92296","2023-01-02"
"86195","2022","COM","2020","563","7","570","2023-01-02"
"86196","2022","COM","2020","233","4","237","2023-01-02"
"86197","2022","COM","2020","418","12","430","2023-01-02"
"86198","2022","COM","2020","709","9","718","2023-01-02"
"86200","2022","COM","2020","561","12","573","2023-01-02"
"86201","2022","COM","2020","209","2","211","2023-01-02"
"86202","2022","COM","2020","600","9","609","2023-01-02"
"86203","2022","COM","2020","549","11","560","2023-01-02"
"86204","2022","COM","2020","2132","55","2187","2023-01-02"
"86205","2022","COM","2020","204","3","207","2023-01-02"
"86206","2022","COM","2020","137","4","141","2023-01-02"
"86207","2022","COM","2020","1569","32","1601","2023-01-02"
"86209","2022","COM","2020","2071","34","2105","2023-01-02"
"86210","2022","COM","2020","750","20","770","2023-01-02"
"86211","2022","COM","2020","869","99","968","2023-01-02"
"86213","2022","COM","2020","2498","187","2685","2023-01-02"
"86214","2022","COM","2020","7308","195","7503","2023-01-02"
"86217","2022","COM","2020","284","11","295","2023-01-02"
"86218","2022","COM","2020","198","8","206","2023-01-02"
"86220","2022","COM","2020","313","8","321","2023-01-02"
"86221","2022","COM","2020","1197","21","1218","2023-01-02"
"86222","2022","COM","2020","4265","55","4320","2023-01-02"
"86223","2022","COM","2020","904","24","928","2023-01-02"
"86224","2022","COM","2020","1333","31","1364","2023-01-02"
"86225","2022","COM","2020","1369","22","1391","2023-01-02"
"86226","2022","COM","2020","2838","50","2888","2023-01-02"
"86227","2022","COM","2020","135","4","139","2023-01-02"
"86228","2022","COM","2020","199","3","202","2023-01-02"
"86229","2022","COM","2020","340","5","345","2023-01-02"
"86230","2022","COM","2020","170","3","173","2023-01-02"
"86231","2022","COM","2020","481","17","498","2023-01-02"
"86233","2022","COM","2020","2753","42","2795","2023-01-02"
"86234","2022","COM","2020","383","3","386","2023-01-02"
"86235","2022","COM","2020","1305","36","1341","2023-01-02"
"86236","2022","COM","2020","885","15","900","2023-01-02"
"86237","2022","COM","2020","768","20","788","2023-01-02"
"86239","2022","COM","2020","176","0","176","2023-01-02"
"86241","2022","COM","2020","412","6","418","2023-01-02"
"86242","2022","COM","2020","393","7","400","2023-01-02"
"86244","2022","COM","2020","1268","29","1297","2023-01-02"
"86245","2022","COM","2020","1754","41","1795","2023-01-02"
"86246","2022","COM","2020","817","16","833","2023-01-02"
"86247","2022","COM","2020","535","13","548","2023-01-02"
"86248","2022","COM","2020","536","17","553","2023-01-02"
"86249","2022","COM","2020","125","1","126","2023-01-02"
"86250","2022","COM","2020","289","5","294","2023-01-02"
"86252","2022","COM","2020","650","17","667","2023-01-02"
"86253","2022","COM","2020","549","11","560","2023-01-02"
"86254","2022","COM","2020","1001","10","1011","2023-01-02"
"86255","2022","COM","2020","1303","25","1328","2023-01-02"
"86256","2022","COM","2020","1208","25","1233","2023-01-02"
"86257","2022","COM","2020","369","5","374","2023-01-02"
"86258","2022","COM","2020","2209","46","2255","2023-01-02"
"86260","2022","COM","2020","313","1","314","2023-01-02"
"86261","2022","COM","2020","2256","76","2332","2023-01-02"
"86262","2022","COM","2020","582","15","597","2023-01-02"
"86263","2022","COM","2020","2910","47","2957","2023-01-02"
"86264","2022","COM","2020","746","17","763","2023-01-02"
"86265","2022","COM","2020","423","7","430","2023-01-02"
"86266","2022","COM","2020","136","1","137","2023-01-02"
"86268","2022","COM","2020","1124","15","1139","2023-01-02"
"86269","2022","COM","2020","190","3","193","2023-01-02"
"86270","2022","COM","2020","155","3","158","2023-01-02"
"86271","2022","COM","2020","787","15","802","2023-01-02"
"86272","2022","COM","2020","2843","146","2989","2023-01-02"
"86273","2022","COM","2020","859","22","881","2023-01-02"
"86274","2022","COM","2020","1091","25","1116","2023-01-02"
"86275","2022","COM","2020","600","9","609","2023-01-02"
"86276","2022","COM","2020","1245","22","1267","2023-01-02"
"86279","2022","COM","2020","540","12","552","2023-01-02"
"86280","2022","COM","2020","355","6","361","2023-01-02"
"86281","2022","COM","2020","5594","86","5680","2023-01-02"
"86284","2022","COM","2020","717","12","729","2023-01-02"
"86285","2022","COM","2020","951","25","976","2023-01-02"
"86286","2022","COM","2020","387","4","391","2023-01-02"
"86287","2022","COM","2020","357","6","363","2023-01-02"
"86288","2022","COM","2020","625","9","634","2023-01-02"
"86289","2022","COM","2020","667","30","697","2023-01-02"
"86290","2022","COM","2020","1536","33","1569","2023-01-02"
"86291","2022","COM","2020","102","7","109","2023-01-02"
"86292","2022","COM","2020","933","18","951","2023-01-02"
"86293","2022","COM","2020","4437","73","4510","2023-01-02"
"86294","2022","COM","2020","3677","74","3751","2023-01-02"
"86295","2022","COM","2020","391","5","396","2023-01-02"
"86296","2022","COM","2020","470","9","479","2023-01-02"
"86297","2022","COM","2020","6142","144","6286","2023-01-02"
"86298","2022","COM","2020","2284","45","2329","2023-01-02"
"86299","2022","COM","2020","572","9","581","2023-01-02"
"86300","2022","COM","2020","617","5","622","2023-01-02"
"87001","2022","COM","2020","5809","78","5887","2023-01-02"
"87002","2022","COM","2020","5556","69","5625","2023-01-02"
"87003","2022","COM","2020","928","25","953","2023-01-02"
"87004","2022","COM","2020","114","2","116","2023-01-02"
"87005","2022","COM","2020","1009","20","1029","2023-01-02"
"87006","2022","COM","2020","240","0","240","2023-01-02"
"87007","2022","COM","2020","196","2","198","2023-01-02"
"87008","2022","COM","2020","148","0","148","2023-01-02"
"87009","2022","COM","2020","141","5","146","2023-01-02"
"87011","2022","COM","2020","3619","125","3744","2023-01-02"
"87012","2022","COM","2020","440","5","445","2023-01-02"
"87013","2022","COM","2020","658","16","674","2023-01-02"
"87014","2022","COM","2020","2787","57","2844","2023-01-02"
"87015","2022","COM","2020","711","71","782","2023-01-02"
"87016","2022","COM","2020","287","5","292","2023-01-02"
"87017","2022","COM","2020","500","10","510","2023-01-02"
"87018","2022","COM","2020","693","24","717","2023-01-02"
"87019","2022","COM","2020","2925","63","2988","2023-01-02"
"87020","2022","COM","2020","1655","27","1682","2023-01-02"
"87021","2022","COM","2020","2612","33","2645","2023-01-02"
"87022","2022","COM","2020","117","1","118","2023-01-02"
"87023","2022","COM","2020","187","4","191","2023-01-02"
"87024","2022","COM","2020","833","9","842","2023-01-02"
"87025","2022","COM","2020","853","12","865","2023-01-02"
"87027","2022","COM","2020","1268","15","1283","2023-01-02"
"87028","2022","COM","2020","1669","21","1690","2023-01-02"
"87029","2022","COM","2020","620","11","631","2023-01-02"
"87030","2022","COM","2020","1254","23","1277","2023-01-02"
"87031","2022","COM","2020","307","4","311","2023-01-02"
"87032","2022","COM","2020","1647","31","1678","2023-01-02"
"87033","2022","COM","2020","795","9","804","2023-01-02"
"87034","2022","COM","2020","568","8","576","2023-01-02"
"87035","2022","COM","2020","520","9","529","2023-01-02"
"87036","2022","COM","2020","674","10","684","2023-01-02"
"87037","2022","COM","2020","263","2","265","2023-01-02"
"87038","2022","COM","2020","2093","17","2110","2023-01-02"
"87039","2022","COM","2020","798","13","811","2023-01-02"
"87040","2022","COM","2020","1524","18","1542","2023-01-02"
"87041","2022","COM","2020","2036","21","2057","2023-01-02"
"87042","2022","COM","2020","384","6","390","2023-01-02"
"87043","2022","COM","2020","217","1","218","2023-01-02"
"87044","2022","COM","2020","317","5","322","2023-01-02"
"87045","2022","COM","2020","1002","22","1024","2023-01-02"
"87046","2022","COM","2020","1191","8","1199","2023-01-02"
"87047","2022","COM","2020","1867","16","1883","2023-01-02"
"87048","2022","COM","2020","5117","67","5184","2023-01-02"
"87049","2022","COM","2020","1302","27","1329","2023-01-02"
"87050","2022","COM","2020","9612","160","9772","2023-01-02"
"87051","2022","COM","2020","613","11","624","2023-01-02"
"87052","2022","COM","2020","174","3","177","2023-01-02"
"87053","2022","COM","2020","239","2","241","2023-01-02"
"87054","2022","COM","2020","1184","15","1199","2023-01-02"
"87056","2022","COM","2020","265","5","270","2023-01-02"
"87057","2022","COM","2020","371","5","376","2023-01-02"
"87058","2022","COM","2020","101","3","104","2023-01-02"
"87059","2022","COM","2020","1535","59","1594","2023-01-02"
"87060","2022","COM","2020","669","9","678","2023-01-02"
"87061","2022","COM","2020","346","5","351","2023-01-02"
"87062","2022","COM","2020","467","8","475","2023-01-02"
"87063","2022","COM","2020","1313","20","1333","2023-01-02"
"87064","2022","COM","2020","2087","20","2107","2023-01-02"
"87065","2022","COM","2020","6120","71","6191","2023-01-02"
"87066","2022","COM","2020","1070","13","1083","2023-01-02"
"87067","2022","COM","2020","456","8","464","2023-01-02"
"87068","2022","COM","2020","516","16","532","2023-01-02"
"87069","2022","COM","2020","145","1","146","2023-01-02"
"87070","2022","COM","2020","979","16","995","2023-01-02"
"87071","2022","COM","2020","790","13","803","2023-01-02"
"87072","2022","COM","2020","507","10","517","2023-01-02"
"87073","2022","COM","2020","389","9","398","2023-01-02"
"87074","2022","COM","2020","240","6","246","2023-01-02"
"87075","2022","COM","2020","7869","136","8005","2023-01-02"
"87076","2022","COM","2020","236","3","239","2023-01-02"
"87077","2022","COM","2020","528","9","537","2023-01-02"
"87078","2022","COM","2020","693","5","698","2023-01-02"
"87079","2022","COM","2020","826","13","839","2023-01-02"
"87080","2022","COM","2020","176","3","179","2023-01-02"
"87081","2022","COM","2020","1104","14","1118","2023-01-02"
"87082","2022","COM","2020","1156","12","1168","2023-01-02"
"87083","2022","COM","2020","530","7","537","2023-01-02"
"87084","2022","COM","2020","164","4","168","2023-01-02"
"87085","2022","COM","2020","130592","2176","132768","2023-01-02"
"87086","2022","COM","2020","1016","17","1033","2023-01-02"
"87087","2022","COM","2020","466","3","469","2023-01-02"
"87088","2022","COM","2020","1114","19","1133","2023-01-02"
"87089","2022","COM","2020","1705","166","1871","2023-01-02"
"87090","2022","COM","2020","263","5","268","2023-01-02"
"87091","2022","COM","2020","382","7","389","2023-01-02"
"87092","2022","COM","2020","495","6","501","2023-01-02"
"87093","2022","COM","2020","282","3","285","2023-01-02"
"87094","2022","COM","2020","522","4","526","2023-01-02"
"87095","2022","COM","2020","731","14","745","2023-01-02"
"87096","2022","COM","2020","843","20","863","2023-01-02"
"87097","2022","COM","2020","1013","12","1025","2023-01-02"
"87099","2022","COM","2020","332","16","348","2023-01-02"
"87100","2022","COM","2020","260","2","262","2023-01-02"
"87101","2022","COM","2020","123","1","124","2023-01-02"
"87103","2022","COM","2020","1604","22","1626","2023-01-02"
"87104","2022","COM","2020","454","4","458","2023-01-02"
"87105","2022","COM","2020","907","16","923","2023-01-02"
"87106","2022","COM","2020","2511","45","2556","2023-01-02"
"87107","2022","COM","2020","1629","17","1646","2023-01-02"
"87108","2022","COM","2020","451","8","459","2023-01-02"
"87109","2022","COM","2020","328","34","362","2023-01-02"
"87110","2022","COM","2020","2478","21","2499","2023-01-02"
"87111","2022","COM","2020","1527","27","1554","2023-01-02"
"87112","2022","COM","2020","597","8","605","2023-01-02"
"87113","2022","COM","2020","6008","58","6066","2023-01-02"
"87114","2022","COM","2020","11002","183","11185","2023-01-02"
"87115","2022","COM","2020","174","2","176","2023-01-02"
"87116","2022","COM","2020","1049","16","1065","2023-01-02"
"87117","2022","COM","2020","1029","15","1044","2023-01-02"
"87118","2022","COM","2020","1307","18","1325","2023-01-02"
"87119","2022","COM","2020","1163","11","1174","2023-01-02"
"87120","2022","COM","2020","505","11","516","2023-01-02"
"87121","2022","COM","2020","482","10","492","2023-01-02"
"87122","2022","COM","2020","1169","12","1181","2023-01-02"
"87123","2022","COM","2020","148","0","148","2023-01-02"
"87124","2022","COM","2020","373","3","376","2023-01-02"
"87125","2022","COM","2020","4655","70","4725","2023-01-02"
"87126","2022","COM","2020","3725","47","3772","2023-01-02"
"87127","2022","COM","2020","597","14","611","2023-01-02"
"87128","2022","COM","2020","1330","15","1345","2023-01-02"
"87129","2022","COM","2020","951","7","958","2023-01-02"
"87130","2022","COM","2020","168","0","168","2023-01-02"
"87131","2022","COM","2020","799","11","810","2023-01-02"
"87132","2022","COM","2020","110","4","114","2023-01-02"
"87133","2022","COM","2020","484","4","488","2023-01-02"
"87134","2022","COM","2020","148","3","151","2023-01-02"
"87135","2022","COM","2020","958","18","976","2023-01-02"
"87137","2022","COM","2020","138","2","140","2023-01-02"
"87138","2022","COM","2020","560","13","573","2023-01-02"
"87139","2022","COM","2020","453","7","460","2023-01-02"
"87140","2022","COM","2020","1665","30","1695","2023-01-02"
"87141","2022","COM","2020","679","10","689","2023-01-02"
"87142","2022","COM","2020","543","6","549","2023-01-02"
"87143","2022","COM","2020","2218","29","2247","2023-01-02"
"87144","2022","COM","2020","524","5","529","2023-01-02"
"87145","2022","COM","2020","235","1","236","2023-01-02"
"87146","2022","COM","2020","1152","12","1164","2023-01-02"
"87147","2022","COM","2020","46","2","48","2023-01-02"
"87148","2022","COM","2020","996","11","1007","2023-01-02"
"87149","2022","COM","2020","364","4","368","2023-01-02"
"87150","2022","COM","2020","831","14","845","2023-01-02"
"87151","2022","COM","2020","494","8","502","2023-01-02"
"87152","2022","COM","2020","1658","24","1682","2023-01-02"
"87153","2022","COM","2020","292","0","292","2023-01-02"
"87154","2022","COM","2020","11295","305","11600","2023-01-02"
"87155","2022","COM","2020","181","7","188","2023-01-02"
"87156","2022","COM","2020","2693","47","2740","2023-01-02"
"87157","2022","COM","2020","829","33","862","2023-01-02"
"87158","2022","COM","2020","1409","14","1423","2023-01-02"
"87159","2022","COM","2020","351","2","353","2023-01-02"
"87160","2022","COM","2020","497","4","501","2023-01-02"
"87161","2022","COM","2020","4357","111","4468","2023-01-02"
"87162","2022","COM","2020","202","2","204","2023-01-02"
"87163","2022","COM","2020","140","3","143","2023-01-02"
"87164","2022","COM","2020","567","10","577","2023-01-02"
"87165","2022","COM","2020","141","1","142","2023-01-02"
"87166","2022","COM","2020","913","11","924","2023-01-02"
"87167","2022","COM","2020","553","5","558","2023-01-02"
"87168","2022","COM","2020","1077","14","1091","2023-01-02"
"87169","2022","COM","2020","1048","24","1072","2023-01-02"
"87170","2022","COM","2020","356","5","361","2023-01-02"
"87172","2022","COM","2020","217","5","222","2023-01-02"
"87174","2022","COM","2020","1222","23","1245","2023-01-02"
"87176","2022","COM","2020","675","5","680","2023-01-02"
"87177","2022","COM","2020","1809","18","1827","2023-01-02"
"87178","2022","COM","2020","2895","32","2927","2023-01-02"
"87179","2022","COM","2020","233","0","233","2023-01-02"
"87180","2022","COM","2020","571","3","574","2023-01-02"
"87181","2022","COM","2020","819","17","836","2023-01-02"
"87182","2022","COM","2020","1206","17","1223","2023-01-02"
"87183","2022","COM","2020","920","12","932","2023-01-02"
"87185","2022","COM","2020","1764","25","1789","2023-01-02"
"87186","2022","COM","2020","321","4","325","2023-01-02"
"87187","2022","COM","2020","6778","369","7147","2023-01-02"
"87188","2022","COM","2020","435","3","438","2023-01-02"
"87189","2022","COM","2020","145","1","146","2023-01-02"
"87190","2022","COM","2020","856","7","863","2023-01-02"
"87191","2022","COM","2020","2010","19","2029","2023-01-02"
"87192","2022","COM","2020","1576","23","1599","2023-01-02"
"87193","2022","COM","2020","44","3","47","2023-01-02"
"87194","2022","COM","2020","347","3","350","2023-01-02"
"87195","2022","COM","2020","133","1","134","2023-01-02"
"87197","2022","COM","2020","567","9","576","2023-01-02"
"87198","2022","COM","2020","408","6","414","2023-01-02"
"87199","2022","COM","2020","725","6","731","2023-01-02"
"87200","2022","COM","2020","129","0","129","2023-01-02"
"87201","2022","COM","2020","4886","215","5101","2023-01-02"
"87202","2022","COM","2020","2132","35","2167","2023-01-02"
"87203","2022","COM","2020","1327","29","1356","2023-01-02"
"87204","2022","COM","2020","203","4","207","2023-01-02"
"87205","2022","COM","2020","2271","38","2309","2023-01-02"
"87206","2022","COM","2020","162","1","163","2023-01-02"
"88001","2022","COM","2020","56","0","56","2023-01-02"
"88002","2022","COM","2020","73","3","76","2023-01-02"
"88003","2022","COM","2020","62","1","63","2023-01-02"
"88004","2022","COM","2020","129","6","135","2023-01-02"
"88005","2022","COM","2020","200","4","204","2023-01-02"
"88006","2022","COM","2020","282","8","290","2023-01-02"
"88007","2022","COM","2020","48","1","49","2023-01-02"
"88008","2022","COM","2020","169","3","172","2023-01-02"
"88009","2022","COM","2020","3339","70","3409","2023-01-02"
"88010","2022","COM","2020","202","0","202","2023-01-02"
"88011","2022","COM","2020","1628","49","1677","2023-01-02"
"88012","2022","COM","2020","1104","12","1116","2023-01-02"
"88013","2022","COM","2020","89","0","89","2023-01-02"
"88014","2022","COM","2020","184","5","189","2023-01-02"
"88015","2022","COM","2020","202","3","205","2023-01-02"
"88016","2022","COM","2020","203","9","212","2023-01-02"
"88017","2022","COM","2020","168","6","174","2023-01-02"
"88019","2022","COM","2020","145","3","148","2023-01-02"
"88020","2022","COM","2020","190","5","195","2023-01-02"
"88021","2022","COM","2020","280","12","292","2023-01-02"
"88022","2022","COM","2020","240","6","246","2023-01-02"
"88023","2022","COM","2020","83","0","83","2023-01-02"
"88024","2022","COM","2020","124","0","124","2023-01-02"
"88025","2022","COM","2020","69","3","72","2023-01-02"
"88026","2022","COM","2020","1006","48","1054","2023-01-02"
"88027","2022","COM","2020","144","6","150","2023-01-02"
"88028","2022","COM","2020","618","94","712","2023-01-02"
"88029","2022","COM","2020","1589","123","1712","2023-01-02"
"88030","2022","COM","2020","151","0","151","2023-01-02"
"88031","2022","COM","2020","98","4","102","2023-01-02"
"88032","2022","COM","2020","1193","34","1227","2023-01-02"
"88033","2022","COM","2020","351","7","358","2023-01-02"
"88035","2022","COM","2020","143","5","148","2023-01-02"
"88036","2022","COM","2020","91","1","92","2023-01-02"
"88037","2022","COM","2020","877","27","904","2023-01-02"
"88038","2022","COM","2020","36","0","36","2023-01-02"
"88039","2022","COM","2020","337","7","344","2023-01-02"
"88040","2022","COM","2020","246","5","251","2023-01-02"
"88041","2022","COM","2020","107","8","115","2023-01-02"
"88042","2022","COM","2020","79","1","80","2023-01-02"
"88043","2022","COM","2020","109","3","112","2023-01-02"
"88044","2022","COM","2020","605","16","621","2023-01-02"
"88045","2022","COM","2020","88","0","88","2023-01-02"
"88046","2022","COM","2020","131","1","132","2023-01-02"
"88047","2022","COM","2020","148","7","155","2023-01-02"
"88048","2022","COM","2020","975","26","1001","2023-01-02"
"88049","2022","COM","2020","112","2","114","2023-01-02"
"88050","2022","COM","2020","302","5","307","2023-01-02"
"88051","2022","COM","2020","130","1","131","2023-01-02"
"88052","2022","COM","2020","94","2","96","2023-01-02"
"88053","2022","COM","2020","155","2","157","2023-01-02"
"88054","2022","COM","2020","306","10","316","2023-01-02"
"88055","2022","COM","2020","161","0","161","2023-01-02"
"88056","2022","COM","2020","96","2","98","2023-01-02"
"88057","2022","COM","2020","92","2","94","2023-01-02"
"88058","2022","COM","2020","94","5","99","2023-01-02"
"88059","2022","COM","2020","395","11","406","2023-01-02"
"88060","2022","COM","2020","34","1","35","2023-01-02"
"88061","2022","COM","2020","294","13","307","2023-01-02"
"88062","2022","COM","2020","93","2","95","2023-01-02"
"88063","2022","COM","2020","135","6","141","2023-01-02"
"88064","2022","COM","2020","106","0","106","2023-01-02"
"88065","2022","COM","2020","281","5","286","2023-01-02"
"88066","2022","COM","2020","66","4","70","2023-01-02"
"88068","2022","COM","2020","903","20","923","2023-01-02"
"88069","2022","COM","2020","136","6","142","2023-01-02"
"88070","2022","COM","2020","176","1","177","2023-01-02"
"88071","2022","COM","2020","52","1","53","2023-01-02"
"88073","2022","COM","2020","209","3","212","2023-01-02"
"88074","2022","COM","2020","60","0","60","2023-01-02"
"88075","2022","COM","2020","4139","150","4289","2023-01-02"
"88076","2022","COM","2020","427","8","435","2023-01-02"
"88077","2022","COM","2020","568","13","581","2023-01-02"
"88078","2022","COM","2020","3028","41","3069","2023-01-02"
"88079","2022","COM","2020","1537","103","1640","2023-01-02"
"88080","2022","COM","2020","310","3","313","2023-01-02"
"88081","2022","COM","2020","1339","22","1361","2023-01-02"
"88082","2022","COM","2020","773","17","790","2023-01-02"
"88083","2022","COM","2020","213","10","223","2023-01-02"
"88084","2022","COM","2020","458","4","462","2023-01-02"
"88085","2022","COM","2020","191","2","193","2023-01-02"
"88086","2022","COM","2020","505","23","528","2023-01-02"
"88087","2022","COM","2020","3190","95","3285","2023-01-02"
"88088","2022","COM","2020","674","6","680","2023-01-02"
"88089","2022","COM","2020","555","13","568","2023-01-02"
"88090","2022","COM","2020","4625","52","4677","2023-01-02"
"88091","2022","COM","2020","384","9","393","2023-01-02"
"88092","2022","COM","2020","586","9","595","2023-01-02"
"88093","2022","COM","2020","39","1","40","2023-01-02"
"88094","2022","COM","2020","1718","48","1766","2023-01-02"
"88095","2022","COM","2020","1719","26","1745","2023-01-02"
"88096","2022","COM","2020","110","7","117","2023-01-02"
"88097","2022","COM","2020","42","0","42","2023-01-02"
"88098","2022","COM","2020","893","24","917","2023-01-02"
"88099","2022","COM","2020","1364","22","1386","2023-01-02"
"88100","2022","COM","2020","47","2","49","2023-01-02"
"88101","2022","COM","2020","1242","22","1264","2023-01-02"
"88102","2022","COM","2020","93","1","94","2023-01-02"
"88103","2022","COM","2020","85","0","85","2023-01-02"
"88104","2022","COM","2020","183","10","193","2023-01-02"
"88105","2022","COM","2020","213","4","217","2023-01-02"
"88106","2022","COM","2020","952","23","975","2023-01-02"
"88107","2022","COM","2020","32","0","32","2023-01-02"
"88108","2022","COM","2020","479","15","494","2023-01-02"
"88109","2022","COM","2020","647","13","660","2023-01-02"
"88110","2022","COM","2020","221","4","225","2023-01-02"
"88111","2022","COM","2020","352","4","356","2023-01-02"
"88113","2022","COM","2020","134","1","135","2023-01-02"
"88114","2022","COM","2020","3105","210","3315","2023-01-02"
"88115","2022","COM","2020","1500","12","1512","2023-01-02"
"88116","2022","COM","2020","3062","72","3134","2023-01-02"
"88117","2022","COM","2020","78","1","79","2023-01-02"
"88118","2022","COM","2020","711","17","728","2023-01-02"
"88119","2022","COM","2020","178","2","180","2023-01-02"
"88120","2022","COM","2020","478","9","487","2023-01-02"
"88121","2022","COM","2020","272","6","278","2023-01-02"
"88122","2022","COM","2020","367","7","374","2023-01-02"
"88123","2022","COM","2020","251","5","256","2023-01-02"
"88124","2022","COM","2020","1065","53","1118","2023-01-02"
"88125","2022","COM","2020","67","1","68","2023-01-02"
"88126","2022","COM","2020","1369","31","1400","2023-01-02"
"88127","2022","COM","2020","56","2","58","2023-01-02"
"88128","2022","COM","2020","249","6","255","2023-01-02"
"88129","2022","COM","2020","109","2","111","2023-01-02"
"88130","2022","COM","2020","244","5","249","2023-01-02"
"88131","2022","COM","2020","306","13","319","2023-01-02"
"88132","2022","COM","2020","1358","36","1394","2023-01-02"
"88133","2022","COM","2020","210","9","219","2023-01-02"
"88134","2022","COM","2020","633","16","649","2023-01-02"
"88135","2022","COM","2020","864","19","883","2023-01-02"
"88136","2022","COM","2020","1504","28","1532","2023-01-02"
"88137","2022","COM","2020","101","0","101","2023-01-02"
"88138","2022","COM","2020","78","2","80","2023-01-02"
"88139","2022","COM","2020","120","1","121","2023-01-02"
"88140","2022","COM","2020","367","14","381","2023-01-02"
"88141","2022","COM","2020","241","2","243","2023-01-02"
"88142","2022","COM","2020","420","9","429","2023-01-02"
"88143","2022","COM","2020","264","14","278","2023-01-02"
"88144","2022","COM","2020","58","0","58","2023-01-02"
"88145","2022","COM","2020","213","2","215","2023-01-02"
"88146","2022","COM","2020","174","2","176","2023-01-02"
"88147","2022","COM","2020","389","9","398","2023-01-02"
"88148","2022","COM","2020","1879","50","1929","2023-01-02"
"88149","2022","COM","2020","53","0","53","2023-01-02"
"88150","2022","COM","2020","295","6","301","2023-01-02"
"88151","2022","COM","2020","1098","26","1124","2023-01-02"
"88152","2022","COM","2020","244","14","258","2023-01-02"
"88153","2022","COM","2020","344","7","351","2023-01-02"
"88154","2022","COM","2020","88","2","90","2023-01-02"
"88155","2022","COM","2020","100","8","108","2023-01-02"
"88156","2022","COM","2020","140","0","140","2023-01-02"
"88157","2022","COM","2020","861","15","876","2023-01-02"
"88158","2022","COM","2020","3110","58","3168","2023-01-02"
"88159","2022","COM","2020","500","13","513","2023-01-02"
"88160","2022","COM","2020","31832","1385","33217","2023-01-02"
"88161","2022","COM","2020","418","10","428","2023-01-02"
"88162","2022","COM","2020","185","3","188","2023-01-02"
"88163","2022","COM","2020","746","9","755","2023-01-02"
"88164","2022","COM","2020","97","1","98","2023-01-02"
"88165","2022","COM","2020","2558","59","2617","2023-01-02"
"88166","2022","COM","2020","361","3","364","2023-01-02"
"88167","2022","COM","2020","231","3","234","2023-01-02"
"88168","2022","COM","2020","142","2","144","2023-01-02"
"88169","2022","COM","2020","212","6","218","2023-01-02"
"88170","2022","COM","2020","724","17","741","2023-01-02"
"88171","2022","COM","2020","48","1","49","2023-01-02"
"88172","2022","COM","2020","227","4","231","2023-01-02"
"88173","2022","COM","2020","477","12","489","2023-01-02"
"88174","2022","COM","2020","147","4","151","2023-01-02"
"88175","2022","COM","2020","462","18","480","2023-01-02"
"88176","2022","COM","2020","496","34","530","2023-01-02"
"88177","2022","COM","2020","518","9","527","2023-01-02"
"88178","2022","COM","2020","1811","69","1880","2023-01-02"
"88179","2022","COM","2020","43","3","46","2023-01-02"
"88180","2022","COM","2020","125","2","127","2023-01-02"
"88181","2022","COM","2020","2844","31","2875","2023-01-02"
"88182","2022","COM","2020","198","9","207","2023-01-02"
"88183","2022","COM","2020","343","7","350","2023-01-02"
"88184","2022","COM","2020","435","8","443","2023-01-02"
"88185","2022","COM","2020","108","4","112","2023-01-02"
"88186","2022","COM","2020","47","0","47","2023-01-02"
"88187","2022","COM","2020","53","3","56","2023-01-02"
"88188","2022","COM","2020","1719","35","1754","2023-01-02"
"88189","2022","COM","2020","131","4","135","2023-01-02"
"88190","2022","COM","2020","509","7","516","2023-01-02"
"88192","2022","COM","2020","107","1","108","2023-01-02"
"88193","2022","COM","2020","146","1","147","2023-01-02"
"88194","2022","COM","2020","135","12","147","2023-01-02"
"88195","2022","COM","2020","105","3","108","2023-01-02"
"88196","2022","COM","2020","7822","620","8442","2023-01-02"
"88197","2022","COM","2020","352","11","363","2023-01-02"
"88198","2022","COM","2020","580","17","597","2023-01-02"
"88199","2022","COM","2020","77","1","78","2023-01-02"
"88200","2022","COM","2020","56","1","57","2023-01-02"
"88201","2022","COM","2020","891","18","909","2023-01-02"
"88202","2022","COM","2020","194","3","197","2023-01-02"
"88203","2022","COM","2020","353","11","364","2023-01-02"
"88205","2022","COM","2020","253","17","270","2023-01-02"
"88206","2022","COM","2020","882","16","898","2023-01-02"
"88208","2022","COM","2020","115","4","119","2023-01-02"
"88209","2022","COM","2020","8882","119","9001","2023-01-02"
"88210","2022","COM","2020","172","3","175","2023-01-02"
"88212","2022","COM","2020","348","10","358","2023-01-02"
"88213","2022","COM","2020","137","0","137","2023-01-02"
"88214","2022","COM","2020","76","3","79","2023-01-02"
"88215","2022","COM","2020","77","2","79","2023-01-02"
"88216","2022","COM","2020","738","9","747","2023-01-02"
"88218","2022","COM","2020","2605","56","2661","2023-01-02"
"88219","2022","COM","2020","144","7","151","2023-01-02"
"88220","2022","COM","2020","47","1","48","2023-01-02"
"88221","2022","COM","2020","224","10","234","2023-01-02"
"88222","2022","COM","2020","258","19","277","2023-01-02"
"88223","2022","COM","2020","166","3","169","2023-01-02"
"88224","2022","COM","2020","380","11","391","2023-01-02"
"88225","2022","COM","2020","2357","102","2459","2023-01-02"
"88226","2022","COM","2020","128","3","131","2023-01-02"
"88227","2022","COM","2020","86","1","87","2023-01-02"
"88228","2022","COM","2020","178","4","182","2023-01-02"
"88229","2022","COM","2020","78","2","80","2023-01-02"
"88230","2022","COM","2020","38","1","39","2023-01-02"
"88231","2022","COM","2020","476","18","494","2023-01-02"
"88232","2022","COM","2020","217","3","220","2023-01-02"
"88233","2022","COM","2020","638","52","690","2023-01-02"
"88236","2022","COM","2020","131","0","131","2023-01-02"
"88237","2022","COM","2020","360","8","368","2023-01-02"
"88238","2022","COM","2020","389","12","401","2023-01-02"
"88239","2022","COM","2020","130","3","133","2023-01-02"
"88240","2022","COM","2020","278","1","279","2023-01-02"
"88241","2022","COM","2020","437","12","449","2023-01-02"
"88242","2022","COM","2020","43","1","44","2023-01-02"
"88243","2022","COM","2020","486","12","498","2023-01-02"
"88244","2022","COM","2020","527","17","544","2023-01-02"
"88245","2022","COM","2020","310","6","316","2023-01-02"
"88246","2022","COM","2020","488","12","500","2023-01-02"
"88247","2022","COM","2020","1156","14","1170","2023-01-02"
"88248","2022","COM","2020","173","4","177","2023-01-02"
"88249","2022","COM","2020","74","3","77","2023-01-02"
"88250","2022","COM","2020","481","5","486","2023-01-02"
"88251","2022","COM","2020","1115","25","1140","2023-01-02"
"88252","2022","COM","2020","138","1","139","2023-01-02"
"88253","2022","COM","2020","680","13","693","2023-01-02"
"88254","2022","COM","2020","83","1","84","2023-01-02"
"88255","2022","COM","2020","91","3","94","2023-01-02"
"88256","2022","COM","2020","268","2","270","2023-01-02"
"88257","2022","COM","2020","181","2","183","2023-01-02"
"88258","2022","COM","2020","849","16","865","2023-01-02"
"88259","2022","COM","2020","298","9","307","2023-01-02"
"88260","2022","COM","2020","152","1","153","2023-01-02"
"88261","2022","COM","2020","631","9","640","2023-01-02"
"88262","2022","COM","2020","580","11","591","2023-01-02"
"88263","2022","COM","2020","204","6","210","2023-01-02"
"88264","2022","COM","2020","61","3","64","2023-01-02"
"88265","2022","COM","2020","28","0","28","2023-01-02"
"88266","2022","COM","2020","827","16","843","2023-01-02"
"88267","2022","COM","2020","447","16","463","2023-01-02"
"88268","2022","COM","2020","139","8","147","2023-01-02"
"88269","2022","COM","2020","297","7","304","2023-01-02"
"88270","2022","COM","2020","2124","60","2184","2023-01-02"
"88271","2022","COM","2020","302","7","309","2023-01-02"
"88272","2022","COM","2020","73","0","73","2023-01-02"
"88273","2022","COM","2020","453","8","461","2023-01-02"
"88274","2022","COM","2020","81","2","83","2023-01-02"
"88275","2022","COM","2020","242","2","244","2023-01-02"
"88276","2022","COM","2020","376","15","391","2023-01-02"
"88277","2022","COM","2020","113","3","116","2023-01-02"
"88278","2022","COM","2020","70","1","71","2023-01-02"
"88279","2022","COM","2020","47","1","48","2023-01-02"
"88280","2022","COM","2020","143","0","143","2023-01-02"
"88281","2022","COM","2020","407","12","419","2023-01-02"
"88283","2022","COM","2020","79","2","81","2023-01-02"
"88284","2022","COM","2020","580","11","591","2023-01-02"
"88285","2022","COM","2020","440","127","567","2023-01-02"
"88286","2022","COM","2020","97","0","97","2023-01-02"
"88287","2022","COM","2020","66","1","67","2023-01-02"
"88288","2022","COM","2020","6","0","6","2023-01-02"
"88289","2022","COM","2020","807","66","873","2023-01-02"
"88290","2022","COM","2020","111","2","113","2023-01-02"
"88291","2022","COM","2020","132","3","135","2023-01-02"
"88292","2022","COM","2020","799","24","823","2023-01-02"
"88293","2022","COM","2020","216","4","220","2023-01-02"
"88294","2022","COM","2020","261","3","264","2023-01-02"
"88295","2022","COM","2020","232","7","239","2023-01-02"
"88296","2022","COM","2020","61","0","61","2023-01-02"
"88297","2022","COM","2020","162","4","166","2023-01-02"
"88298","2022","COM","2020","62","0","62","2023-01-02"
"88299","2022","COM","2020","154","2","156","2023-01-02"
"88300","2022","COM","2020","127","6","133","2023-01-02"
"88301","2022","COM","2020","292","11","303","2023-01-02"
"88302","2022","COM","2020","1005","23","1028","2023-01-02"
"88303","2022","COM","2020","188","1","189","2023-01-02"
"88304","2022","COM","2020","4819","473","5292","2023-01-02"
"88305","2022","COM","2020","192","5","197","2023-01-02"
"88306","2022","COM","2020","51","0","51","2023-01-02"
"88307","2022","COM","2020","98","2","100","2023-01-02"
"88308","2022","COM","2020","300","5","305","2023-01-02"
"88309","2022","COM","2020","164","4","168","2023-01-02"
"88310","2022","COM","2020","896","18","914","2023-01-02"
"88311","2022","COM","2020","37","0","37","2023-01-02"
"88312","2022","COM","2020","195","4","199","2023-01-02"
"88313","2022","COM","2020","421","9","430","2023-01-02"
"88314","2022","COM","2020","99","4","103","2023-01-02"
"88315","2022","COM","2020","173","2","175","2023-01-02"
"88316","2022","COM","2020","46","1","47","2023-01-02"
"88317","2022","COM","2020","561","5","566","2023-01-02"
"88318","2022","COM","2020","226","5","231","2023-01-02"
"88319","2022","COM","2020","3065","63","3128","2023-01-02"
"88320","2022","COM","2020","773","36","809","2023-01-02"
"88321","2022","COM","2020","6644","281","6925","2023-01-02"
"88322","2022","COM","2020","508","14","522","2023-01-02"
"88324","2022","COM","2020","377","10","387","2023-01-02"
"88325","2022","COM","2020","189","8","197","2023-01-02"
"88326","2022","COM","2020","354","11","365","2023-01-02"
"88327","2022","COM","2020","1955","22","1977","2023-01-02"
"88328","2022","COM","2020","533","23","556","2023-01-02"
"88330","2022","COM","2020","193","1","194","2023-01-02"
"88331","2022","COM","2020","54","2","56","2023-01-02"
"88332","2022","COM","2020","213","6","219","2023-01-02"
"88333","2022","COM","2020","126","1","127","2023-01-02"
"88334","2022","COM","2020","297","7","304","2023-01-02"
"88335","2022","COM","2020","154","3","157","2023-01-02"
"88336","2022","COM","2020","74","1","75","2023-01-02"
"88338","2022","COM","2020","84","0","84","2023-01-02"
"88340","2022","COM","2020","492","9","501","2023-01-02"
"88341","2022","COM","2020","502","17","519","2023-01-02"
"88342","2022","COM","2020","168","3","171","2023-01-02"
"88343","2022","COM","2020","163","4","167","2023-01-02"
"88344","2022","COM","2020","181","5","186","2023-01-02"
"88345","2022","COM","2020","70","4","74","2023-01-02"
"88346","2022","COM","2020","739","10","749","2023-01-02"
"88347","2022","COM","2020","117","1","118","2023-01-02"
"88348","2022","COM","2020","135","3","138","2023-01-02"
"88349","2022","COM","2020","1627","20","1647","2023-01-02"
"88350","2022","COM","2020","76","2","78","2023-01-02"
"88351","2022","COM","2020","1566","33","1599","2023-01-02"
"88352","2022","COM","2020","194","5","199","2023-01-02"
"88353","2022","COM","2020","106","3","109","2023-01-02"
"88354","2022","COM","2020","188","0","188","2023-01-02"
"88355","2022","COM","2020","1230","21","1251","2023-01-02"
"88356","2022","COM","2020","287","5","292","2023-01-02"
"88357","2022","COM","2020","675","21","696","2023-01-02"
"88358","2022","COM","2020","1968","34","2002","2023-01-02"
"88359","2022","COM","2020","90","2","92","2023-01-02"
"88360","2022","COM","2020","149","5","154","2023-01-02"
"88361","2022","COM","2020","1328","115","1443","2023-01-02"
"88362","2022","COM","2020","114","1","115","2023-01-02"
"88363","2022","COM","2020","153","5","158","2023-01-02"
"88364","2022","COM","2020","147","3","150","2023-01-02"
"88365","2022","COM","2020","152","9","161","2023-01-02"
"88366","2022","COM","2020","281","13","294","2023-01-02"
"88367","2022","COM","2020","5072","134","5206","2023-01-02"
"88368","2022","COM","2020","177","3","180","2023-01-02"
"88369","2022","COM","2020","1869","132","2001","2023-01-02"
"88370","2022","COM","2020","66","0","66","2023-01-02"
"88371","2022","COM","2020","1221","33","1254","2023-01-02"
"88372","2022","COM","2020","6113","134","6247","2023-01-02"
"88373","2022","COM","2020","147","2","149","2023-01-02"
"88374","2022","COM","2020","23","0","23","2023-01-02"
"88375","2022","COM","2020","474","9","483","2023-01-02"
"88376","2022","COM","2020","281","7","288","2023-01-02"
"88377","2022","COM","2020","122","2","124","2023-01-02"
"88378","2022","COM","2020","99","2","101","2023-01-02"
"88379","2022","COM","2020","356","6","362","2023-01-02"
"88380","2022","COM","2020","208","2","210","2023-01-02"
"88381","2022","COM","2020","196","8","204","2023-01-02"
"88382","2022","COM","2020","66","1","67","2023-01-02"
"88383","2022","COM","2020","7711","299","8010","2023-01-02"
"88385","2022","COM","2020","573","9","582","2023-01-02"
"88386","2022","COM","2020","446","4","450","2023-01-02"
"88387","2022","COM","2020","209","3","212","2023-01-02"
"88388","2022","COM","2020","120","3","123","2023-01-02"
"88389","2022","COM","2020","81","0","81","2023-01-02"
"88390","2022","COM","2020","105","8","113","2023-01-02"
"88391","2022","COM","2020","680","17","697","2023-01-02"
"88393","2022","COM","2020","315","9","324","2023-01-02"
"88394","2022","COM","2020","49","1","50","2023-01-02"
"88395","2022","COM","2020","369","8","377","2023-01-02"
"88398","2022","COM","2020","82","4","86","2023-01-02"
"88399","2022","COM","2020","206","3","209","2023-01-02"
"88400","2022","COM","2020","268","12","280","2023-01-02"
"88401","2022","COM","2020","452","9","461","2023-01-02"
"88402","2022","COM","2020","370","139","509","2023-01-02"
"88403","2022","COM","2020","187","2","189","2023-01-02"
"88404","2022","COM","2020","68","1","69","2023-01-02"
"88406","2022","COM","2020","131","1","132","2023-01-02"
"88407","2022","COM","2020","141","3","144","2023-01-02"
"88408","2022","COM","2020","3536","66","3602","2023-01-02"
"88409","2022","COM","2020","2161","38","2199","2023-01-02"
"88410","2022","COM","2020","271","2","273","2023-01-02"
"88411","2022","COM","2020","77","1","78","2023-01-02"
"88412","2022","COM","2020","449","6","455","2023-01-02"
"88413","2022","COM","2020","19490","446","19936","2023-01-02"
"88415","2022","COM","2020","3827","76","3903","2023-01-02"
"88416","2022","COM","2020","135","2","137","2023-01-02"
"88417","2022","COM","2020","379","9","388","2023-01-02"
"88418","2022","COM","2020","452","4","456","2023-01-02"
"88419","2022","COM","2020","117","0","117","2023-01-02"
"88421","2022","COM","2020","102","2","104","2023-01-02"
"88423","2022","COM","2020","1359","23","1382","2023-01-02"
"88424","2022","COM","2020","2286","65","2351","2023-01-02"
"88425","2022","COM","2020","179","4","183","2023-01-02"
"88426","2022","COM","2020","1369","33","1402","2023-01-02"
"88427","2022","COM","2020","125","0","125","2023-01-02"
"88428","2022","COM","2020","1820","57","1877","2023-01-02"
"88429","2022","COM","2020","3992","257","4249","2023-01-02"
"88430","2022","COM","2020","501","13","514","2023-01-02"
"88431","2022","COM","2020","159","2","161","2023-01-02"
"88432","2022","COM","2020","152","3","155","2023-01-02"
"88433","2022","COM","2020","73","1","74","2023-01-02"
"88434","2022","COM","2020","220","4","224","2023-01-02"
"88435","2022","COM","2020","517","12","529","2023-01-02"
"88436","2022","COM","2020","72","0","72","2023-01-02"
"88437","2022","COM","2020","100","3","103","2023-01-02"
"88438","2022","COM","2020","392","6","398","2023-01-02"
"88439","2022","COM","2020","947","37","984","2023-01-02"
"88440","2022","COM","2020","168","4","172","2023-01-02"
"88441","2022","COM","2020","128","2","130","2023-01-02"
"88442","2022","COM","2020","633","10","643","2023-01-02"
"88443","2022","COM","2020","95","2","97","2023-01-02"
"88444","2022","COM","2020","317","8","325","2023-01-02"
"88445","2022","COM","2020","2323","55","2378","2023-01-02"
"88446","2022","COM","2020","244","3","247","2023-01-02"
"88447","2022","COM","2020","2514","80","2594","2023-01-02"
"88448","2022","COM","2020","176","7","183","2023-01-02"
"88449","2022","COM","2020","187","0","187","2023-01-02"
"88450","2022","COM","2020","183","4","187","2023-01-02"
"88451","2022","COM","2020","2394","35","2429","2023-01-02"
"88452","2022","COM","2020","134","0","134","2023-01-02"
"88453","2022","COM","2020","34","0","34","2023-01-02"
"88454","2022","COM","2020","226","10","236","2023-01-02"
"88455","2022","COM","2020","98","2","100","2023-01-02"
"88456","2022","COM","2020","84","3","87","2023-01-02"
"88457","2022","COM","2020","145","1","146","2023-01-02"
"88458","2022","COM","2020","283","3","286","2023-01-02"
"88459","2022","COM","2020","43","1","44","2023-01-02"
"88460","2022","COM","2020","658","13","671","2023-01-02"
"88461","2022","COM","2020","210","5","215","2023-01-02"
"88462","2022","COM","2020","1887","40","1927","2023-01-02"
"88463","2022","COM","2020","1505","34","1539","2023-01-02"
"88464","2022","COM","2020","510","7","517","2023-01-02"
"88465","2022","COM","2020","8583","216","8799","2023-01-02"
"88466","2022","COM","2020","127","5","132","2023-01-02"
"88467","2022","COM","2020","573","14","587","2023-01-02"
"88468","2022","COM","2020","3316","56","3372","2023-01-02"
"88469","2022","COM","2020","99","6","105","2023-01-02"
"88470","2022","COM","2020","1536","38","1574","2023-01-02"
"88471","2022","COM","2020","101","1","102","2023-01-02"
"88472","2022","COM","2020","115","4","119","2023-01-02"
"88473","2022","COM","2020","98","5","103","2023-01-02"
"88474","2022","COM","2020","66","0","66","2023-01-02"
"88475","2022","COM","2020","118","5","123","2023-01-02"
"88476","2022","COM","2020","120","1","121","2023-01-02"
"88477","2022","COM","2020","99","1","100","2023-01-02"
"88478","2022","COM","2020","103","1","104","2023-01-02"
"88479","2022","COM","2020","251","6","257","2023-01-02"
"88480","2022","COM","2020","167","0","167","2023-01-02"
"88481","2022","COM","2020","1331","22","1353","2023-01-02"
"88482","2022","COM","2020","56","2","58","2023-01-02"
"88483","2022","COM","2020","2281","56","2337","2023-01-02"
"88484","2022","COM","2020","1040","26","1066","2023-01-02"
"88485","2022","COM","2020","117","0","117","2023-01-02"
"88486","2022","COM","2020","3900","108","4008","2023-01-02"
"88487","2022","COM","2020","3860","95","3955","2023-01-02"
"88488","2022","COM","2020","233","5","238","2023-01-02"
"88489","2022","COM","2020","253","8","261","2023-01-02"
"88490","2022","COM","2020","183","4","187","2023-01-02"
"88491","2022","COM","2020","117","5","122","2023-01-02"
"88492","2022","COM","2020","74","1","75","2023-01-02"
"88493","2022","COM","2020","23","1","24","2023-01-02"
"88494","2022","COM","2020","119","2","121","2023-01-02"
"88495","2022","COM","2020","185","6","191","2023-01-02"
"88496","2022","COM","2020","161","3","164","2023-01-02"
"88497","2022","COM","2020","463","3","466","2023-01-02"
"88498","2022","COM","2020","848","20","868","2023-01-02"
"88499","2022","COM","2020","159","3","162","2023-01-02"
"88500","2022","COM","2020","832","14","846","2023-01-02"
"88501","2022","COM","2020","72","0","72","2023-01-02"
"88502","2022","COM","2020","134","2","136","2023-01-02"
"88503","2022","COM","2020","148","2","150","2023-01-02"
"88504","2022","COM","2020","191","2","193","2023-01-02"
"88505","2022","COM","2020","125","2","127","2023-01-02"
"88506","2022","COM","2020","311","6","317","2023-01-02"
"88507","2022","COM","2020","196","6","202","2023-01-02"
"88508","2022","COM","2020","533","11","544","2023-01-02"
"88509","2022","COM","2020","108","1","109","2023-01-02"
"88510","2022","COM","2020","143","6","149","2023-01-02"
"88511","2022","COM","2020","87","2","89","2023-01-02"
"88512","2022","COM","2020","247","4","251","2023-01-02"
"88513","2022","COM","2020","2151","39","2190","2023-01-02"
"88514","2022","COM","2020","162","7","169","2023-01-02"
"88515","2022","COM","2020","154","2","156","2023-01-02"
"88516","2022","COM","2020","4805","138","4943","2023-01-02"
"88517","2022","COM","2020","195","5","200","2023-01-02"
"88518","2022","COM","2020","34","0","34","2023-01-02"
"88519","2022","COM","2020","672","21","693","2023-01-02"
"88520","2022","COM","2020","292","9","301","2023-01-02"
"88521","2022","COM","2020","252","3","255","2023-01-02"
"88522","2022","COM","2020","69","3","72","2023-01-02"
"88523","2022","COM","2020","160","5","165","2023-01-02"
"88524","2022","COM","2020","352","4","356","2023-01-02"
"88525","2022","COM","2020","131","2","133","2023-01-02"
"88526","2022","COM","2020","423","8","431","2023-01-02"
"88527","2022","COM","2020","140","2","142","2023-01-02"
"88528","2022","COM","2020","154","3","157","2023-01-02"
"88529","2022","COM","2020","111","4","115","2023-01-02"
"88530","2022","COM","2020","2583","52","2635","2023-01-02"
"88531","2022","COM","2020","1500","32","1532","2023-01-02"
"88532","2022","COM","2020","77","4","81","2023-01-02"
"89002","2022","COM","2020","75","5","80","2023-01-02"
"89003","2022","COM","2020","2814","87","2901","2023-01-02"
"89004","2022","COM","2020","237","11","248","2023-01-02"
"89005","2022","COM","2020","843","22","865","2023-01-02"
"89006","2022","COM","2020","149","6","155","2023-01-02"
"89007","2022","COM","2020","438","12","450","2023-01-02"
"89008","2022","COM","2020","156","5","161","2023-01-02"
"89009","2022","COM","2020","350","17","367","2023-01-02"
"89010","2022","COM","2020","205","5","210","2023-01-02"
"89011","2022","COM","2020","120","10","130","2023-01-02"
"89012","2022","COM","2020","83","2","85","2023-01-02"
"89013","2022","COM","2020","3207","86","3293","2023-01-02"
"89014","2022","COM","2020","608","10","618","2023-01-02"
"89015","2022","COM","2020","469","12","481","2023-01-02"
"89016","2022","COM","2020","76","3","79","2023-01-02"
"89017","2022","COM","2020","219","2","221","2023-01-02"
"89018","2022","COM","2020","767","9","776","2023-01-02"
"89019","2022","COM","2020","151","1","152","2023-01-02"
"89020","2022","COM","2020","113","2","115","2023-01-02"
"89021","2022","COM","2020","287","13","300","2023-01-02"
"89022","2022","COM","2020","131","3","134","2023-01-02"
"89023","2022","COM","2020","983","22","1005","2023-01-02"
"89024","2022","COM","2020","34151","1093","35244","2023-01-02"
"89025","2022","COM","2020","6414","221","6635","2023-01-02"
"89027","2022","COM","2020","200","5","205","2023-01-02"
"89028","2022","COM","2020","61","5","66","2023-01-02"
"89029","2022","COM","2020","880","19","899","2023-01-02"
"89030","2022","COM","2020","417","9","426","2023-01-02"
"89031","2022","COM","2020","628","13","641","2023-01-02"
"89032","2022","COM","2020","64","3","67","2023-01-02"
"89033","2022","COM","2020","395","11","406","2023-01-02"
"89034","2022","COM","2020","462","16","478","2023-01-02"
"89035","2022","COM","2020","440","12","452","2023-01-02"
"89036","2022","COM","2020","237","10","247","2023-01-02"
"89037","2022","COM","2020","520","21","541","2023-01-02"
"89038","2022","COM","2020","113","0","113","2023-01-02"
"89039","2022","COM","2020","76","4","80","2023-01-02"
"89040","2022","COM","2020","187","4","191","2023-01-02"
"89041","2022","COM","2020","301","14","315","2023-01-02"
"89042","2022","COM","2020","162","5","167","2023-01-02"
"89043","2022","COM","2020","99","1","100","2023-01-02"
"89044","2022","COM","2020","103","1","104","2023-01-02"
"89045","2022","COM","2020","284","6","290","2023-01-02"
"89046","2022","COM","2020","1164","20","1184","2023-01-02"
"89048","2022","COM","2020","340","6","346","2023-01-02"
"89049","2022","COM","2020","22","1","23","2023-01-02"
"89050","2022","COM","2020","873","20","893","2023-01-02"
"89051","2022","COM","2020","538","12","550","2023-01-02"
"89053","2022","COM","2020","436","10","446","2023-01-02"
"89054","2022","COM","2020","787","11","798","2023-01-02"
"89055","2022","COM","2020","3160","55","3215","2023-01-02"
"89056","2022","COM","2020","620","21","641","2023-01-02"
"89057","2022","COM","2020","303","5","308","2023-01-02"
"89058","2022","COM","2020","119","3","122","2023-01-02"
"89059","2022","COM","2020","707","9","716","2023-01-02"
"89060","2022","COM","2020","456","10","466","2023-01-02"
"89061","2022","COM","2020","247","1","248","2023-01-02"
"89062","2022","COM","2020","362","4","366","2023-01-02"
"89063","2022","COM","2020","815","18","833","2023-01-02"
"89064","2022","COM","2020","56","1","57","2023-01-02"
"89065","2022","COM","2020","43","0","43","2023-01-02"
"89066","2022","COM","2020","972","23","995","2023-01-02"
"89067","2022","COM","2020","1102","24","1126","2023-01-02"
"89068","2022","COM","2020","2171","39","2210","2023-01-02"
"89069","2022","COM","2020","519","10","529","2023-01-02"
"89071","2022","COM","2020","101","2","103","2023-01-02"
"89072","2022","COM","2020","307","0","307","2023-01-02"
"89073","2022","COM","2020","911","42","953","2023-01-02"
"89074","2022","COM","2020","2105","41","2146","2023-01-02"
"89075","2022","COM","2020","725","14","739","2023-01-02"
"89076","2022","COM","2020","790","12","802","2023-01-02"
"89077","2022","COM","2020","1576","93","1669","2023-01-02"
"89079","2022","COM","2020","658","15","673","2023-01-02"
"89080","2022","COM","2020","650","17","667","2023-01-02"
"89081","2022","COM","2020","91","0","91","2023-01-02"
"89083","2022","COM","2020","1867","48","1915","2023-01-02"
"89084","2022","COM","2020","281","7","288","2023-01-02"
"89085","2022","COM","2020","1109","26","1135","2023-01-02"
"89086","2022","COM","2020","4759","77","4836","2023-01-02"
"89087","2022","COM","2020","299","9","308","2023-01-02"
"89088","2022","COM","2020","467","9","476","2023-01-02"
"89089","2022","COM","2020","135","4","139","2023-01-02"
"89091","2022","COM","2020","571","14","585","2023-01-02"
"89092","2022","COM","2020","204","9","213","2023-01-02"
"89093","2022","COM","2020","645","12","657","2023-01-02"
"89094","2022","COM","2020","703","12","715","2023-01-02"
"89095","2022","COM","2020","138","8","146","2023-01-02"
"89096","2022","COM","2020","904","26","930","2023-01-02"
"89098","2022","COM","2020","228","7","235","2023-01-02"
"89099","2022","COM","2020","2287","46","2333","2023-01-02"
"89100","2022","COM","2020","1705","23","1728","2023-01-02"
"89101","2022","COM","2020","553","11","564","2023-01-02"
"89102","2022","COM","2020","2165","68","2233","2023-01-02"
"89104","2022","COM","2020","302","10","312","2023-01-02"
"89105","2022","COM","2020","467","12","479","2023-01-02"
"89108","2022","COM","2020","341","9","350","2023-01-02"
"89111","2022","COM","2020","299","5","304","2023-01-02"
"89112","2022","COM","2020","159","8","167","2023-01-02"
"89113","2022","COM","2020","671","14","685","2023-01-02"
"89115","2022","COM","2020","198","4","202","2023-01-02"
"89116","2022","COM","2020","360","7","367","2023-01-02"
"89117","2022","COM","2020","217","1","218","2023-01-02"
"89118","2022","COM","2020","794","20","814","2023-01-02"
"89119","2022","COM","2020","511","10","521","2023-01-02"
"89120","2022","COM","2020","133","5","138","2023-01-02"
"89122","2022","COM","2020","566","8","574","2023-01-02"
"89123","2022","COM","2020","261","8","269","2023-01-02"
"89124","2022","COM","2020","1189","20","1209","2023-01-02"
"89125","2022","COM","2020","924","13","937","2023-01-02"
"89126","2022","COM","2020","31","1","32","2023-01-02"
"89127","2022","COM","2020","782","24","806","2023-01-02"
"89128","2022","COM","2020","138","4","142","2023-01-02"
"89129","2022","COM","2020","410","9","419","2023-01-02"
"89130","2022","COM","2020","1265","30","1295","2023-01-02"
"89131","2022","COM","2020","230","4","234","2023-01-02"
"89132","2022","COM","2020","163","6","169","2023-01-02"
"89133","2022","COM","2020","365","4","369","2023-01-02"
"89134","2022","COM","2020","326","8","334","2023-01-02"
"89136","2022","COM","2020","860","29","889","2023-01-02"
"89137","2022","COM","2020","468","10","478","2023-01-02"
"89139","2022","COM","2020","1083","37","1120","2023-01-02"
"89141","2022","COM","2020","118","7","125","2023-01-02"
"89142","2022","COM","2020","911","15","926","2023-01-02"
"89143","2022","COM","2020","315","2","317","2023-01-02"
"89144","2022","COM","2020","806","8","814","2023-01-02"
"89145","2022","COM","2020","388","5","393","2023-01-02"
"89146","2022","COM","2020","86","2","88","2023-01-02"
"89147","2022","COM","2020","242","2","244","2023-01-02"
"89148","2022","COM","2020","267","5","272","2023-01-02"
"89149","2022","COM","2020","205","3","208","2023-01-02"
"89150","2022","COM","2020","450","9","459","2023-01-02"
"89151","2022","COM","2020","1372","21","1393","2023-01-02"
"89152","2022","COM","2020","740","12","752","2023-01-02"
"89153","2022","COM","2020","533","16","549","2023-01-02"
"89154","2022","COM","2020","887","25","912","2023-01-02"
"89155","2022","COM","2020","709","11","720","2023-01-02"
"89156","2022","COM","2020","395","7","402","2023-01-02"
"89158","2022","COM","2020","624","14","638","2023-01-02"
"89159","2022","COM","2020","390","10","400","2023-01-02"
"89160","2022","COM","2020","763","23","786","2023-01-02"
"89161","2022","COM","2020","192","5","197","2023-01-02"
"89162","2022","COM","2020","393","3","396","2023-01-02"
"89163","2022","COM","2020","524","11","535","2023-01-02"
"89164","2022","COM","2020","92","0","92","2023-01-02"
"89165","2022","COM","2020","112","2","114","2023-01-02"
"89167","2022","COM","2020","1081","31","1112","2023-01-02"
"89168","2022","COM","2020","176","3","179","2023-01-02"
"89169","2022","COM","2020","946","23","969","2023-01-02"
"89170","2022","COM","2020","121","3","124","2023-01-02"
"89171","2022","COM","2020","290","3","293","2023-01-02"
"89172","2022","COM","2020","502","25","527","2023-01-02"
"89173","2022","COM","2020","467","7","474","2023-01-02"
"89175","2022","COM","2020","145","4","149","2023-01-02"
"89176","2022","COM","2020","138","3","141","2023-01-02"
"89177","2022","COM","2020","73","0","73","2023-01-02"
"89179","2022","COM","2020","298","9","307","2023-01-02"
"89180","2022","COM","2020","496","11","507","2023-01-02"
"89181","2022","COM","2020","118","2","120","2023-01-02"
"89182","2022","COM","2020","174","4","178","2023-01-02"
"89183","2022","COM","2020","66","0","66","2023-01-02"
"89184","2022","COM","2020","130","2","132","2023-01-02"
"89186","2022","COM","2020","521","13","534","2023-01-02"
"89187","2022","COM","2020","83","2","85","2023-01-02"
"89188","2022","COM","2020","166","6","172","2023-01-02"
"89189","2022","COM","2020","571","19","590","2023-01-02"
"89190","2022","COM","2020","178","8","186","2023-01-02"
"89191","2022","COM","2020","46","2","48","2023-01-02"
"89194","2022","COM","2020","114","6","120","2023-01-02"
"89195","2022","COM","2020","1242","73","1315","2023-01-02"
"89196","2022","COM","2020","1752","51","1803","2023-01-02"
"89197","2022","COM","2020","736","15","751","2023-01-02"
"89198","2022","COM","2020","1702","36","1738","2023-01-02"
"89199","2022","COM","2020","453","9","462","2023-01-02"
"89200","2022","COM","2020","391","6","397","2023-01-02"
"89201","2022","COM","2020","1774","40","1814","2023-01-02"
"89202","2022","COM","2020","256","7","263","2023-01-02"
"89203","2022","COM","2020","188","5","193","2023-01-02"
"89204","2022","COM","2020","660","14","674","2023-01-02"
"89205","2022","COM","2020","575","4","579","2023-01-02"
"89206","2022","COM","2020","9381","310","9691","2023-01-02"
"89207","2022","COM","2020","26","0","26","2023-01-02"
"89208","2022","COM","2020","1152","18","1170","2023-01-02"
"89209","2022","COM","2020","512","11","523","2023-01-02"
"89210","2022","COM","2020","128","7","135","2023-01-02"
"89211","2022","COM","2020","68","0","68","2023-01-02"
"89212","2022","COM","2020","364","14","378","2023-01-02"
"89214","2022","COM","2020","195","2","197","2023-01-02"
"89215","2022","COM","2020","185","4","189","2023-01-02"
"89216","2022","COM","2020","319","10","329","2023-01-02"
"89217","2022","COM","2020","136","3","139","2023-01-02"
"89218","2022","COM","2020","1258","24","1282","2023-01-02"
"89219","2022","COM","2020","143","1","144","2023-01-02"
"89220","2022","COM","2020","436","2","438","2023-01-02"
"89221","2022","COM","2020","320","5","325","2023-01-02"
"89222","2022","COM","2020","218","6","224","2023-01-02"
"89223","2022","COM","2020","662","17","679","2023-01-02"
"89224","2022","COM","2020","154","3","157","2023-01-02"
"89225","2022","COM","2020","43","0","43","2023-01-02"
"89226","2022","COM","2020","188","5","193","2023-01-02"
"89227","2022","COM","2020","1201","27","1228","2023-01-02"
"89228","2022","COM","2020","1373","47","1420","2023-01-02"
"89229","2022","COM","2020","476","13","489","2023-01-02"
"89230","2022","COM","2020","438","21","459","2023-01-02"
"89232","2022","COM","2020","300","14","314","2023-01-02"
"89233","2022","COM","2020","198","5","203","2023-01-02"
"89234","2022","COM","2020","119","2","121","2023-01-02"
"89235","2022","COM","2020","874","23","897","2023-01-02"
"89236","2022","COM","2020","1206","29","1235","2023-01-02"
"89237","2022","COM","2020","492","9","501","2023-01-02"
"89238","2022","COM","2020","540","7","547","2023-01-02"
"89239","2022","COM","2020","1558","45","1603","2023-01-02"
"89240","2022","COM","2020","321","10","331","2023-01-02"
"89242","2022","COM","2020","797","15","812","2023-01-02"
"89244","2022","COM","2020","83","4","87","2023-01-02"
"89245","2022","COM","2020","835","18","853","2023-01-02"
"89246","2022","COM","2020","349","7","356","2023-01-02"
"89247","2022","COM","2020","229","2","231","2023-01-02"
"89248","2022","COM","2020","40","2","42","2023-01-02"
"89249","2022","COM","2020","77","1","78","2023-01-02"
"89250","2022","COM","2020","204","3","207","2023-01-02"
"89251","2022","COM","2020","367","9","376","2023-01-02"
"89252","2022","COM","2020","178","4","182","2023-01-02"
"89253","2022","COM","2020","194","4","198","2023-01-02"
"89254","2022","COM","2020","518","8","526","2023-01-02"
"89255","2022","COM","2020","1071","23","1094","2023-01-02"
"89256","2022","COM","2020","409","2","411","2023-01-02"
"89257","2022","COM","2020","7274","128","7402","2023-01-02"
"89259","2022","COM","2020","94","2","96","2023-01-02"
"89261","2022","COM","2020","275","6","281","2023-01-02"
"89262","2022","COM","2020","170","8","178","2023-01-02"
"89263","2022","COM","2020","4110","83","4193","2023-01-02"
"89264","2022","COM","2020","715","26","741","2023-01-02"
"89265","2022","COM","2020","579","20","599","2023-01-02"
"89266","2022","COM","2020","255","6","261","2023-01-02"
"89267","2022","COM","2020","177","6","183","2023-01-02"
"89268","2022","COM","2020","787","19","806","2023-01-02"
"89270","2022","COM","2020","126","2","128","2023-01-02"
"89271","2022","COM","2020","105","1","106","2023-01-02"
"89272","2022","COM","2020","288","2","290","2023-01-02"
"89273","2022","COM","2020","275","3","278","2023-01-02"
"89274","2022","COM","2020","1333","37","1370","2023-01-02"
"89276","2022","COM","2020","877","38","915","2023-01-02"
"89277","2022","COM","2020","366","11","377","2023-01-02"
"89278","2022","COM","2020","550","5","555","2023-01-02"
"89279","2022","COM","2020","593","19","612","2023-01-02"
"89280","2022","COM","2020","392","9","401","2023-01-02"
"89281","2022","COM","2020","336","5","341","2023-01-02"
"89282","2022","COM","2020","675","11","686","2023-01-02"
"89283","2022","COM","2020","595","16","611","2023-01-02"
"89284","2022","COM","2020","179","4","183","2023-01-02"
"89285","2022","COM","2020","316","3","319","2023-01-02"
"89286","2022","COM","2020","833","16","849","2023-01-02"
"89287","2022","COM","2020","4825","118","4943","2023-01-02"
"89288","2022","COM","2020","171","8","179","2023-01-02"
"89289","2022","COM","2020","280","13","293","2023-01-02"
"89290","2022","COM","2020","43","1","44","2023-01-02"
"89291","2022","COM","2020","338","10","348","2023-01-02"
"89292","2022","COM","2020","248","5","253","2023-01-02"
"89295","2022","COM","2020","1266","31","1297","2023-01-02"
"89296","2022","COM","2020","129","1","130","2023-01-02"
"89297","2022","COM","2020","107","1","108","2023-01-02"
"89298","2022","COM","2020","598","11","609","2023-01-02"
"89299","2022","COM","2020","63","2","65","2023-01-02"
"89300","2022","COM","2020","81","1","82","2023-01-02"
"89302","2022","COM","2020","209","3","212","2023-01-02"
"89303","2022","COM","2020","247","6","253","2023-01-02"
"89304","2022","COM","2020","675","22","697","2023-01-02"
"89306","2022","COM","2020","363","11","374","2023-01-02"
"89307","2022","COM","2020","754","10","764","2023-01-02"
"89308","2022","COM","2020","184","7","191","2023-01-02"
"89309","2022","COM","2020","3316","59","3375","2023-01-02"
"89310","2022","COM","2020","138","3","141","2023-01-02"
"89311","2022","COM","2020","1356","27","1383","2023-01-02"
"89312","2022","COM","2020","245","5","250","2023-01-02"
"89313","2022","COM","2020","419","16","435","2023-01-02"
"89314","2022","COM","2020","181","1","182","2023-01-02"
"89315","2022","COM","2020","159","1","160","2023-01-02"
"89316","2022","COM","2020","252","6","258","2023-01-02"
"89318","2022","COM","2020","628","20","648","2023-01-02"
"89319","2022","COM","2020","483","14","497","2023-01-02"
"89320","2022","COM","2020","65","2","67","2023-01-02"
"89321","2022","COM","2020","712","18","730","2023-01-02"
"89323","2022","COM","2020","141","4","145","2023-01-02"
"89324","2022","COM","2020","672","11","683","2023-01-02"
"89325","2022","COM","2020","90","1","91","2023-01-02"
"89326","2022","COM","2020","1074","31","1105","2023-01-02"
"89327","2022","COM","2020","389","10","399","2023-01-02"
"89328","2022","COM","2020","369","7","376","2023-01-02"
"89329","2022","COM","2020","73","1","74","2023-01-02"
"89331","2022","COM","2020","311","11","322","2023-01-02"
"89332","2022","COM","2020","957","27","984","2023-01-02"
"89333","2022","COM","2020","149","4","153","2023-01-02"
"89334","2022","COM","2020","555","7","562","2023-01-02"
"89335","2022","COM","2020","427","13","440","2023-01-02"
"89336","2022","COM","2020","280","7","287","2023-01-02"
"89337","2022","COM","2020","1023","26","1049","2023-01-02"
"89338","2022","COM","2020","2812","81","2893","2023-01-02"
"89339","2022","COM","2020","187","9","196","2023-01-02"
"89341","2022","COM","2020","448","5","453","2023-01-02"
"89342","2022","COM","2020","640","18","658","2023-01-02"
"89344","2022","COM","2020","1482","13","1495","2023-01-02"
"89345","2022","COM","2020","4211","55","4266","2023-01-02"
"89346","2022","COM","2020","3225","145","3370","2023-01-02"
"89347","2022","COM","2020","343","10","353","2023-01-02"
"89348","2022","COM","2020","2224","49","2273","2023-01-02"
"89349","2022","COM","2020","356","11","367","2023-01-02"
"89350","2022","COM","2020","260","5","265","2023-01-02"
"89351","2022","COM","2020","478","8","486","2023-01-02"
"89352","2022","COM","2020","265","7","272","2023-01-02"
"89353","2022","COM","2020","421","4","425","2023-01-02"
"89354","2022","COM","2020","1529","42","1571","2023-01-02"
"89355","2022","COM","2020","147","6","153","2023-01-02"
"89359","2022","COM","2020","413","5","418","2023-01-02"
"89360","2022","COM","2020","372","8","380","2023-01-02"
"89361","2022","COM","2020","253","2","255","2023-01-02"
"89362","2022","COM","2020","178","5","183","2023-01-02"
"89363","2022","COM","2020","104","4","108","2023-01-02"
"89364","2022","COM","2020","292","6","298","2023-01-02"
"89365","2022","COM","2020","525","11","536","2023-01-02"
"89367","2022","COM","2020","543","11","554","2023-01-02"
"89368","2022","COM","2020","895","22","917","2023-01-02"
"89369","2022","COM","2020","581","12","593","2023-01-02"
"89370","2022","COM","2020","1750","21","1771","2023-01-02"
"89371","2022","COM","2020","78","5","83","2023-01-02"
"89373","2022","COM","2020","679","10","689","2023-01-02"
"89374","2022","COM","2020","70","3","73","2023-01-02"
"89375","2022","COM","2020","84","3","87","2023-01-02"
"89376","2022","COM","2020","135","7","142","2023-01-02"
"89377","2022","COM","2020","68","0","68","2023-01-02"
"89378","2022","COM","2020","729","15","744","2023-01-02"
"89379","2022","COM","2020","144","3","147","2023-01-02"
"89380","2022","COM","2020","451","7","458","2023-01-02"
"89382","2022","COM","2020","1457","38","1495","2023-01-02"
"89383","2022","COM","2020","103","2","105","2023-01-02"
"89384","2022","COM","2020","682","17","699","2023-01-02"
"89385","2022","COM","2020","76","3","79","2023-01-02"
"89386","2022","COM","2020","113","1","114","2023-01-02"
"89387","2022","COM","2020","26854","513","27367","2023-01-02"
"89388","2022","COM","2020","507","16","523","2023-01-02"
"89390","2022","COM","2020","669","9","678","2023-01-02"
"89391","2022","COM","2020","1260","26","1286","2023-01-02"
"89392","2022","COM","2020","244","3","247","2023-01-02"
"89393","2022","COM","2020","111","2","113","2023-01-02"
"89394","2022","COM","2020","76","1","77","2023-01-02"
"89395","2022","COM","2020","404","8","412","2023-01-02"
"89397","2022","COM","2020","372","6","378","2023-01-02"
"89398","2022","COM","2020","364","5","369","2023-01-02"
"89399","2022","COM","2020","1575","42","1617","2023-01-02"
"89400","2022","COM","2020","317","6","323","2023-01-02"
"89402","2022","COM","2020","218","3","221","2023-01-02"
"89403","2022","COM","2020","85","8","93","2023-01-02"
"89404","2022","COM","2020","525","9","534","2023-01-02"
"89405","2022","COM","2020","499","9","508","2023-01-02"
"89406","2022","COM","2020","76","2","78","2023-01-02"
"89407","2022","COM","2020","915","30","945","2023-01-02"
"89408","2022","COM","2020","274","7","281","2023-01-02"
"89409","2022","COM","2020","61","1","62","2023-01-02"
"89410","2022","COM","2020","104","1","105","2023-01-02"
"89411","2022","COM","2020","1020","18","1038","2023-01-02"
"89412","2022","COM","2020","184","7","191","2023-01-02"
"89413","2022","COM","2020","39","1","40","2023-01-02"
"89414","2022","COM","2020","1405","29","1434","2023-01-02"
"89415","2022","COM","2020","198","3","201","2023-01-02"
"89416","2022","COM","2020","442","7","449","2023-01-02"
"89417","2022","COM","2020","110","2","112","2023-01-02"
"89418","2022","COM","2020","4345","163","4508","2023-01-02"
"89419","2022","COM","2020","2589","143","2732","2023-01-02"
"89420","2022","COM","2020","1007","21","1028","2023-01-02"
"89422","2022","COM","2020","42","2","44","2023-01-02"
"89423","2022","COM","2020","127","3","130","2023-01-02"
"89424","2022","COM","2020","133","6","139","2023-01-02"
"89425","2022","COM","2020","665","20","685","2023-01-02"
"89426","2022","COM","2020","387","12","399","2023-01-02"
"89427","2022","COM","2020","677","19","696","2023-01-02"
"89428","2022","COM","2020","568","6","574","2023-01-02"
"89430","2022","COM","2020","321","8","329","2023-01-02"
"89431","2022","COM","2020","68","5","73","2023-01-02"
"89432","2022","COM","2020","453","8","461","2023-01-02"
"89433","2022","COM","2020","269","5","274","2023-01-02"
"89434","2022","COM","2020","341","8","349","2023-01-02"
"89436","2022","COM","2020","871","17","888","2023-01-02"
"89437","2022","COM","2020","298","7","305","2023-01-02"
"89438","2022","COM","2020","1750","191","1941","2023-01-02"
"89439","2022","COM","2020","1519","21","1540","2023-01-02"
"89440","2022","COM","2020","412","5","417","2023-01-02"
"89441","2022","COM","2020","1250","25","1275","2023-01-02"
"89442","2022","COM","2020","239","7","246","2023-01-02"
"89443","2022","COM","2020","1855","61","1916","2023-01-02"
"89445","2022","COM","2020","52","2","54","2023-01-02"
"89446","2022","COM","2020","433","7","440","2023-01-02"
"89447","2022","COM","2020","157","2","159","2023-01-02"
"89449","2022","COM","2020","1796","35","1831","2023-01-02"
"89450","2022","COM","2020","629","14","643","2023-01-02"
"89451","2022","COM","2020","249","5","254","2023-01-02"
"89452","2022","COM","2020","367","13","380","2023-01-02"
"89453","2022","COM","2020","1118","23","1141","2023-01-02"
"89456","2022","COM","2020","666","8","674","2023-01-02"
"89458","2022","COM","2020","161","8","169","2023-01-02"
"89459","2022","COM","2020","329","0","329","2023-01-02"
"89460","2022","COM","2020","3458","66","3524","2023-01-02"
"89461","2022","COM","2020","1109","19","1128","2023-01-02"
"89462","2022","COM","2020","304","5","309","2023-01-02"
"89463","2022","COM","2020","255","4","259","2023-01-02"
"89464","2022","COM","2020","5148","85","5233","2023-01-02"
"89465","2022","COM","2020","324","1","325","2023-01-02"
"89466","2022","COM","2020","386","9","395","2023-01-02"
"89467","2022","COM","2020","809","14","823","2023-01-02"
"89468","2022","COM","2020","418","64","482","2023-01-02"
"89469","2022","COM","2020","947","23","970","2023-01-02"
"89470","2022","COM","2020","122","3","125","2023-01-02"
"89471","2022","COM","2020","470","16","486","2023-01-02"
"89472","2022","COM","2020","442","9","451","2023-01-02"
"89474","2022","COM","2020","270","6","276","2023-01-02"
"89475","2022","COM","2020","108","2","110","2023-01-02"
"89477","2022","COM","2020","114","2","116","2023-01-02"
"89478","2022","COM","2020","914","17","931","2023-01-02"
"89479","2022","COM","2020","289","6","295","2023-01-02"
"89480","2022","COM","2020","1606","19","1625","2023-01-02"
"89481","2022","COM","2020","104","6","110","2023-01-02"
"89482","2022","COM","2020","108","1","109","2023-01-02"
"89483","2022","COM","2020","515","18","533","2023-01-02"
"89485","2022","COM","2020","199","6","205","2023-01-02"
"89486","2022","COM","2020","151","3","154","2023-01-02"
"90001","2022","COM","2020","1165","21","1186","2023-01-02"
"90002","2022","COM","2020","355","6","361","2023-01-02"
"90003","2022","COM","2020","582","22","604","2023-01-02"
"90004","2022","COM","2020","540","8","548","2023-01-02"
"90005","2022","COM","2020","443","12","455","2023-01-02"
"90006","2022","COM","2020","284","7","291","2023-01-02"
"90007","2022","COM","2020","291","12","303","2023-01-02"
"90008","2022","COM","2020","4627","108","4735","2023-01-02"
"90009","2022","COM","2020","5016","65","5081","2023-01-02"
"90010","2022","COM","2020","45458","767","46225","2023-01-02"
"90011","2022","COM","2020","376","9","385","2023-01-02"
"90012","2022","COM","2020","1302","47","1349","2023-01-02"
"90013","2022","COM","2020","243","11","254","2023-01-02"
"90014","2022","COM","2020","489","8","497","2023-01-02"
"90015","2022","COM","2020","238","13","251","2023-01-02"
"90016","2022","COM","2020","123","2","125","2023-01-02"
"90017","2022","COM","2020","1848","26","1874","2023-01-02"
"90018","2022","COM","2020","400","7","407","2023-01-02"
"90019","2022","COM","2020","285","6","291","2023-01-02"
"90020","2022","COM","2020","264","11","275","2023-01-02"
"90021","2022","COM","2020","375","4","379","2023-01-02"
"90022","2022","COM","2020","2625","50","2675","2023-01-02"
"90023","2022","COM","2020","1176","31","1207","2023-01-02"
"90024","2022","COM","2020","138","3","141","2023-01-02"
"90025","2022","COM","2020","340","4","344","2023-01-02"
"90026","2022","COM","2020","1572","37","1609","2023-01-02"
"90027","2022","COM","2020","120","0","120","2023-01-02"
"90028","2022","COM","2020","382","7","389","2023-01-02"
"90029","2022","COM","2020","1938","51","1989","2023-01-02"
"90030","2022","COM","2020","173","3","176","2023-01-02"
"90031","2022","COM","2020","338","9","347","2023-01-02"
"90032","2022","COM","2020","3573","67","3640","2023-01-02"
"90033","2022","COM","2020","5689","85","5774","2023-01-02"
"90034","2022","COM","2020","760","26","786","2023-01-02"
"90035","2022","COM","2020","808","10","818","2023-01-02"
"90036","2022","COM","2020","269","9","278","2023-01-02"
"90037","2022","COM","2020","955","27","982","2023-01-02"
"90039","2022","COM","2020","3316","104","3420","2023-01-02"
"90041","2022","COM","2020","1401","43","1444","2023-01-02"
"90042","2022","COM","2020","2021","69","2090","2023-01-02"
"90043","2022","COM","2020","586","1","587","2023-01-02"
"90044","2022","COM","2020","239","4","243","2023-01-02"
"90045","2022","COM","2020","758","13","771","2023-01-02"
"90046","2022","COM","2020","449","6","455","2023-01-02"
"90047","2022","COM","2020","594","15","609","2023-01-02"
"90048","2022","COM","2020","127","4","131","2023-01-02"
"90049","2022","COM","2020","917","18","935","2023-01-02"
"90050","2022","COM","2020","237","7","244","2023-01-02"
"90051","2022","COM","2020","472","8","480","2023-01-02"
"90052","2022","COM","2020","2914","80","2994","2023-01-02"
"90053","2022","COM","2020","2995","61","3056","2023-01-02"
"90054","2022","COM","2020","516","9","525","2023-01-02"
"90055","2022","COM","2020","331","6","337","2023-01-02"
"90056","2022","COM","2020","1416","29","1445","2023-01-02"
"90057","2022","COM","2020","754","27","781","2023-01-02"
"90058","2022","COM","2020","584","6","590","2023-01-02"
"90059","2022","COM","2020","226","10","236","2023-01-02"
"90060","2022","COM","2020","139","5","144","2023-01-02"
"90061","2022","COM","2020","44","2","46","2023-01-02"
"90062","2022","COM","2020","279","10","289","2023-01-02"
"90063","2022","COM","2020","413","9","422","2023-01-02"
"90064","2022","COM","2020","308","4","312","2023-01-02"
"90065","2022","COM","2020","1141","20","1161","2023-01-02"
"90066","2022","COM","2020","243","1","244","2023-01-02"
"90067","2022","COM","2020","400","18","418","2023-01-02"
"90068","2022","COM","2020","1390","27","1417","2023-01-02"
"90069","2022","COM","2020","1294","25","1319","2023-01-02"
"90070","2022","COM","2020","403","9","412","2023-01-02"
"90071","2022","COM","2020","1172","21","1193","2023-01-02"
"90072","2022","COM","2020","1068","21","1089","2023-01-02"
"90074","2022","COM","2020","304","4","308","2023-01-02"
"90075","2022","COM","2020","4164","91","4255","2023-01-02"
"90076","2022","COM","2020","1180","42","1222","2023-01-02"
"90077","2022","COM","2020","298","7","305","2023-01-02"
"90078","2022","COM","2020","190","5","195","2023-01-02"
"90079","2022","COM","2020","321","5","326","2023-01-02"
"90080","2022","COM","2020","435","13","448","2023-01-02"
"90081","2022","COM","2020","767","13","780","2023-01-02"
"90082","2022","COM","2020","276","9","285","2023-01-02"
"90083","2022","COM","2020","132","0","132","2023-01-02"
"90084","2022","COM","2020","336","3","339","2023-01-02"
"90085","2022","COM","2020","93","2","95","2023-01-02"
"90086","2022","COM","2020","219","7","226","2023-01-02"
"90087","2022","COM","2020","1037","31","1068","2023-01-02"
"90088","2022","COM","2020","973","22","995","2023-01-02"
"90089","2022","COM","2020","1492","51","1543","2023-01-02"
"90090","2022","COM","2020","433","12","445","2023-01-02"
"90091","2022","COM","2020","652","23","675","2023-01-02"
"90093","2022","COM","2020","924","20","944","2023-01-02"
"90094","2022","COM","2020","703","22","725","2023-01-02"
"90095","2022","COM","2020","432","3","435","2023-01-02"
"90096","2022","COM","2020","280","8","288","2023-01-02"
"90097","2022","COM","2020","1281","32","1313","2023-01-02"
"90098","2022","COM","2020","245","4","249","2023-01-02"
"90099","2022","COM","2020","5251","238","5489","2023-01-02"
"90100","2022","COM","2020","195","11","206","2023-01-02"
"90101","2022","COM","2020","243","6","249","2023-01-02"
"90102","2022","COM","2020","712","23","735","2023-01-02"
"90103","2022","COM","2020","668","22","690","2023-01-02"
"90104","2022","COM","2020","999","23","1022","2023-01-02"
"90105","2022","COM","2020","178","5","183","2023-01-02"
"91001","2022","COM","2020","328","8","336","2023-01-02"
"91016","2022","COM","2020","4374","53","4427","2023-01-02"
"91017","2022","COM","2020","1725","25","1750","2023-01-02"
"91021","2022","COM","2020","11165","101","11266","2023-01-02"
"91022","2022","COM","2020","126","5","131","2023-01-02"
"91027","2022","COM","2020","35641","286","35927","2023-01-02"
"91035","2022","COM","2020","373","8","381","2023-01-02"
"91037","2022","COM","2020","325","1","326","2023-01-02"
"91038","2022","COM","2020","1272","21","1293","2023-01-02"
"91041","2022","COM","2020","1017","7","1024","2023-01-02"
"91044","2022","COM","2020","4666","45","4711","2023-01-02"
"91045","2022","COM","2020","7706","106","7812","2023-01-02"
"91047","2022","COM","2020","1363","14","1377","2023-01-02"
"91064","2022","COM","2020","4796","77","4873","2023-01-02"
"91067","2022","COM","2020","115","4","119","2023-01-02"
"91069","2022","COM","2020","390","9","399","2023-01-02"
"91075","2022","COM","2020","81","1","82","2023-01-02"
"91079","2022","COM","2020","500","6","506","2023-01-02"
"91080","2022","COM","2020","1367","13","1380","2023-01-02"
"91081","2022","COM","2020","692","16","708","2023-01-02"
"91085","2022","COM","2020","3806","47","3853","2023-01-02"
"91086","2022","COM","2020","10326","100","10426","2023-01-02"
"91093","2022","COM","2020","647","21","668","2023-01-02"
"91095","2022","COM","2020","2095","27","2122","2023-01-02"
"91097","2022","COM","2020","7980","77","8057","2023-01-02"
"91098","2022","COM","2020","430","5","435","2023-01-02"
"91099","2022","COM","2020","2952","42","2994","2023-01-02"
"91100","2022","COM","2020","650","15","665","2023-01-02"
"91103","2022","COM","2020","27006","355","27361","2023-01-02"
"91105","2022","COM","2020","8759","123","8882","2023-01-02"
"91106","2022","COM","2020","1280","12","1292","2023-01-02"
"91109","2022","COM","2020","1282","10","1292","2023-01-02"
"91111","2022","COM","2020","3394","38","3432","2023-01-02"
"91112","2022","COM","2020","125","4","129","2023-01-02"
"91114","2022","COM","2020","25344","431","25775","2023-01-02"
"91115","2022","COM","2020","3594","45","3639","2023-01-02"
"91121","2022","COM","2020","464","4","468","2023-01-02"
"91122","2022","COM","2020","9240","202","9442","2023-01-02"
"91129","2022","COM","2020","3346","164","3510","2023-01-02"
"91130","2022","COM","2020","1020","28","1048","2023-01-02"
"91131","2022","COM","2020","390","8","398","2023-01-02"
"91132","2022","COM","2020","1134","12","1146","2023-01-02"
"91135","2022","COM","2020","2880","57","2937","2023-01-02"
"91136","2022","COM","2020","2771","17","2788","2023-01-02"
"91137","2022","COM","2020","367","7","374","2023-01-02"
"91145","2022","COM","2020","72","0","72","2023-01-02"
"91148","2022","COM","2020","140","0","140","2023-01-02"
"91156","2022","COM","2020","2227","30","2257","2023-01-02"
"91159","2022","COM","2020","1569","28","1597","2023-01-02"
"91161","2022","COM","2020","19943","107","20050","2023-01-02"
"91174","2022","COM","2020","52340","273","52613","2023-01-02"
"91175","2022","COM","2020","1712","30","1742","2023-01-02"
"91179","2022","COM","2020","4828","43","4871","2023-01-02"
"91180","2022","COM","2020","332","10","342","2023-01-02"
"91184","2022","COM","2020","277","7","284","2023-01-02"
"91186","2022","COM","2020","583","8","591","2023-01-02"
"91191","2022","COM","2020","9458","50","9508","2023-01-02"
"91195","2022","COM","2020","833","12","845","2023-01-02"
"91198","2022","COM","2020","1509","23","1532","2023-01-02"
"91200","2022","COM","2020","10733","177","10910","2023-01-02"
"91201","2022","COM","2020","28595","256","28851","2023-01-02"
"91204","2022","COM","2020","768","13","781","2023-01-02"
"91207","2022","COM","2020","6539","56","6595","2023-01-02"
"91215","2022","COM","2020","12197","83","12280","2023-01-02"
"91216","2022","COM","2020","11102","114","11216","2023-01-02"
"91223","2022","COM","2020","26251","203","26454","2023-01-02"
"91225","2022","COM","2020","3114","148","3262","2023-01-02"
"91226","2022","COM","2020","6806","94","6900","2023-01-02"
"91228","2022","COM","2020","66106","437","66543","2023-01-02"
"91232","2022","COM","2020","3656","55","3711","2023-01-02"
"91235","2022","COM","2020","13708","21","13729","2023-01-02"
"91240","2022","COM","2020","179","4","183","2023-01-02"
"91243","2022","COM","2020","2281","33","2314","2023-01-02"
"91244","2022","COM","2020","1565","27","1592","2023-01-02"
"91247","2022","COM","2020","510","11","521","2023-01-02"
"91248","2022","COM","2020","163","1","164","2023-01-02"
"91249","2022","COM","2020","3973","75","4048","2023-01-02"
"91272","2022","COM","2020","21439","557","21996","2023-01-02"
"91273","2022","COM","2020","763","18","781","2023-01-02"
"91274","2022","COM","2020","1511","24","1535","2023-01-02"
"91275","2022","COM","2020","2618","48","2666","2023-01-02"
"91284","2022","COM","2020","1184","23","1207","2023-01-02"
"91286","2022","COM","2020","27571","84","27655","2023-01-02"
"91292","2022","COM","2020","871","6","877","2023-01-02"
"91293","2022","COM","2020","893","17","910","2023-01-02"
"91294","2022","COM","2020","813","8","821","2023-01-02"
"91312","2022","COM","2020","10157","330","10487","2023-01-02"
"91315","2022","COM","2020","6638","63","6701","2023-01-02"
"91318","2022","COM","2020","1964","48","2012","2023-01-02"
"91319","2022","COM","2020","638","10","648","2023-01-02"
"91326","2022","COM","2020","17656","117","17773","2023-01-02"
"91330","2022","COM","2020","5462","102","5564","2023-01-02"
"91332","2022","COM","2020","1557","25","1582","2023-01-02"
"91333","2022","COM","2020","4350","43","4393","2023-01-02"
"91338","2022","COM","2020","6460","121","6581","2023-01-02"
"91339","2022","COM","2020","6864","49","6913","2023-01-02"
"91340","2022","COM","2020","7302","64","7366","2023-01-02"
"91345","2022","COM","2020","21105","137","21242","2023-01-02"
"91347","2022","COM","2020","6378","83","6461","2023-01-02"
"91359","2022","COM","2020","2809","39","2848","2023-01-02"
"91363","2022","COM","2020","8262","136","8398","2023-01-02"
"91374","2022","COM","2020","239","4","243","2023-01-02"
"91376","2022","COM","2020","5607","53","5660","2023-01-02"
"91377","2022","COM","2020","50506","338","50844","2023-01-02"
"91378","2022","COM","2020","331","3","334","2023-01-02"
"91386","2022","COM","2020","15669","245","15914","2023-01-02"
"91390","2022","COM","2020","3307","43","3350","2023-01-02"
"91393","2022","COM","2020","630","8","638","2023-01-02"
"91399","2022","COM","2020","214","1","215","2023-01-02"
"91405","2022","COM","2020","4620","91","4711","2023-01-02"
"91408","2022","COM","2020","1252","31","1283","2023-01-02"
"91411","2022","COM","2020","1856","49","1905","2023-01-02"
"91412","2022","COM","2020","733","11","744","2023-01-02"
"91414","2022","COM","2020","378","5","383","2023-01-02"
"91421","2022","COM","2020","23943","274","24217","2023-01-02"
"91425","2022","COM","2020","8561","227","8788","2023-01-02"
"91432","2022","COM","2020","13131","84","13215","2023-01-02"
"91433","2022","COM","2020","4376","105","4481","2023-01-02"
"91434","2022","COM","2020","20149","170","20319","2023-01-02"
"91435","2022","COM","2020","561","18","579","2023-01-02"
"91441","2022","COM","2020","517","11","528","2023-01-02"
"91457","2022","COM","2020","4316","46","4362","2023-01-02"
"91458","2022","COM","2020","4490","73","4563","2023-01-02"
"91461","2022","COM","2020","4803","59","4862","2023-01-02"
"91463","2022","COM","2020","1040","21","1061","2023-01-02"
"91468","2022","COM","2020","2200","21","2221","2023-01-02"
"91469","2022","COM","2020","909","50","959","2023-01-02"
"91471","2022","COM","2020","15554","336","15890","2023-01-02"
"91473","2022","COM","2020","155","2","157","2023-01-02"
"91477","2022","COM","2020","34750","306","35056","2023-01-02"
"91479","2022","COM","2020","7823","62","7885","2023-01-02"
"91482","2022","COM","2020","547","11","558","2023-01-02"
"91494","2022","COM","2020","4114","58","4172","2023-01-02"
"91495","2022","COM","2020","331","4","335","2023-01-02"
"91507","2022","COM","2020","287","5","292","2023-01-02"
"91508","2022","COM","2020","259","4","263","2023-01-02"
"91511","2022","COM","2020","2120","29","2149","2023-01-02"
"91514","2022","COM","2020","9463","59","9522","2023-01-02"
"91519","2022","COM","2020","391","11","402","2023-01-02"
"91521","2022","COM","2020","29643","186","29829","2023-01-02"
"91525","2022","COM","2020","1313","25","1338","2023-01-02"
"91526","2022","COM","2020","106","1","107","2023-01-02"
"91533","2022","COM","2020","1854","24","1878","2023-01-02"
"91534","2022","COM","2020","4261","58","4319","2023-01-02"
"91538","2022","COM","2020","691","18","709","2023-01-02"
"91540","2022","COM","2020","5264","79","5343","2023-01-02"
"91544","2022","COM","2020","506","6","512","2023-01-02"
"91546","2022","COM","2020","941","22","963","2023-01-02"
"91547","2022","COM","2020","478","16","494","2023-01-02"
"91549","2022","COM","2020","35879","311","36190","2023-01-02"
"91552","2022","COM","2020","11068","82","11150","2023-01-02"
"91553","2022","COM","2020","7474","97","7571","2023-01-02"
"91556","2022","COM","2020","408","8","416","2023-01-02"
"91560","2022","COM","2020","482","5","487","2023-01-02"
"91568","2022","COM","2020","1540","37","1577","2023-01-02"
"91570","2022","COM","2020","21298","143","21441","2023-01-02"
"91573","2022","COM","2020","11514","104","11618","2023-01-02"
"91577","2022","COM","2020","5835","66","5901","2023-01-02"
"91578","2022","COM","2020","268","5","273","2023-01-02"
"91579","2022","COM","2020","3029","51","3080","2023-01-02"
"91581","2022","COM","2020","907","10","917","2023-01-02"
"91587","2022","COM","2020","6593","57","6650","2023-01-02"
"91589","2022","COM","2020","37190","251","37441","2023-01-02"
"91593","2022","COM","2020","1605","37","1642","2023-01-02"
"91599","2022","COM","2020","1245","19","1264","2023-01-02"
"91600","2022","COM","2020","7218","139","7357","2023-01-02"
"91602","2022","COM","2020","445","9","454","2023-01-02"
"91613","2022","COM","2020","215","8","223","2023-01-02"
"91617","2022","COM","2020","4380","77","4457","2023-01-02"
"91619","2022","COM","2020","273","10","283","2023-01-02"
"91629","2022","COM","2020","620","14","634","2023-01-02"
"91630","2022","COM","2020","1498","32","1530","2023-01-02"
"91631","2022","COM","2020","2302","31","2333","2023-01-02"
"91634","2022","COM","2020","1389","32","1421","2023-01-02"
"91635","2022","COM","2020","2054","33","2087","2023-01-02"
"91639","2022","COM","2020","962","68","1030","2023-01-02"
"91645","2022","COM","2020","14602","329","14931","2023-01-02"
"91648","2022","COM","2020","2260","26","2286","2023-01-02"
"91649","2022","COM","2020","2782","28","2810","2023-01-02"
"91654","2022","COM","2020","590","17","607","2023-01-02"
"91657","2022","COM","2020","31495","145","31640","2023-01-02"
"91659","2022","COM","2020","5469","44","5513","2023-01-02"
"91661","2022","COM","2020","10406","167","10573","2023-01-02"
"91662","2022","COM","2020","747","14","761","2023-01-02"
"91665","2022","COM","2020","8021","91","8112","2023-01-02"
"91666","2022","COM","2020","2446","18","2464","2023-01-02"
"91667","2022","COM","2020","7014","88","7102","2023-01-02"
"91671","2022","COM","2020","598","6","604","2023-01-02"
"91679","2022","COM","2020","1155","22","1177","2023-01-02"
"91685","2022","COM","2020","4592","33","4625","2023-01-02"
"91687","2022","COM","2020","31098","199","31297","2023-01-02"
"91689","2022","COM","2020","7063","71","7134","2023-01-02"
"91691","2022","COM","2020","29097","228","29325","2023-01-02"
"91692","2022","COM","2020","25165","134","25299","2023-01-02"
"92002","2022","COM","2020","62906","733","63639","2023-01-02"
"92004","2022","COM","2020","88004","668","88672","2023-01-02"
"92007","2022","COM","2020","41967","155","42122","2023-01-02"
"92009","2022","COM","2020","29555","262","29817","2023-01-02"
"92012","2022","COM","2020","120911","1251","122162","2023-01-02"
"92014","2022","COM","2020","20974","317","21291","2023-01-02"
"92019","2022","COM","2020","34383","365","34748","2023-01-02"
"92020","2022","COM","2020","36392","296","36688","2023-01-02"
"92022","2022","COM","2020","20524","306","20830","2023-01-02"
"92023","2022","COM","2020","53179","561","53740","2023-01-02"
"92024","2022","COM","2020","62933","233","63166","2023-01-02"
"92025","2022","COM","2020","86775","553","87328","2023-01-02"
"92026","2022","COM","2020","82074","627","82701","2023-01-02"
"92032","2022","COM","2020","25174","215","25389","2023-01-02"
"92033","2022","COM","2020","17557","403","17960","2023-01-02"
"92035","2022","COM","2020","29624","266","29890","2023-01-02"
"92036","2022","COM","2020","49880","216","50096","2023-01-02"
"92040","2022","COM","2020","67937","704","68641","2023-01-02"
"92044","2022","COM","2020","67258","551","67809","2023-01-02"
"92046","2022","COM","2020","31230","182","31412","2023-01-02"
"92047","2022","COM","2020","1756","59","1815","2023-01-02"
"92048","2022","COM","2020","45825","692","46517","2023-01-02"
"92049","2022","COM","2020","47907","267","48174","2023-01-02"
"92050","2022","COM","2020","95782","620","96402","2023-01-02"
"92051","2022","COM","2020","59388","1023","60411","2023-01-02"
"92060","2022","COM","2020","29562","157","29719","2023-01-02"
"92062","2022","COM","2020","44009","266","44275","2023-01-02"
"92063","2022","COM","2020","78265","1448","79713","2023-01-02"
"92064","2022","COM","2020","29560","555","30115","2023-01-02"
"92071","2022","COM","2020","20359","362","20721","2023-01-02"
"92072","2022","COM","2020","23108","364","23472","2023-01-02"
"92073","2022","COM","2020","49482","510","49992","2023-01-02"
"92075","2022","COM","2020","27871","286","28157","2023-01-02"
"92076","2022","COM","2020","8627","314","8941","2023-01-02"
"92077","2022","COM","2020","10883","287","11170","2023-01-02"
"92078","2022","COM","2020","24592","78","24670","2023-01-02"
"93001","2022","COM","2020","89401","158","89559","2023-01-02"
"93005","2022","COM","2020","86485","388","86873","2023-01-02"
"93006","2022","COM","2020","38470","101","38571","2023-01-02"
"93007","2022","COM","2020","57989","127","58116","2023-01-02"
"93008","2022","COM","2020","54906","160","55066","2023-01-02"
"93010","2022","COM","2020","53342","167","53509","2023-01-02"
"93013","2022","COM","2020","15660","35","15695","2023-01-02"
"93014","2022","COM","2020","29568","56","29624","2023-01-02"
"93015","2022","COM","2020","4975","42","5017","2023-01-02"
"93027","2022","COM","2020","46828","123","46951","2023-01-02"
"93029","2022","COM","2020","71276","259","71535","2023-01-02"
"93030","2022","COM","2020","11200","32","11232","2023-01-02"
"93031","2022","COM","2020","54419","150","54569","2023-01-02"
"93032","2022","COM","2020","39588","229","39817","2023-01-02"
"93033","2022","COM","2020","6814","62","6876","2023-01-02"
"93039","2022","COM","2020","8646","19","8665","2023-01-02"
"93045","2022","COM","2020","23276","120","23396","2023-01-02"
"93046","2022","COM","2020","45618","200","45818","2023-01-02"
"93047","2022","COM","2020","28006","135","28141","2023-01-02"
"93048","2022","COM","2020","111367","587","111954","2023-01-02"
"93049","2022","COM","2020","20934","125","21059","2023-01-02"
"93050","2022","COM","2020","36535","105","36640","2023-01-02"
"93051","2022","COM","2020","68930","422","69352","2023-01-02"
"93053","2022","COM","2020","45043","113","45156","2023-01-02"
"93055","2022","COM","2020","60419","178","60597","2023-01-02"
"93057","2022","COM","2020","23904","99","24003","2023-01-02"
"93059","2022","COM","2020","31344","49","31393","2023-01-02"
"93061","2022","COM","2020","17290","52","17342","2023-01-02"
"93062","2022","COM","2020","14753","196","14949","2023-01-02"
"93063","2022","COM","2020","31469","85","31554","2023-01-02"
"93064","2022","COM","2020","45442","180","45622","2023-01-02"
"93066","2022","COM","2020","113116","911","114027","2023-01-02"
"93070","2022","COM","2020","51547","109","51656","2023-01-02"
"93071","2022","COM","2020","51778","179","51957","2023-01-02"
"93072","2022","COM","2020","39193","84","39277","2023-01-02"
"93073","2022","COM","2020","36477","176","36653","2023-01-02"
"93074","2022","COM","2020","7194","89","7283","2023-01-02"
"93077","2022","COM","2020","30583","180","30763","2023-01-02"
"93078","2022","COM","2020","38204","79","38283","2023-01-02"
"93079","2022","COM","2020","13433","80","13513","2023-01-02"
"94001","2022","COM","2020","5906","32","5938","2023-01-02"
"94002","2022","COM","2020","45151","166","45317","2023-01-02"
"94003","2022","COM","2020","21840","122","21962","2023-01-02"
"94004","2022","COM","2020","17286","59","17345","2023-01-02"
"94011","2022","COM","2020","18424","64","18488","2023-01-02"
"94015","2022","COM","2020","17592","204","17796","2023-01-02"
"94016","2022","COM","2020","30214","278","30492","2023-01-02"
"94017","2022","COM","2020","77439","312","77751","2023-01-02"
"94018","2022","COM","2020","29632","210","29842","2023-01-02"
"94019","2022","COM","2020","18011","104","18115","2023-01-02"
"94021","2022","COM","2020","20372","75","20447","2023-01-02"
"94022","2022","COM","2020","46229","237","46466","2023-01-02"
"94028","2022","COM","2020","92566","418","92984","2023-01-02"
"94033","2022","COM","2020","51386","421","51807","2023-01-02"
"94034","2022","COM","2020","28556","123","28679","2023-01-02"
"94037","2022","COM","2020","18813","137","18950","2023-01-02"
"94038","2022","COM","2020","31647","200","31847","2023-01-02"
"94041","2022","COM","2020","64016","232","64248","2023-01-02"
"94042","2022","COM","2020","19128","150","19278","2023-01-02"
"94043","2022","COM","2020","24513","129","24642","2023-01-02"
"94044","2022","COM","2020","28290","101","28391","2023-01-02"
"94046","2022","COM","2020","57639","305","57944","2023-01-02"
"94047","2022","COM","2020","4788","48","4836","2023-01-02"
"94048","2022","COM","2020","4737","107","4844","2023-01-02"
"94052","2022","COM","2020","33578","242","33820","2023-01-02"
"94053","2022","COM","2020","4602","42","4644","2023-01-02"
"94054","2022","COM","2020","24361","165","24526","2023-01-02"
"94055","2022","COM","2020","10528","83","10611","2023-01-02"
"94056","2022","COM","2020","2707","33","2740","2023-01-02"
"94058","2022","COM","2020","33697","284","33981","2023-01-02"
"94059","2022","COM","2020","19651","82","19733","2023-01-02"
"94060","2022","COM","2020","12148","125","12273","2023-01-02"
"94065","2022","COM","2020","5625","48","5673","2023-01-02"
"94067","2022","COM","2020","21991","200","22191","2023-01-02"
"94068","2022","COM","2020","74520","929","75449","2023-01-02"
"94069","2022","COM","2020","14560","113","14673","2023-01-02"
"94070","2022","COM","2020","3994","61","4055","2023-01-02"
"94071","2022","COM","2020","27040","278","27318","2023-01-02"
"94073","2022","COM","2020","30788","206","30994","2023-01-02"
"94074","2022","COM","2020","14538","41","14579","2023-01-02"
"94075","2022","COM","2020","11846","73","11919","2023-01-02"
"94076","2022","COM","2020","56349","236","56585","2023-01-02"
"94077","2022","COM","2020","21411","82","21493","2023-01-02"
"94078","2022","COM","2020","34845","94","34939","2023-01-02"
"94079","2022","COM","2020","29672","148","29820","2023-01-02"
"94080","2022","COM","2020","49697","471","50168","2023-01-02"
"94081","2022","COM","2020","95649","489","96138","2023-01-02"
"95002","2022","COM","2020","1105","14","1119","2023-01-02"
"95008","2022","COM","2020","879","12","891","2023-01-02"
"95011","2022","COM","2020","394","3","397","2023-01-02"
"95012","2022","COM","2020","206","1","207","2023-01-02"
"95014","2022","COM","2020","2703","41","2744","2023-01-02"
"95018","2022","COM","2020","108567","491","109058","2023-01-02"
"95019","2022","COM","2020","14364","70","14434","2023-01-02"
"95023","2022","COM","2020","630","3","633","2023-01-02"
"95024","2022","COM","2020","271","4","275","2023-01-02"
"95026","2022","COM","2020","3083","42","3125","2023-01-02"
"95028","2022","COM","2020","1695","8","1703","2023-01-02"
"95039","2022","COM","2020","6792","100","6892","2023-01-02"
"95040","2022","COM","2020","860","13","873","2023-01-02"
"95042","2022","COM","2020","1893","15","1908","2023-01-02"
"95046","2022","COM","2020","149","2","151","2023-01-02"
"95051","2022","COM","2020","8900","93","8993","2023-01-02"
"95052","2022","COM","2020","9572","99","9671","2023-01-02"
"95054","2022","COM","2020","214","5","219","2023-01-02"
"95055","2022","COM","2020","473","3","476","2023-01-02"
"95056","2022","COM","2020","2217","10","2227","2023-01-02"
"95058","2022","COM","2020","2743","25","2768","2023-01-02"
"95059","2022","COM","2020","362","4","366","2023-01-02"
"95060","2022","COM","2020","7876","57","7933","2023-01-02"
"95061","2022","COM","2020","409","2","411","2023-01-02"
"95063","2022","COM","2020","31866","112","31978","2023-01-02"
"95074","2022","COM","2020","855","17","872","2023-01-02"
"95078","2022","COM","2020","1934","26","1960","2023-01-02"
"95088","2022","COM","2020","1158","2","1160","2023-01-02"
"95091","2022","COM","2020","6596","58","6654","2023-01-02"
"95094","2022","COM","2020","303","3","306","2023-01-02"
"95101","2022","COM","2020","966","10","976","2023-01-02"
"95102","2022","COM","2020","420","9","429","2023-01-02"
"95110","2022","COM","2020","221","3","224","2023-01-02"
"95116","2022","COM","2020","4367","35","4402","2023-01-02"
"95119","2022","COM","2020","320","3","323","2023-01-02"
"95120","2022","COM","2020","2266","28","2294","2023-01-02"
"95127","2022","COM","2020","67790","485","68275","2023-01-02"
"95134","2022","COM","2020","5019","61","5080","2023-01-02"
"95139","2022","COM","2020","322","5","327","2023-01-02"
"95141","2022","COM","2020","36","0","36","2023-01-02"
"95142","2022","COM","2020","2042","17","2059","2023-01-02"
"95144","2022","COM","2020","77","1","78","2023-01-02"
"95149","2022","COM","2020","3230","53","3283","2023-01-02"
"95150","2022","COM","2020","599","8","607","2023-01-02"
"95151","2022","COM","2020","297","5","302","2023-01-02"
"95154","2022","COM","2020","308","3","311","2023-01-02"
"95157","2022","COM","2020","121","3","124","2023-01-02"
"95166","2022","COM","2020","473","6","479","2023-01-02"
"95169","2022","COM","2020","511","3","514","2023-01-02"
"95170","2022","COM","2020","544","2","546","2023-01-02"
"95176","2022","COM","2020","26074","223","26297","2023-01-02"
"95177","2022","COM","2020","1298","14","1312","2023-01-02"
"95181","2022","COM","2020","298","3","301","2023-01-02"
"95183","2022","COM","2020","6720","108","6828","2023-01-02"
"95197","2022","COM","2020","22050","196","22246","2023-01-02"
"95199","2022","COM","2020","15685","189","15874","2023-01-02"
"95203","2022","COM","2020","25498","284","25782","2023-01-02"
"95205","2022","COM","2020","7099","43","7142","2023-01-02"
"95210","2022","COM","2020","11416","158","11574","2023-01-02"
"95211","2022","COM","2020","2467","23","2490","2023-01-02"
"95212","2022","COM","2020","112","0","112","2023-01-02"
"95213","2022","COM","2020","616","15","631","2023-01-02"
"95214","2022","COM","2020","66","0","66","2023-01-02"
"95218","2022","COM","2020","18317","133","18450","2023-01-02"
"95219","2022","COM","2020","29230","223","29453","2023-01-02"
"95229","2022","COM","2020","9594","57","9651","2023-01-02"
"95241","2022","COM","2020","2078","13","2091","2023-01-02"
"95250","2022","COM","2020","9830","65","9895","2023-01-02"
"95252","2022","COM","2020","37347","147","37494","2023-01-02"
"95253","2022","COM","2020","515","9","524","2023-01-02"
"95254","2022","COM","2020","551","7","558","2023-01-02"
"95256","2022","COM","2020","3346","46","3392","2023-01-02"
"95257","2022","COM","2020","4655","54","4709","2023-01-02"
"95258","2022","COM","2020","349","8","357","2023-01-02"
"95268","2022","COM","2020","43215","79","43294","2023-01-02"
"95270","2022","COM","2020","537","9","546","2023-01-02"
"95271","2022","COM","2020","514","9","523","2023-01-02"
"95277","2022","COM","2020","25853","97","25950","2023-01-02"
"95280","2022","COM","2020","30910","142","31052","2023-01-02"
"95282","2022","COM","2020","156","4","160","2023-01-02"
"95287","2022","COM","2020","698","13","711","2023-01-02"
"95288","2022","COM","2020","8474","45","8519","2023-01-02"
"95295","2022","COM","2020","143","3","146","2023-01-02"
"95298","2022","COM","2020","566","6","572","2023-01-02"
"95301","2022","COM","2020","290","6","296","2023-01-02"
"95303","2022","COM","2020","203","1","204","2023-01-02"
"95304","2022","COM","2020","281","2","283","2023-01-02"
"95306","2022","COM","2020","31747","223","31970","2023-01-02"
"95308","2022","COM","2020","572","13","585","2023-01-02"
"95309","2022","COM","2020","213","0","213","2023-01-02"
"95313","2022","COM","2020","11723","200","11923","2023-01-02"
"95316","2022","COM","2020","271","7","278","2023-01-02"
"95323","2022","COM","2020","17225","132","17357","2023-01-02"
"95328","2022","COM","2020","644","7","651","2023-01-02"
"95331","2022","COM","2020","191","3","194","2023-01-02"
"95341","2022","COM","2020","382","4","386","2023-01-02"
"95348","2022","COM","2020","535","9","544","2023-01-02"
"95351","2022","COM","2020","11356","80","11436","2023-01-02"
"95352","2022","COM","2020","4828","78","4906","2023-01-02"
"95353","2022","COM","2020","1830","18","1848","2023-01-02"
"95355","2022","COM","2020","5810","55","5865","2023-01-02"
"95365","2022","COM","2020","718","8","726","2023-01-02"
"95369","2022","COM","2020","2830","47","2877","2023-01-02"
"95370","2022","COM","2020","3438","53","3491","2023-01-02"
"95371","2022","COM","2020","5661","42","5703","2023-01-02"
"95379","2022","COM","2020","193","3","196","2023-01-02"
"95387","2022","COM","2020","63","0","63","2023-01-02"
"95388","2022","COM","2020","5998","47","6045","2023-01-02"
"95392","2022","COM","2020","5211","55","5266","2023-01-02"
"95394","2022","COM","2020","9983","100","10083","2023-01-02"
"95395","2022","COM","2020","907","9","916","2023-01-02"
"95409","2022","COM","2020","1264","3","1267","2023-01-02"
"95422","2022","COM","2020","338","3","341","2023-01-02"
"95424","2022","COM","2020","22186","119","22305","2023-01-02"
"95426","2022","COM","2020","2917","74","2991","2023-01-02"
"95427","2022","COM","2020","14550","65","14615","2023-01-02"
"95428","2022","COM","2020","21688","254","21942","2023-01-02"
"95429","2022","COM","2020","398","8","406","2023-01-02"
"95430","2022","COM","2020","3703","34","3737","2023-01-02"
"95436","2022","COM","2020","1655","8","1663","2023-01-02"
"95438","2022","COM","2020","116","2","118","2023-01-02"
"95445","2022","COM","2020","753","5","758","2023-01-02"
"95446","2022","COM","2020","1780","31","1811","2023-01-02"
"95447","2022","COM","2020","229","4","233","2023-01-02"
"95450","2022","COM","2020","2056","28","2084","2023-01-02"
"95452","2022","COM","2020","868","7","875","2023-01-02"
"95456","2022","COM","2020","647","4","651","2023-01-02"
"95459","2022","COM","2020","706","12","718","2023-01-02"
"95462","2022","COM","2020","322","8","330","2023-01-02"
"95476","2022","COM","2020","17111","219","17330","2023-01-02"
"95480","2022","COM","2020","5602","112","5714","2023-01-02"
"95483","2022","COM","2020","531","4","535","2023-01-02"
"95487","2022","COM","2020","14029","53","14082","2023-01-02"
"95488","2022","COM","2020","9734","38","9772","2023-01-02"
"95489","2022","COM","2020","669","68","737","2023-01-02"
"95491","2022","COM","2020","8454","70","8524","2023-01-02"
"95492","2022","COM","2020","82","2","84","2023-01-02"
"95493","2022","COM","2020","130","1","131","2023-01-02"
"95500","2022","COM","2020","31973","480","32453","2023-01-02"
"95504","2022","COM","2020","3948","51","3999","2023-01-02"
"95509","2022","COM","2020","3583","32","3615","2023-01-02"
"95510","2022","COM","2020","571","11","582","2023-01-02"
"95523","2022","COM","2020","479","37","516","2023-01-02"
"95527","2022","COM","2020","2793","24","2817","2023-01-02"
"95529","2022","COM","2020","874","20","894","2023-01-02"
"95535","2022","COM","2020","1103","22","1125","2023-01-02"
"95539","2022","COM","2020","15102","80","15182","2023-01-02"
"95541","2022","COM","2020","993","10","1003","2023-01-02"
"95543","2022","COM","2020","239","1","240","2023-01-02"
"95554","2022","COM","2020","891","19","910","2023-01-02"
"95555","2022","COM","2020","20914","146","21060","2023-01-02"
"95563","2022","COM","2020","16076","166","16242","2023-01-02"
"95566","2022","COM","2020","2656","23","2679","2023-01-02"
"95572","2022","COM","2020","24743","106","24849","2023-01-02"
"95574","2022","COM","2020","7220","78","7298","2023-01-02"
"95580","2022","COM","2020","2439","109","2548","2023-01-02"
"95582","2022","COM","2020","26524","354","26878","2023-01-02"
"95584","2022","COM","2020","663","7","670","2023-01-02"
"95585","2022","COM","2020","58483","232","58715","2023-01-02"
"95592","2022","COM","2020","1297","14","1311","2023-01-02"
"95594","2022","COM","2020","1038","14","1052","2023-01-02"
"95598","2022","COM","2020","18061","167","18228","2023-01-02"
"95604","2022","COM","2020","4276","29","4305","2023-01-02"
"95607","2022","COM","2020","26607","166","26773","2023-01-02"
"95610","2022","COM","2020","301","7","308","2023-01-02"
"95611","2022","COM","2020","53","0","53","2023-01-02"
"95612","2022","COM","2020","4597","20","4617","2023-01-02"
"95625","2022","COM","2020","1339","11","1350","2023-01-02"
"95627","2022","COM","2020","594","12","606","2023-01-02"
"95628","2022","COM","2020","1222","25","1247","2023-01-02"
"95633","2022","COM","2020","101","0","101","2023-01-02"
"95637","2022","COM","2020","16020","187","16207","2023-01-02"
"95641","2022","COM","2020","2710","18","2728","2023-01-02"
"95651","2022","COM","2020","885","18","903","2023-01-02"
"95652","2022","COM","2020","5264","65","5329","2023-01-02"
"95656","2022","COM","2020","376","6","382","2023-01-02"
"95658","2022","COM","2020","1098","20","1118","2023-01-02"
"95660","2022","COM","2020","762","9","771","2023-01-02"
"95675","2022","COM","2020","1534","14","1548","2023-01-02"
"95676","2022","COM","2020","490","10","500","2023-01-02"
"95678","2022","COM","2020","857","16","873","2023-01-02"
"95680","2022","COM","2020","28636","106","28742","2023-01-02"
"95682","2022","COM","2020","193","3","196","2023-01-02"
"95690","2022","COM","2020","330","3","333","2023-01-02"
"97101","2022","COM","2020","52948","495","53443","2023-01-02"
"97102","2022","COM","2020","3871","58","3929","2023-01-02"
"97103","2022","COM","2020","30316","458","30774","2023-01-02"
"97104","2022","COM","2020","5122","88","5210","2023-01-02"
"97105","2022","COM","2020","9892","216","10108","2023-01-02"
"97106","2022","COM","2020","6760","109","6869","2023-01-02"
"97107","2022","COM","2020","17628","160","17788","2023-01-02"
"97108","2022","COM","2020","3247","27","3274","2023-01-02"
"97109","2022","COM","2020","7638","110","7748","2023-01-02"
"97110","2022","COM","2020","1406","30","1436","2023-01-02"
"97111","2022","COM","2020","3963","60","4023","2023-01-02"
"97112","2022","COM","2020","4803","71","4874","2023-01-02"
"97113","2022","COM","2020","26919","267","27186","2023-01-02"
"97114","2022","COM","2020","7635","143","7778","2023-01-02"
"97115","2022","COM","2020","17774","297","18071","2023-01-02"
"97116","2022","COM","2020","16223","213","16436","2023-01-02"
"97117","2022","COM","2020","22230","269","22499","2023-01-02"
"97118","2022","COM","2020","24412","369","24781","2023-01-02"
"97119","2022","COM","2020","8195","124","8319","2023-01-02"
"97120","2022","COM","2020","14498","83","14581","2023-01-02"
"97121","2022","COM","2020","5963","132","6095","2023-01-02"
"97122","2022","COM","2020","5601","79","5680","2023-01-02"
"97124","2022","COM","2020","10506","229","10735","2023-01-02"
"97125","2022","COM","2020","12184","138","12322","2023-01-02"
"97126","2022","COM","2020","2462","32","2494","2023-01-02"
"97128","2022","COM","2020","24430","235","24665","2023-01-02"
"97129","2022","COM","2020","17840","261","18101","2023-01-02"
"97130","2022","COM","2020","939","21","960","2023-01-02"
"97131","2022","COM","2020","1513","49","1562","2023-01-02"
"97132","2022","COM","2020","7733","137","7870","2023-01-02"
"97133","2022","COM","2020","1841","30","1871","2023-01-02"
"97134","2022","COM","2020","7067","178","7245","2023-01-02"
"97201","2022","COM","2020","1736","34","1770","2023-01-02"
"97202","2022","COM","2020","3630","26","3656","2023-01-02"
"97203","2022","COM","2020","2727","41","2768","2023-01-02"
"97204","2022","COM","2020","3424","51","3475","2023-01-02"
"97205","2022","COM","2020","4475","58","4533","2023-01-02"
"97206","2022","COM","2020","5447","72","5519","2023-01-02"
"97207","2022","COM","2020","17504","261","17765","2023-01-02"
"97208","2022","COM","2020","661","12","673","2023-01-02"
"97209","2022","COM","2020","75286","799","76085","2023-01-02"
"97210","2022","COM","2020","16082","174","16256","2023-01-02"
"97211","2022","COM","2020","554","14","568","2023-01-02"
"97212","2022","COM","2020","9758","64","9822","2023-01-02"
"97213","2022","COM","2020","39628","563","40191","2023-01-02"
"97214","2022","COM","2020","6713","85","6798","2023-01-02"
"97215","2022","COM","2020","1034","3","1037","2023-01-02"
"97216","2022","COM","2020","3078","48","3126","2023-01-02"
"97217","2022","COM","2020","8647","71","8718","2023-01-02"
"97218","2022","COM","2020","4635","60","4695","2023-01-02"
"97219","2022","COM","2020","1291","13","1304","2023-01-02"
"97220","2022","COM","2020","11675","143","11818","2023-01-02"
"97221","2022","COM","2020","11780","244","12024","2023-01-02"
"97222","2022","COM","2020","21627","166","21793","2023-01-02"
"97223","2022","COM","2020","10120","98","10218","2023-01-02"
"97224","2022","COM","2020","16137","225","16362","2023-01-02"
"97225","2022","COM","2020","4107","52","4159","2023-01-02"
"97226","2022","COM","2020","4464","68","4532","2023-01-02"
"97227","2022","COM","2020","9425","202","9627","2023-01-02"
"97228","2022","COM","2020","14843","178","15021","2023-01-02"
"97229","2022","COM","2020","19467","171","19638","2023-01-02"
"97230","2022","COM","2020","11860","135","11995","2023-01-02"
"97231","2022","COM","2020","7194","126","7320","2023-01-02"
"97232","2022","COM","2020","8552","95","8647","2023-01-02"
"97233","2022","COM","2020","1806","31","1837","2023-01-02"
"97234","2022","COM","2020","1858","126","1984","2023-01-02"
"97301","2022","COM","2020","844","26","870","2023-01-02"
"97302","2022","COM","2020","65956","371","66327","2023-01-02"
"97303","2022","COM","2020","1729","13","1742","2023-01-02"
"97304","2022","COM","2020","24805","232","25037","2023-01-02"
"97305","2022","COM","2020","19087","165","19252","2023-01-02"
"97306","2022","COM","2020","11605","158","11763","2023-01-02"
"97307","2022","COM","2020","34474","192","34666","2023-01-02"
"97308","2022","COM","2020","4303","93","4396","2023-01-02"
"97309","2022","COM","2020","25793","333","26126","2023-01-02"
"97310","2022","COM","2020","3436","54","3490","2023-01-02"
"97311","2022","COM","2020","49173","302","49475","2023-01-02"
"97312","2022","COM","2020","2855","44","2899","2023-01-02"
"97313","2022","COM","2020","3141","20","3161","2023-01-02"
"97314","2022","COM","2020","266","1","267","2023-01-02"
"97352","2022","COM","2020","153","7","160","2023-01-02"
"97353","2022","COM","2020","9768","136","9904","2023-01-02"
"97356","2022","COM","2020","1894","24","1918","2023-01-02"
"97357","2022","COM","2020","8859","6","8865","2023-01-02"
"97358","2022","COM","2020","244","1","245","2023-01-02"
"97360","2022","COM","2020","9582","21","9603","2023-01-02"
"97361","2022","COM","2020","1482","6","1488","2023-01-02"
"97362","2022","COM","2020","5684","17","5701","2023-01-02"
"97401","2022","COM","2020","11470","210","11680","2023-01-02"
"97402","2022","COM","2020","13416","206","13622","2023-01-02"
"97403","2022","COM","2020","7040","69","7109","2023-01-02"
"97404","2022","COM","2020","13645","196","13841","2023-01-02"
"97405","2022","COM","2020","12401","142","12543","2023-01-02"
"97406","2022","COM","2020","6723","96","6819","2023-01-02"
"97407","2022","COM","2020","32619","245","32864","2023-01-02"
"97408","2022","COM","2020","33370","396","33766","2023-01-02"
"97409","2022","COM","2020","56857","472","57329","2023-01-02"
"97410","2022","COM","2020","36994","271","37265","2023-01-02"
"97411","2022","COM","2020","153001","1458","154459","2023-01-02"
"97412","2022","COM","2020","38465","532","38997","2023-01-02"
"97413","2022","COM","2020","34740","484","35224","2023-01-02"
"97414","2022","COM","2020","53744","578","54322","2023-01-02"
"97415","2022","COM","2020","104301","1296","105597","2023-01-02"
"97416","2022","COM","2020","83930","892","84822","2023-01-02"
"97417","2022","COM","2020","5085","65","5150","2023-01-02"
"97418","2022","COM","2020","34350","424","34774","2023-01-02"
"97419","2022","COM","2020","6237","80","6317","2023-01-02"
"97420","2022","COM","2020","24086","241","24327","2023-01-02"
"97421","2022","COM","2020","7310","76","7386","2023-01-02"
"97422","2022","COM","2020","80778","950","81728","2023-01-02"
"97423","2022","COM","2020","6953","90","7043","2023-01-02"
"97424","2022","COM","2020","5568","83","5651","2023-01-02"
"97501","2022","COM","2020","585","15","600","2023-01-02"
"97502","2022","COM","2020","5340","152","5492","2023-01-02"
"97601","2022","COM","2017","5192","192","5384","2023-01-02"
"97602","2022","COM","2017","13989","222","14211","2023-01-02"
"97603","2022","COM","2017","10282","247","10529","2023-01-02"
"97604","2022","COM","2017","6189","314","6503","2023-01-02"
"97605","2022","COM","2017","8295","321","8616","2023-01-02"
"97606","2022","COM","2017","8920","277","9197","2023-01-02"
"97607","2022","COM","2017","15848","268","16116","2023-01-02"
"97608","2022","COM","2017","17831","406","18237","2023-01-02"
"97609","2022","COM","2017","5507","209","5716","2023-01-02"
"97610","2022","COM","2017","32156","596","32752","2023-01-02"
"97611","2022","COM","2017","71437","1537","72974","2023-01-02"
"97612","2022","COM","2017","7705","320","8025","2023-01-02"
"97613","2022","COM","2017","6432","154","6586","2023-01-02"
"97614","2022","COM","2017","10203","190","10393","2023-01-02"
"97615","2022","COM","2017","11442","360","11802","2023-01-02"
"97616","2022","COM","2017","11156","463","11619","2023-01-02"
"97617","2022","COM","2017","13934","301","14235","2023-01-02"
"97701","2022","COM","2020","10457","128","10585","2023-01-02"
"97801","2022","COM","2020","31801","557","32358","2023-01-02"
"98411","2022","DIS",".",".",".",".","2023-01-02"
"98412","2022","DIS",".",".",".",".","2023-01-02"
"98413","2022","DIS",".",".",".",".","2023-01-02"
"98414","2022","DIS",".",".",".",".","2023-01-02"
"98415","2022","DIS",".",".",".",".","2023-01-02"
"98611","2022","CIR","2018","1950","81","2031","2023-01-02"
"98612","2022","CIR","2018","1275","60","1335","2023-01-02"
"98613","2022","CIR","2018","8333","368","8701","2023-01-02"
"98711","2022","COM","2017","811","12","823","2023-01-02"
"98712","2022","COM","2017","10243","90","10333","2023-01-02"
"98713","2022","COM","2017","1664","30","1694","2023-01-02"
"98714","2022","COM","2017","10549","56","10605","2023-01-02"
"98715","2022","COM","2017","29506","372","29878","2023-01-02"
"98716","2022","COM","2017","1637","22","1659","2023-01-02"
"98717","2022","COM","2017","296","6","302","2023-01-02"
"98718","2022","COM","2017","612","21","633","2023-01-02"
"98719","2022","COM","2017","1535","57","1592","2023-01-02"
"98720","2022","COM","2017","1258","158","1416","2023-01-02"
"98721","2022","COM","2017","275","0","275","2023-01-02"
"98722","2022","COM","2017","10033","68","10101","2023-01-02"
"98723","2022","COM","2017","2243","195","2438","2023-01-02"
"98724","2022","COM","2017","6075","103","6178","2023-01-02"
"98725","2022","COM","2017","14763","353","15116","2023-01-02"
"98726","2022","COM","2017","1508","82","1590","2023-01-02"
"98727","2022","COM","2017","1141","38","1179","2023-01-02"
"98728","2022","COM","2017","1286","9","1295","2023-01-02"
"98729","2022","COM","2017","17816","255","18071","2023-01-02"
"98730","2022","COM","2017","284","10","294","2023-01-02"
"98731","2022","COM","2017","2951","169","3120","2023-01-02"
"98732","2022","COM","2017","295","27","322","2023-01-02"
"98733","2022","COM","2017","13021","100","13121","2023-01-02"
"98734","2022","COM","2017","11680","240","11920","2023-01-02"
"98735","2022","COM","2017","26926","461","27387","2023-01-02"
"98736","2022","COM","2017","14209","492","14701","2023-01-02"
"98737","2022","COM","2017","163","0","163","2023-01-02"
"98738","2022","COM","2017","28103","649","28752","2023-01-02"
"98739","2022","COM","2017","903","34","937","2023-01-02"
"98740","2022","COM","2017","3657","198","3855","2023-01-02"
"98741","2022","COM","2017","507","8","515","2023-01-02"
"98742","2022","COM","2017","587","12","599","2023-01-02"
"98743","2022","COM","2017","872","13","885","2023-01-02"
"98744","2022","COM","2017","2466","108","2574","2023-01-02"
"98745","2022","COM","2017","5234","79","5313","2023-01-02"
"98746","2022","COM","2017","653","18","671","2023-01-02"
"98747","2022","COM","2017","12701","213","12914","2023-01-02"
"98748","2022","COM","2017","8078","94","8172","2023-01-02"
"98749","2022","COM","2017","1175","20","1195","2023-01-02"
"98750","2022","COM","2017","4792","57","4849","2023-01-02"
"98751","2022","COM","2017","259","6","265","2023-01-02"
"98752","2022","COM","2017","10254","111","10365","2023-01-02"
"98753","2022","COM","2017","2217","105","2322","2023-01-02"
"98754","2022","COM","2017","3721","40","3761","2023-01-02"
"98755","2022","COM","2017","336","0","336","2023-01-02"
"98756","2022","COM","2017","674","4","678","2023-01-02"
"98757","2022","COM","2017","2213","82","2295","2023-01-02"
"98758","2022","COM","2017","3736","479","4215","2023-01-02"
"98801","2022","COM","2019","867","852","1719","2023-01-02"
"98802","2022","COM","2019","3315","385","3700","2023-01-02"
"98803","2022","COM","2019","5531","878","6409","2023-01-02"
"98804","2022","COM","2019","3701","2327","6028","2023-01-02"
"98805","2022","COM","2019","35873","377","36250","2023-01-02"
"98806","2022","COM","2019","712","6","718","2023-01-02"
"98807","2022","COM","2019","2454","1524","3978","2023-01-02"
"98808","2022","COM","2019","3955","2198","6153","2023-01-02"
"98809","2022","COM","2019","2037","1010","3047","2023-01-02"
"98810","2022","COM","2019","1803","550","2353","2023-01-02"
"98811","2022","COM","2019","8144","1078","9222","2023-01-02"
"98812","2022","COM","2019","3981","469","4450","2023-01-02"
"98813","2022","COM","2019","3552","472","4024","2023-01-02"
"98814","2022","COM","2019","9195","13958","23153","2023-01-02"
"98815","2022","COM","2019","5757","7578","13335","2023-01-02"
"98816","2022","COM","2019","681","161","842","2023-01-02"
"98817","2022","COM","2019","27620","720","28340","2023-01-02"
"98818","2022","COM","2019","94285","1797","96082","2023-01-02"
"98819","2022","COM","2019","2118","875","2993","2023-01-02"
"98820","2022","COM","2019","3401","5296","8697","2023-01-02"
"98821","2022","COM","2019","24563","888","25451","2023-01-02"
"98822","2022","COM","2019","5006","1646","6652","2023-01-02"
"98823","2022","COM","2019","2420","1971","4391","2023-01-02"
"98824","2022","COM","2019","2144","1672","3816","2023-01-02"
"98825","2022","COM","2019","2752","537","3289","2023-01-02"
"98826","2022","COM","2019","1435","680","2115","2023-01-02"
"98827","2022","COM","2019","2802","582","3384","2023-01-02"
"98828","2022","COM","2019","572","357","929","2023-01-02"
"98829","2022","COM","2019","2524","860","3384","2023-01-02"
"98830","2022","COM","2019","2380","1123","3503","2023-01-02"
"98831","2022","COM","2019","2856","754","3610","2023-01-02"
"98832","2022","COM","2019","1667","1027","2694","2023-01-02"
"98833","2022","COM","2019","1304","526","1830","2023-01-02"
"98901","2022","CPT",".",".",".",".","2023-01-02"
